Fiscal Year,Military Personnel Class,Unit Zip Code,Accession Total,Prior Service,Non-Prior Service
2013,Enlisted,     ,9,8,1
2013,Enlisted,00602,21,1,20
2013,Enlisted,00605,11,0,11
2013,Enlisted,00612,9,1,8
2013,Enlisted,00623,15,2,13
2013,Enlisted,00624,13,1,12
2013,Enlisted,00641,8,0,8
2013,Enlisted,00681,32,4,28
2013,Enlisted,00683,21,0,21
2013,Enlisted,00693,45,6,39
2013,Enlisted,00705,25,3,22
2013,Enlisted,00714,18,0,18
2013,Enlisted,00725,11,4,7
2013,Enlisted,00732,30,1,29
2013,Enlisted,00733,7,0,7
2013,Enlisted,00735,16,0,16
2013,Enlisted,00736,15,3,12
2013,Enlisted,00737,25,4,21
2013,Enlisted,00751,35,12,23
2013,Enlisted,00769,15,1,14
2013,Enlisted,00777,24,2,22
2013,Enlisted,00778,7,1,6
2013,Enlisted,00785,21,3,18
2013,Enlisted,00792,22,1,21
2013,Enlisted,00795,214,12,202
2013,Enlisted,00802,19,0,19
2013,Enlisted,00820,65,6,59
2013,Enlisted,00901,28,7,21
2013,Enlisted,00918,43,7,36
2013,Enlisted,00934,17,2,15
2013,Enlisted,00949,11,1,10
2013,Enlisted,00960,12,4,8
2013,Enlisted,00986,7,0,7
2013,Enlisted,01013,10,5,5
2013,Enlisted,01022,11,1,10
2013,Enlisted,01030,39,8,31
2013,Enlisted,01082,36,7,29
2013,Enlisted,01085,9,4,5
2013,Enlisted,01109,27,5,22
2013,Enlisted,01201,3,2,1
2013,Enlisted,01301,19,3,16
2013,Enlisted,01434,67,21,46
2013,Enlisted,01440,17,1,16
2013,Enlisted,01453,17,3,14
2013,Enlisted,01588,28,2,26
2013,Enlisted,01605,89,18,71
2013,Enlisted,01702,28,5,23
2013,Enlisted,01731,1,0,1
2013,Enlisted,01749,2,1,1
2013,Enlisted,01844,20,5,15
2013,Enlisted,01867,91,9,82
2013,Enlisted,01923,15,1,14
2013,Enlisted,01950,16,6,10
2013,Enlisted,02043,36,1,35
2013,Enlisted,02122,29,11,18
2013,Enlisted,02138,43,12,31
2013,Enlisted,02169,32,3,29
2013,Enlisted,02173,2,0,2
2013,Enlisted,02176,50,20,30
2013,Enlisted,02184,47,8,39
2013,Enlisted,02301,15,1,14
2013,Enlisted,02324,7,1,6
2013,Enlisted,02346,24,10,14
2013,Enlisted,02401,3,2,1
2013,Enlisted,02420,30,3,27
2013,Enlisted,02465,4,2,2
2013,Enlisted,02532,16,7,9
2013,Enlisted,02542,79,26,53
2013,Enlisted,02724,20,8,12
2013,Enlisted,02780,40,3,37
2013,Enlisted,02809,11,2,9
2013,Enlisted,02818,147,30,117
2013,Enlisted,02842,6,6,0
2013,Enlisted,02852,23,4,19
2013,Enlisted,02885,27,2,25
2013,Enlisted,02886,24,8,16
2013,Enlisted,02896,8,2,6
2013,Enlisted,02904,18,4,14
2013,Enlisted,02920,3,3,0
2013,Enlisted,03055,49,5,44
2013,Enlisted,03060,13,2,11
2013,Enlisted,03101,60,7,53
2013,Enlisted,03235,1,0,1
2013,Enlisted,03244,15,1,14
2013,Enlisted,03264,9,0,9
2013,Enlisted,03301,70,34,36
2013,Enlisted,03431,5,1,4
2013,Enlisted,03561,10,0,10
2013,Enlisted,03570,9,0,9
2013,Enlisted,03801,2,0,2
2013,Enlisted,03815,1,0,1
2013,Enlisted,03878,14,0,14
2013,Enlisted,04073,4,1,3
2013,Enlisted,04092,11,3,8
2013,Enlisted,04103,11,1,10
2013,Enlisted,04240,12,0,12
2013,Enlisted,04268,11,1,10
2013,Enlisted,04330,27,7,20
2013,Enlisted,04333,6,2,4
2013,Enlisted,04345,3,2,1
2013,Enlisted,04401,74,17,57
2013,Enlisted,04412,38,11,27
2013,Enlisted,04619,5,2,3
2013,Enlisted,04730,7,0,7
2013,Enlisted,04736,21,4,17
2013,Enlisted,04901,20,5,15
2013,Enlisted,04915,10,1,9
2013,Enlisted,04976,8,2,6
2013,Enlisted,05001,20,4,16
2013,Enlisted,05033,7,1,6
2013,Enlisted,05158,13,2,11
2013,Enlisted,05201,14,3,11
2013,Enlisted,05403,16,2,14
2013,Enlisted,05404,12,3,9
2013,Enlisted,05446,21,5,16
2013,Enlisted,05450,6,2,4
2013,Enlisted,05465,66,16,50
2013,Enlisted,05478,12,5,7
2013,Enlisted,05488,13,3,10
2013,Enlisted,05491,5,0,5
2013,Enlisted,05495,10,1,9
2013,Enlisted,05602,7,0,7
2013,Enlisted,05661,20,3,17
2013,Enlisted,05663,23,5,18
2013,Enlisted,05676,12,1,11
2013,Enlisted,05701,21,8,13
2013,Enlisted,05851,17,2,15
2013,Enlisted,05855,3,0,3
2013,Enlisted,06051,33,8,25
2013,Enlisted,06066,6,2,4
2013,Enlisted,06082,7,2,5
2013,Enlisted,06096,23,3,20
2013,Enlisted,06105,3,2,1
2013,Enlisted,06110,25,3,22
2013,Enlisted,06320,54,4,50
2013,Enlisted,06333,3,3,0
2013,Enlisted,06340,37,5,32
2013,Enlisted,06357,24,5,19
2013,Enlisted,06360,5,0,5
2013,Enlisted,06457,74,15,59
2013,Enlisted,06489,50,8,42
2013,Enlisted,06498,25,6,19
2013,Enlisted,06512,50,13,37
2013,Enlisted,06614,41,2,39
2013,Enlisted,06702,3,2,1
2013,Enlisted,06770,20,6,14
2013,Enlisted,06850,31,3,28
2013,Enlisted,07052,94,32,62
2013,Enlisted,07090,24,7,17
2013,Enlisted,07095,47,15,32
2013,Enlisted,07107,36,15,21
2013,Enlisted,07306,41,10,31
2013,Enlisted,07457,36,6,30
2013,Enlisted,07666,82,22,60
2013,Enlisted,07728,39,6,33
2013,Enlisted,07801,37,13,24
2013,Enlisted,07840,19,2,17
2013,Enlisted,07865,46,12,34
2013,Enlisted,07960,53,16,37
2013,Enlisted,08002,16,2,14
2013,Enlisted,08016,34,12,22
2013,Enlisted,08037,19,10,9
2013,Enlisted,08060,27,6,21
2013,Enlisted,08087,15,4,11
2013,Enlisted,08096,45,15,30
2013,Enlisted,08098,13,9,4
2013,Enlisted,08210,25,3,22
2013,Enlisted,08360,41,9,32
2013,Enlisted,08401,31,3,28
2013,Enlisted,08533,24,8,16
2013,Enlisted,08628,4,0,4
2013,Enlisted,08640,13,8,5
2013,Enlisted,08648,21,9,12
2013,Enlisted,08733,50,17,33
2013,Enlisted,08750,103,25,78
2013,Enlisted,08753,30,5,25
2013,Enlisted,08822,7,4,3
2013,Enlisted,08873,36,12,24
2013,Enlisted,10010,101,27,74
2013,Enlisted,10021,1,1,0
2013,Enlisted,10037,58,19,39
2013,Enlisted,10314,50,8,42
2013,Enlisted,10468,21,3,18
2013,Enlisted,10566,2,0,2
2013,Enlisted,10567,39,10,29
2013,Enlisted,10701,49,10,39
2013,Enlisted,10962,15,2,13
2013,Enlisted,11252,140,18,122
2013,Enlisted,11357,30,3,27
2013,Enlisted,11433,66,13,53
2013,Enlisted,11735,89,27,62
2013,Enlisted,11779,48,14,34
2013,Enlisted,12078,14,6,8
2013,Enlisted,12110,74,29,45
2013,Enlisted,12180,59,25,34
2013,Enlisted,12189,8,4,4
2013,Enlisted,12302,53,11,42
2013,Enlisted,12401,33,7,26
2013,Enlisted,12451,16,8,8
2013,Enlisted,12553,55,8,47
2013,Enlisted,12601,3,2,1
2013,Enlisted,12804,26,3,23
2013,Enlisted,12962,10,3,7
2013,Enlisted,12983,19,1,18
2013,Enlisted,13021,18,5,13
2013,Enlisted,13211,66,24,42
2013,Enlisted,13501,59,9,50
2013,Enlisted,13602,18,6,12
2013,Enlisted,13669,10,4,6
2013,Enlisted,13856,10,1,9
2013,Enlisted,13905,19,5,14
2013,Enlisted,14048,8,2,6
2013,Enlisted,14094,18,1,17
2013,Enlisted,14204,86,17,69
2013,Enlisted,14213,95,23,72
2013,Enlisted,14304,5,2,3
2013,Enlisted,14454,24,6,18
2013,Enlisted,14456,18,5,13
2013,Enlisted,14624,94,27,67
2013,Enlisted,14701,12,6,6
2013,Enlisted,14760,1,0,1
2013,Enlisted,14845,26,3,23
2013,Enlisted,14850,12,4,8
2013,Enlisted,15010,10,1,9
2013,Enlisted,15206,33,5,28
2013,Enlisted,15216,18,3,15
2013,Enlisted,15301,21,3,18
2013,Enlisted,15370,38,6,32
2013,Enlisted,15425,7,1,6
2013,Enlisted,15537,15,5,10
2013,Enlisted,15541,6,0,6
2013,Enlisted,15601,12,0,12
2013,Enlisted,15666,47,12,35
2013,Enlisted,15701,31,3,28
2013,Enlisted,15767,17,1,16
2013,Enlisted,15779,10,1,9
2013,Enlisted,15902,54,4,50
2013,Enlisted,15904,113,12,101
2013,Enlisted,16001,53,11,42
2013,Enlisted,16101,18,1,17
2013,Enlisted,16127,10,1,9
2013,Enlisted,16148,13,3,10
2013,Enlisted,16226,14,0,14
2013,Enlisted,16301,11,4,7
2013,Enlisted,16403,66,16,50
2013,Enlisted,16493,2,0,2
2013,Enlisted,16635,35,6,29
2013,Enlisted,16648,1,0,1
2013,Enlisted,16652,5,4,1
2013,Enlisted,16735,3,1,2
2013,Enlisted,16738,22,6,16
2013,Enlisted,16803,48,8,40
2013,Enlisted,16830,42,4,38
2013,Enlisted,16901,6,1,5
2013,Enlisted,17003,285,57,228
2013,Enlisted,17013,29,6,23
2013,Enlisted,17022,55,10,45
2013,Enlisted,17033,16,1,15
2013,Enlisted,17042,33,4,29
2013,Enlisted,17044,42,10,32
2013,Enlisted,17098,16,2,14
2013,Enlisted,17103,61,11,50
2013,Enlisted,17201,21,5,16
2013,Enlisted,17222,16,1,15
2013,Enlisted,17331,16,1,15
2013,Enlisted,17404,7,1,6
2013,Enlisted,17701,22,4,18
2013,Enlisted,17745,86,9,77
2013,Enlisted,17821,52,11,41
2013,Enlisted,17837,13,5,8
2013,Enlisted,17963,21,5,16
2013,Enlisted,18040,44,7,37
2013,Enlisted,18102,19,3,16
2013,Enlisted,18201,18,2,16
2013,Enlisted,18235,30,5,25
2013,Enlisted,18252,6,2,4
2013,Enlisted,18301,4,2,2
2013,Enlisted,18407,1,0,1
2013,Enlisted,18431,1,0,1
2013,Enlisted,18466,8,1,7
2013,Enlisted,18509,80,12,68
2013,Enlisted,18510,30,5,25
2013,Enlisted,18634,16,2,14
2013,Enlisted,18643,7,1,6
2013,Enlisted,18651,30,4,26
2013,Enlisted,18704,25,8,17
2013,Enlisted,18834,18,1,17
2013,Enlisted,18960,6,1,5
2013,Enlisted,19044,60,9,51
2013,Enlisted,19103,10,3,7
2013,Enlisted,19104,38,8,30
2013,Enlisted,19141,4,0,4
2013,Enlisted,19154,194,35,159
2013,Enlisted,19320,6,1,5
2013,Enlisted,19380,21,4,17
2013,Enlisted,19460,15,6,9
2013,Enlisted,19462,28,8,20
2013,Enlisted,19475,19,5,14
2013,Enlisted,19526,12,3,9
2013,Enlisted,19530,39,12,27
2013,Enlisted,19605,20,4,16
2013,Enlisted,19701,1,0,1
2013,Enlisted,19706,30,8,22
2013,Enlisted,19711,18,6,12
2013,Enlisted,19720,28,4,24
2013,Enlisted,19804,19,2,17
2013,Enlisted,19808,7,3,4
2013,Enlisted,19930,1,1,0
2013,Enlisted,19939,13,2,11
2013,Enlisted,19947,8,1,7
2013,Enlisted,19973,13,2,11
2013,Enlisted,19977,11,5,6
2013,Enlisted,20003,174,112,62
2013,Enlisted,20112,59,20,39
2013,Enlisted,20175,21,9,12
2013,Enlisted,20186,19,2,17
2013,Enlisted,20373,64,35,29
2013,Enlisted,20623,1,1,0
2013,Enlisted,20646,19,11,8
2013,Enlisted,20653,11,2,9
2013,Enlisted,20708,22,17,5
2013,Enlisted,20755,1,1,0
2013,Enlisted,20770,23,11,12
2013,Enlisted,20783,2,2,0
2013,Enlisted,20882,14,6,8
2013,Enlisted,20904,26,11,15
2013,Enlisted,21010,85,27,58
2013,Enlisted,21043,22,13,9
2013,Enlisted,21057,15,12,3
2013,Enlisted,21061,32,14,18
2013,Enlisted,21078,15,5,10
2013,Enlisted,21136,42,17,25
2013,Enlisted,21157,22,5,17
2013,Enlisted,21201,1,1,0
2013,Enlisted,21204,21,7,14
2013,Enlisted,21208,29,12,17
2013,Enlisted,21216,20,10,10
2013,Enlisted,21222,1,1,0
2013,Enlisted,21228,27,6,21
2013,Enlisted,21236,29,8,21
2013,Enlisted,21401,10,5,5
2013,Enlisted,21502,9,1,8
2013,Enlisted,21601,17,9,8
2013,Enlisted,21701,23,13,10
2013,Enlisted,21719,26,4,22
2013,Enlisted,21740,21,6,15
2013,Enlisted,21801,4,2,2
2013,Enlisted,21921,9,1,8
2013,Enlisted,22032,19,5,14
2013,Enlisted,22060,16,7,9
2013,Enlisted,22401,64,13,51
2013,Enlisted,22427,51,12,39
2013,Enlisted,22601,54,17,37
2013,Enlisted,22664,6,1,5
2013,Enlisted,22731,8,2,6
2013,Enlisted,22801,14,4,10
2013,Enlisted,22902,19,2,17
2013,Enlisted,23139,24,5,19
2013,Enlisted,23150,91,26,65
2013,Enlisted,23181,10,3,7
2013,Enlisted,23237,12,1,11
2013,Enlisted,23417,12,2,10
2013,Enlisted,23434,21,5,16
2013,Enlisted,23451,70,11,59
2013,Enlisted,23502,77,11,66
2013,Enlisted,23666,27,11,16
2013,Enlisted,23701,42,8,34
2013,Enlisted,23805,24,7,17
2013,Enlisted,23824,67,16,51
2013,Enlisted,23847,5,3,2
2013,Enlisted,23851,9,1,8
2013,Enlisted,23901,12,3,9
2013,Enlisted,24073,20,2,18
2013,Enlisted,24112,7,1,6
2013,Enlisted,24143,12,0,12
2013,Enlisted,24151,35,4,31
2013,Enlisted,24210,19,4,15
2013,Enlisted,24251,35,5,30
2013,Enlisted,24301,9,3,6
2013,Enlisted,24401,25,5,20
2013,Enlisted,24422,4,2,2
2013,Enlisted,24450,21,3,18
2013,Enlisted,24502,71,10,61
2013,Enlisted,24523,22,3,19
2013,Enlisted,24531,8,3,5
2013,Enlisted,24541,12,1,11
2013,Enlisted,24592,11,0,11
2013,Enlisted,24609,35,1,34
2013,Enlisted,24701,17,3,14
2013,Enlisted,24801,6,3,3
2013,Enlisted,24957,16,2,14
2013,Enlisted,25064,10,3,7
2013,Enlisted,25168,78,16,62
2013,Enlisted,25177,1,1,0
2013,Enlisted,25262,3,0,3
2013,Enlisted,25276,9,1,8
2013,Enlisted,25304,1,1,0
2013,Enlisted,25309,1,0,1
2013,Enlisted,25311,7,3,4
2013,Enlisted,25401,23,2,21
2013,Enlisted,25530,36,16,20
2013,Enlisted,25550,16,5,11
2013,Enlisted,25601,10,0,10
2013,Enlisted,25661,22,3,19
2013,Enlisted,25704,24,3,21
2013,Enlisted,25846,45,5,40
2013,Enlisted,26003,12,3,9
2013,Enlisted,26041,31,3,28
2013,Enlisted,26101,20,4,16
2013,Enlisted,26187,32,6,26
2013,Enlisted,26201,20,2,18
2013,Enlisted,26241,9,1,8
2013,Enlisted,26301,12,2,10
2013,Enlisted,26330,1,0,1
2013,Enlisted,26426,11,2,9
2013,Enlisted,26452,7,1,6
2013,Enlisted,26505,7,2,5
2013,Enlisted,26537,22,13,9
2013,Enlisted,26554,10,2,8
2013,Enlisted,26624,6,2,4
2013,Enlisted,26651,5,1,4
2013,Enlisted,26726,7,3,4
2013,Enlisted,26836,5,2,3
2013,Enlisted,27028,1,0,1
2013,Enlisted,27103,53,16,37
2013,Enlisted,27204,6,3,3
2013,Enlisted,27217,10,4,6
2013,Enlisted,27260,13,2,11
2013,Enlisted,27264,5,0,5
2013,Enlisted,27320,23,2,21
2013,Enlisted,27344,8,1,7
2013,Enlisted,27360,23,3,20
2013,Enlisted,27401,25,6,19
2013,Enlisted,27504,33,11,22
2013,Enlisted,27509,14,0,14
2013,Enlisted,27515,10,3,7
2013,Enlisted,27530,27,5,22
2013,Enlisted,27549,9,0,9
2013,Enlisted,27560,80,17,63
2013,Enlisted,27577,26,12,14
2013,Enlisted,27581,6,2,4
2013,Enlisted,27607,28,10,18
2013,Enlisted,27704,69,18,51
2013,Enlisted,27803,15,3,12
2013,Enlisted,27828,3,1,2
2013,Enlisted,27830,1,0,1
2013,Enlisted,27856,16,3,13
2013,Enlisted,27870,17,14,3
2013,Enlisted,27874,9,2,7
2013,Enlisted,27886,9,2,7
2013,Enlisted,27889,13,6,7
2013,Enlisted,27892,17,10,7
2013,Enlisted,27897,9,3,6
2013,Enlisted,27909,4,0,4
2013,Enlisted,27932,7,2,5
2013,Enlisted,28001,14,14,0
2013,Enlisted,28012,15,2,13
2013,Enlisted,28027,15,6,9
2013,Enlisted,28043,13,3,10
2013,Enlisted,28054,25,2,23
2013,Enlisted,28086,3,1,2
2013,Enlisted,28092,15,4,11
2013,Enlisted,28110,18,4,14
2013,Enlisted,28147,18,8,10
2013,Enlisted,28170,15,2,13
2013,Enlisted,28208,67,17,50
2013,Enlisted,28306,50,21,29
2013,Enlisted,28307,8,8,0
2013,Enlisted,28310,16,6,10
2013,Enlisted,28328,24,8,16
2013,Enlisted,28334,11,5,6
2013,Enlisted,28337,5,3,2
2013,Enlisted,28345,13,4,9
2013,Enlisted,28352,8,1,7
2013,Enlisted,28359,29,14,15
2013,Enlisted,28365,11,1,10
2013,Enlisted,28371,7,1,6
2013,Enlisted,28376,26,10,16
2013,Enlisted,28377,25,8,17
2013,Enlisted,28379,14,2,12
2013,Enlisted,28382,4,0,4
2013,Enlisted,28384,16,5,11
2013,Enlisted,28388,4,1,3
2013,Enlisted,28401,6,0,6
2013,Enlisted,28405,23,14,9
2013,Enlisted,28439,3,0,3
2013,Enlisted,28466,3,1,2
2013,Enlisted,28470,11,2,9
2013,Enlisted,28472,8,4,4
2013,Enlisted,28504,28,4,24
2013,Enlisted,28518,14,2,12
2013,Enlisted,28540,20,13,7
2013,Enlisted,28560,17,4,13
2013,Enlisted,28577,4,3,1
2013,Enlisted,28580,6,2,4
2013,Enlisted,28590,31,4,27
2013,Enlisted,28601,17,3,14
2013,Enlisted,28607,10,1,9
2013,Enlisted,28621,3,0,3
2013,Enlisted,28640,11,0,11
2013,Enlisted,28645,19,6,13
2013,Enlisted,28655,10,1,9
2013,Enlisted,28658,15,4,11
2013,Enlisted,28659,4,2,2
2013,Enlisted,28677,16,3,13
2013,Enlisted,28721,42,5,37
2013,Enlisted,28726,19,4,15
2013,Enlisted,28734,23,4,19
2013,Enlisted,28752,15,1,14
2013,Enlisted,28779,6,1,5
2013,Enlisted,28806,21,5,16
2013,Enlisted,28845,4,1,3
2013,Enlisted,29006,23,7,16
2013,Enlisted,29020,27,8,19
2013,Enlisted,29044,120,26,94
2013,Enlisted,29065,3,1,2
2013,Enlisted,29102,6,0,6
2013,Enlisted,29108,10,3,7
2013,Enlisted,29115,11,5,6
2013,Enlisted,29151,17,3,14
2013,Enlisted,29161,41,3,38
2013,Enlisted,29170,12,1,11
2013,Enlisted,29201,13,7,6
2013,Enlisted,29303,15,6,9
2013,Enlisted,29325,12,4,8
2013,Enlisted,29341,3,0,3
2013,Enlisted,29360,37,5,32
2013,Enlisted,29379,29,7,22
2013,Enlisted,29385,22,5,17
2013,Enlisted,29403,8,3,5
2013,Enlisted,29418,61,12,49
2013,Enlisted,29440,11,4,7
2013,Enlisted,29461,12,5,7
2013,Enlisted,29465,17,3,14
2013,Enlisted,29483,31,6,25
2013,Enlisted,29488,11,1,10
2013,Enlisted,29506,1,0,1
2013,Enlisted,29510,4,1,3
2013,Enlisted,29512,21,1,20
2013,Enlisted,29520,5,0,5
2013,Enlisted,29526,12,2,10
2013,Enlisted,29532,5,0,5
2013,Enlisted,29536,4,0,4
2013,Enlisted,29544,8,1,7
2013,Enlisted,29550,7,1,6
2013,Enlisted,29556,18,0,18
2013,Enlisted,29571,20,4,16
2013,Enlisted,29574,23,1,22
2013,Enlisted,29577,2,0,2
2013,Enlisted,29605,9,4,5
2013,Enlisted,29620,24,0,24
2013,Enlisted,29625,30,14,16
2013,Enlisted,29631,5,1,4
2013,Enlisted,29633,9,2,7
2013,Enlisted,29641,9,1,8
2013,Enlisted,29644,48,12,36
2013,Enlisted,29646,38,9,29
2013,Enlisted,29651,25,2,23
2013,Enlisted,29653,45,6,39
2013,Enlisted,29679,9,4,5
2013,Enlisted,29706,9,0,9
2013,Enlisted,29710,1,1,0
2013,Enlisted,29715,19,5,14
2013,Enlisted,29720,24,3,21
2013,Enlisted,29732,1,0,1
2013,Enlisted,29810,10,0,10
2013,Enlisted,29812,29,4,25
2013,Enlisted,29824,7,0,7
2013,Enlisted,29829,31,4,27
2013,Enlisted,29835,5,0,5
2013,Enlisted,29845,2,1,1
2013,Enlisted,29906,29,8,21
2013,Enlisted,29944,4,0,4
2013,Enlisted,30014,11,9,2
2013,Enlisted,30032,15,5,10
2013,Enlisted,30040,90,31,59
2013,Enlisted,30045,22,7,15
2013,Enlisted,30060,193,78,115
2013,Enlisted,30069,33,11,22
2013,Enlisted,30114,28,5,23
2013,Enlisted,30125,19,5,14
2013,Enlisted,30134,27,4,23
2013,Enlisted,30144,116,31,85
2013,Enlisted,30162,34,13,21
2013,Enlisted,30224,51,3,48
2013,Enlisted,30233,24,7,17
2013,Enlisted,30241,48,14,34
2013,Enlisted,30263,16,14,2
2013,Enlisted,30294,61,24,37
2013,Enlisted,30297,79,35,44
2013,Enlisted,30336,94,15,79
2013,Enlisted,30401,44,8,36
2013,Enlisted,30427,18,4,14
2013,Enlisted,30461,59,25,34
2013,Enlisted,30501,17,3,14
2013,Enlisted,30577,23,5,18
2013,Enlisted,30635,4,2,2
2013,Enlisted,30643,17,4,13
2013,Enlisted,30655,50,12,38
2013,Enlisted,30673,28,4,24
2013,Enlisted,30680,63,20,43
2013,Enlisted,30701,52,7,45
2013,Enlisted,30720,18,1,17
2013,Enlisted,30830,2,2,0
2013,Enlisted,30904,37,23,14
2013,Enlisted,30905,67,24,43
2013,Enlisted,31015,21,7,14
2013,Enlisted,31029,47,21,26
2013,Enlisted,31040,35,12,23
2013,Enlisted,31061,14,5,9
2013,Enlisted,31211,77,21,56
2013,Enlisted,31313,9,8,1
2013,Enlisted,31314,17,5,12
2013,Enlisted,31329,12,3,9
2013,Enlisted,31406,20,7,13
2013,Enlisted,31409,46,18,28
2013,Enlisted,31416,4,4,0
2013,Enlisted,31520,15,4,11
2013,Enlisted,31533,3,3,0
2013,Enlisted,31601,11,5,6
2013,Enlisted,31701,29,11,18
2013,Enlisted,31719,6,2,4
2013,Enlisted,31792,15,15,0
2013,Enlisted,31794,12,3,9
2013,Enlisted,31901,31,14,17
2013,Enlisted,31905,50,28,22
2013,Enlisted,32055,22,9,13
2013,Enlisted,32060,7,2,5
2013,Enlisted,32064,14,1,13
2013,Enlisted,32084,17,4,13
2013,Enlisted,32085,5,3,2
2013,Enlisted,32091,148,68,80
2013,Enlisted,32114,19,14,5
2013,Enlisted,32177,8,4,4
2013,Enlisted,32221,113,57,56
2013,Enlisted,32311,66,21,45
2013,Enlisted,32351,10,4,6
2013,Enlisted,32406,12,3,9
2013,Enlisted,32425,18,3,15
2013,Enlisted,32428,29,6,23
2013,Enlisted,32447,32,12,20
2013,Enlisted,32514,57,25,32
2013,Enlisted,32536,10,6,4
2013,Enlisted,32609,32,12,20
2013,Enlisted,32724,19,4,15
2013,Enlisted,32727,15,6,9
2013,Enlisted,32771,27,12,15
2013,Enlisted,32806,64,32,32
2013,Enlisted,32827,13,6,7
2013,Enlisted,32924,26,12,14
2013,Enlisted,32935,24,14,10
2013,Enlisted,33020,24,11,13
2013,Enlisted,33024,4,3,1
2013,Enlisted,33092,7,5,2
2013,Enlisted,33127,111,46,65
2013,Enlisted,33315,47,22,25
2013,Enlisted,33405,23,11,12
2013,Enlisted,33406,30,9,21
2013,Enlisted,33523,12,6,6
2013,Enlisted,33563,27,4,23
2013,Enlisted,33606,21,10,11
2013,Enlisted,33711,12,9,3
2013,Enlisted,33782,140,68,72
2013,Enlisted,33811,11,5,6
2013,Enlisted,33825,8,1,7
2013,Enlisted,33830,20,9,11
2013,Enlisted,33844,11,5,6
2013,Enlisted,33859,27,15,12
2013,Enlisted,33873,7,7,0
2013,Enlisted,33880,22,8,14
2013,Enlisted,33916,4,3,1
2013,Enlisted,34142,33,8,25
2013,Enlisted,34208,8,4,4
2013,Enlisted,34221,2,2,0
2013,Enlisted,34237,3,2,1
2013,Enlisted,34266,7,2,5
2013,Enlisted,34429,18,5,13
2013,Enlisted,34474,42,29,13
2013,Enlisted,34604,16,6,10
2013,Enlisted,34748,21,15,6
2013,Enlisted,34947,5,2,3
2013,Enlisted,35010,23,0,23
2013,Enlisted,35016,10,0,10
2013,Enlisted,35040,15,2,13
2013,Enlisted,35042,17,3,14
2013,Enlisted,35045,7,2,5
2013,Enlisted,35055,19,5,14
2013,Enlisted,35072,34,8,26
2013,Enlisted,35121,36,5,31
2013,Enlisted,35124,9,3,6
2013,Enlisted,35146,7,1,6
2013,Enlisted,35150,4,1,3
2013,Enlisted,35161,34,4,30
2013,Enlisted,35178,22,1,21
2013,Enlisted,35209,12,8,4
2013,Enlisted,35217,54,7,47
2013,Enlisted,35259,7,2,5
2013,Enlisted,35405,9,0,9
2013,Enlisted,35442,4,1,3
2013,Enlisted,35476,23,0,23
2013,Enlisted,35501,23,3,20
2013,Enlisted,35555,23,3,20
2013,Enlisted,35565,15,1,14
2013,Enlisted,35592,7,0,7
2013,Enlisted,35594,11,1,10
2013,Enlisted,35601,20,2,18
2013,Enlisted,35611,25,0,25
2013,Enlisted,35613,35,3,32
2013,Enlisted,35630,27,3,24
2013,Enlisted,35640,14,0,14
2013,Enlisted,35660,7,2,5
2013,Enlisted,35803,20,3,17
2013,Enlisted,35805,13,1,12
2013,Enlisted,35904,57,12,45
2013,Enlisted,35950,6,0,6
2013,Enlisted,35967,8,5,3
2013,Enlisted,36009,7,3,4
2013,Enlisted,36010,24,2,22
2013,Enlisted,36016,16,0,16
2013,Enlisted,36032,28,1,27
2013,Enlisted,36043,26,3,23
2013,Enlisted,36067,30,3,27
2013,Enlisted,36072,9,1,8
2013,Enlisted,36078,17,1,16
2013,Enlisted,36081,19,3,16
2013,Enlisted,36083,4,0,4
2013,Enlisted,36108,1,1,0
2013,Enlisted,36109,67,9,58
2013,Enlisted,36117,2,1,1
2013,Enlisted,36121,12,1,11
2013,Enlisted,36203,23,5,18
2013,Enlisted,36205,16,2,14
2013,Enlisted,36250,3,0,3
2013,Enlisted,36251,21,5,16
2013,Enlisted,36265,46,12,34
2013,Enlisted,36301,35,8,27
2013,Enlisted,36322,31,7,24
2013,Enlisted,36323,12,1,11
2013,Enlisted,36330,9,3,6
2013,Enlisted,36331,4,0,4
2013,Enlisted,36340,12,2,10
2013,Enlisted,36344,9,1,8
2013,Enlisted,36421,8,3,5
2013,Enlisted,36426,21,5,16
2013,Enlisted,36442,5,0,5
2013,Enlisted,36460,16,3,13
2013,Enlisted,36502,24,3,21
2013,Enlisted,36522,22,2,20
2013,Enlisted,36532,19,4,15
2013,Enlisted,36535,8,2,6
2013,Enlisted,36545,13,0,13
2013,Enlisted,36605,72,10,62
2013,Enlisted,36608,11,3,8
2013,Enlisted,36701,4,1,3
2013,Enlisted,36726,4,0,4
2013,Enlisted,36732,11,1,10
2013,Enlisted,36756,14,1,13
2013,Enlisted,36801,13,2,11
2013,Enlisted,36832,10,5,5
2013,Enlisted,36854,36,9,27
2013,Enlisted,36867,22,3,19
2013,Enlisted,36904,14,2,12
2013,Enlisted,37015,12,3,9
2013,Enlisted,37033,10,5,5
2013,Enlisted,37042,15,8,7
2013,Enlisted,37056,18,12,6
2013,Enlisted,37066,21,8,13
2013,Enlisted,37083,19,3,16
2013,Enlisted,37090,38,14,24
2013,Enlisted,37091,16,5,11
2013,Enlisted,37097,12,5,7
2013,Enlisted,37110,29,4,25
2013,Enlisted,37129,27,8,19
2013,Enlisted,37160,8,2,6
2013,Enlisted,37167,112,46,66
2013,Enlisted,37172,26,10,16
2013,Enlisted,37178,6,5,1
2013,Enlisted,37185,8,5,3
2013,Enlisted,37204,101,35,66
2013,Enlisted,37211,7,3,4
2013,Enlisted,37303,13,4,9
2013,Enlisted,37321,1,1,0
2013,Enlisted,37323,34,4,30
2013,Enlisted,37327,17,1,16
2013,Enlisted,37334,4,2,2
2013,Enlisted,37356,8,2,6
2013,Enlisted,37388,25,12,13
2013,Enlisted,37398,17,7,10
2013,Enlisted,37404,40,13,27
2013,Enlisted,37615,15,5,10
2013,Enlisted,37620,17,6,11
2013,Enlisted,37644,9,1,8
2013,Enlisted,37645,24,10,14
2013,Enlisted,37650,7,1,6
2013,Enlisted,37683,10,1,9
2013,Enlisted,37717,8,4,4
2013,Enlisted,37743,9,2,7
2013,Enlisted,37757,4,2,2
2013,Enlisted,37760,19,6,13
2013,Enlisted,37771,23,11,12
2013,Enlisted,37777,40,10,30
2013,Enlisted,37801,16,6,10
2013,Enlisted,37821,10,0,10
2013,Enlisted,37825,17,4,13
2013,Enlisted,37841,9,3,6
2013,Enlisted,37854,26,7,19
2013,Enlisted,37857,11,2,9
2013,Enlisted,37860,11,4,7
2013,Enlisted,37863,6,2,4
2013,Enlisted,37874,15,2,13
2013,Enlisted,37919,45,21,24
2013,Enlisted,37939,23,9,14
2013,Enlisted,38000,5,0,5
2013,Enlisted,38001,4,0,4
2013,Enlisted,38008,8,1,7
2013,Enlisted,38012,19,7,12
2013,Enlisted,38019,6,0,6
2013,Enlisted,38024,13,1,12
2013,Enlisted,38053,5,3,2
2013,Enlisted,38054,3,1,2
2013,Enlisted,38063,32,7,25
2013,Enlisted,38079,6,1,5
2013,Enlisted,38118,40,12,28
2013,Enlisted,38201,14,4,10
2013,Enlisted,38225,10,5,5
2013,Enlisted,38242,8,5,3
2013,Enlisted,38261,23,2,21
2013,Enlisted,38301,28,5,23
2013,Enlisted,38302,19,6,13
2013,Enlisted,38320,4,0,4
2013,Enlisted,38340,22,2,20
2013,Enlisted,38343,16,4,12
2013,Enlisted,38344,10,7,3
2013,Enlisted,38348,2,2,0
2013,Enlisted,38351,7,2,5
2013,Enlisted,38358,10,2,8
2013,Enlisted,38363,7,2,5
2013,Enlisted,38372,12,6,6
2013,Enlisted,38375,21,4,17
2013,Enlisted,38382,45,7,38
2013,Enlisted,38401,23,8,15
2013,Enlisted,38462,8,4,4
2013,Enlisted,38464,2,1,1
2013,Enlisted,38478,3,1,2
2013,Enlisted,38485,21,9,12
2013,Enlisted,38506,13,6,7
2013,Enlisted,38556,21,8,13
2013,Enlisted,38563,8,3,5
2013,Enlisted,38570,15,5,10
2013,Enlisted,38572,9,1,8
2013,Enlisted,38583,4,0,4
2013,Enlisted,38606,22,2,20
2013,Enlisted,38614,15,5,10
2013,Enlisted,38632,16,3,13
2013,Enlisted,38635,12,6,6
2013,Enlisted,38655,14,2,12
2013,Enlisted,38663,13,1,12
2013,Enlisted,38668,16,3,13
2013,Enlisted,38671,40,8,32
2013,Enlisted,38701,9,2,7
2013,Enlisted,38703,1,1,0
2013,Enlisted,38732,6,1,5
2013,Enlisted,38737,18,3,15
2013,Enlisted,38751,7,0,7
2013,Enlisted,38801,37,7,30
2013,Enlisted,38803,23,4,19
2013,Enlisted,38821,8,1,7
2013,Enlisted,38829,14,0,14
2013,Enlisted,38835,13,0,13
2013,Enlisted,38843,5,1,4
2013,Enlisted,38851,32,2,30
2013,Enlisted,38852,9,3,6
2013,Enlisted,38858,13,2,11
2013,Enlisted,38860,13,3,10
2013,Enlisted,38863,27,4,23
2013,Enlisted,38901,17,11,6
2013,Enlisted,38902,2,1,1
2013,Enlisted,38915,22,2,20
2013,Enlisted,38916,20,4,16
2013,Enlisted,38921,7,1,6
2013,Enlisted,38935,16,1,15
2013,Enlisted,38965,11,0,11
2013,Enlisted,38967,7,3,4
2013,Enlisted,39043,14,6,8
2013,Enlisted,39046,27,8,19
2013,Enlisted,39051,32,4,28
2013,Enlisted,39059,18,3,15
2013,Enlisted,39060,18,5,13
2013,Enlisted,39074,18,6,12
2013,Enlisted,39090,12,1,11
2013,Enlisted,39111,6,2,4
2013,Enlisted,39114,11,1,10
2013,Enlisted,39117,17,3,14
2013,Enlisted,39120,10,1,9
2013,Enlisted,39159,8,1,7
2013,Enlisted,39168,4,0,4
2013,Enlisted,39183,19,3,16
2013,Enlisted,39194,7,0,7
2013,Enlisted,39202,3,3,0
2013,Enlisted,39204,37,9,28
2013,Enlisted,39209,33,8,25
2013,Enlisted,39216,16,8,8
2013,Enlisted,39296,8,6,2
2013,Enlisted,39307,20,5,15
2013,Enlisted,39328,8,1,7
2013,Enlisted,39339,22,2,20
2013,Enlisted,39345,30,9,21
2013,Enlisted,39350,22,3,19
2013,Enlisted,39355,9,2,7
2013,Enlisted,39367,10,2,8
2013,Enlisted,39403,4,2,2
2013,Enlisted,39407,83,25,58
2013,Enlisted,39422,12,2,10
2013,Enlisted,39429,14,0,14
2013,Enlisted,39440,4,2,2
2013,Enlisted,39452,33,9,24
2013,Enlisted,39455,10,4,6
2013,Enlisted,39466,11,2,9
2013,Enlisted,39470,38,11,27
2013,Enlisted,39475,20,3,17
2013,Enlisted,39476,15,3,12
2013,Enlisted,39501,17,7,10
2013,Enlisted,39505,14,10,4
2013,Enlisted,39507,32,8,24
2013,Enlisted,39532,27,9,18
2013,Enlisted,39556,8,2,6
2013,Enlisted,39567,15,7,8
2013,Enlisted,39577,15,4,11
2013,Enlisted,39601,33,0,33
2013,Enlisted,39638,13,2,11
2013,Enlisted,39648,29,6,23
2013,Enlisted,39654,17,2,15
2013,Enlisted,39667,27,5,22
2013,Enlisted,39704,5,1,4
2013,Enlisted,39730,11,3,8
2013,Enlisted,39735,7,0,7
2013,Enlisted,39744,10,0,10
2013,Enlisted,39760,23,3,20
2013,Enlisted,39773,9,2,7
2013,Enlisted,39819,6,0,6
2013,Enlisted,40004,1,1,0
2013,Enlisted,40065,18,0,18
2013,Enlisted,40069,4,0,4
2013,Enlisted,40108,38,7,31
2013,Enlisted,40209,13,4,9
2013,Enlisted,40213,12,7,5
2013,Enlisted,40218,53,9,44
2013,Enlisted,40311,1,1,0
2013,Enlisted,40330,13,2,11
2013,Enlisted,40351,37,2,35
2013,Enlisted,40422,24,3,21
2013,Enlisted,40472,42,6,36
2013,Enlisted,40475,84,8,76
2013,Enlisted,40510,6,3,3
2013,Enlisted,40512,1,1,0
2013,Enlisted,40516,9,2,7
2013,Enlisted,40601,46,11,35
2013,Enlisted,40741,40,4,36
2013,Enlisted,40769,8,2,6
2013,Enlisted,40831,15,1,14
2013,Enlisted,40906,23,2,21
2013,Enlisted,40965,24,1,23
2013,Enlisted,41005,17,2,15
2013,Enlisted,41008,6,1,5
2013,Enlisted,41031,6,1,5
2013,Enlisted,41051,39,4,35
2013,Enlisted,41056,24,1,23
2013,Enlisted,41094,67,8,59
2013,Enlisted,41101,21,2,19
2013,Enlisted,41164,11,3,8
2013,Enlisted,41339,15,0,15
2013,Enlisted,41502,6,0,6
2013,Enlisted,41653,21,1,20
2013,Enlisted,41701,17,1,16
2013,Enlisted,42025,12,2,10
2013,Enlisted,42064,8,1,7
2013,Enlisted,42071,25,2,23
2013,Enlisted,42086,17,4,13
2013,Enlisted,42101,34,6,28
2013,Enlisted,42141,19,3,16
2013,Enlisted,42167,4,1,3
2013,Enlisted,42240,36,8,28
2013,Enlisted,42276,9,3,6
2013,Enlisted,42301,20,3,17
2013,Enlisted,42330,15,5,10
2013,Enlisted,42345,16,7,9
2013,Enlisted,42420,1,0,1
2013,Enlisted,42431,12,3,9
2013,Enlisted,42501,26,2,24
2013,Enlisted,42633,9,0,9
2013,Enlisted,42701,14,4,10
2013,Enlisted,42718,6,1,5
2013,Enlisted,42754,4,1,3
2013,Enlisted,43040,34,4,30
2013,Enlisted,43055,31,2,29
2013,Enlisted,43102,19,2,17
2013,Enlisted,43213,59,11,48
2013,Enlisted,43217,65,24,41
2013,Enlisted,43228,13,1,12
2013,Enlisted,43235,42,16,26
2013,Enlisted,43302,19,1,18
2013,Enlisted,43402,42,9,33
2013,Enlisted,43465,123,13,110
2013,Enlisted,43614,28,3,25
2013,Enlisted,43756,91,7,84
2013,Enlisted,43812,21,2,19
2013,Enlisted,44023,43,7,36
2013,Enlisted,44055,23,1,22
2013,Enlisted,44128,79,10,69
2013,Enlisted,44142,29,4,25
2013,Enlisted,44224,76,12,64
2013,Enlisted,44256,35,6,29
2013,Enlisted,44313,9,1,8
2013,Enlisted,44444,51,8,43
2013,Enlisted,44515,48,6,42
2013,Enlisted,44601,14,5,9
2013,Enlisted,44622,19,3,16
2013,Enlisted,44691,18,3,15
2013,Enlisted,44720,119,8,111
2013,Enlisted,44857,25,3,22
2013,Enlisted,44870,21,3,18
2013,Enlisted,44883,27,4,23
2013,Enlisted,44903,28,4,24
2013,Enlisted,45015,41,4,37
2013,Enlisted,45036,35,4,31
2013,Enlisted,45044,38,2,36
2013,Enlisted,45215,68,9,59
2013,Enlisted,45331,32,4,28
2013,Enlisted,45346,25,4,21
2013,Enlisted,45356,8,2,6
2013,Enlisted,45385,16,5,11
2013,Enlisted,45430,51,7,44
2013,Enlisted,45502,30,7,23
2013,Enlisted,45505,33,3,30
2013,Enlisted,45601,43,3,40
2013,Enlisted,45662,31,2,29
2013,Enlisted,45804,25,2,23
2013,Enlisted,45885,4,0,4
2013,Enlisted,46012,25,6,19
2013,Enlisted,46036,10,0,10
2013,Enlisted,46041,17,3,14
2013,Enlisted,46052,11,4,7
2013,Enlisted,46060,19,5,14
2013,Enlisted,46122,33,5,28
2013,Enlisted,46124,54,13,41
2013,Enlisted,46131,124,21,103
2013,Enlisted,46135,17,3,14
2013,Enlisted,46140,12,0,12
2013,Enlisted,46151,34,12,22
2013,Enlisted,46176,69,14,55
2013,Enlisted,46208,10,1,9
2013,Enlisted,46216,102,32,70
2013,Enlisted,46241,208,55,153
2013,Enlisted,46249,29,3,26
2013,Enlisted,46323,18,4,14
2013,Enlisted,46350,29,5,24
2013,Enlisted,46360,1,0,1
2013,Enlisted,46383,22,4,18
2013,Enlisted,46402,29,5,24
2013,Enlisted,46406,49,14,35
2013,Enlisted,46517,32,6,26
2013,Enlisted,46563,14,2,12
2013,Enlisted,46580,17,2,15
2013,Enlisted,46613,56,11,45
2013,Enlisted,46703,9,1,8
2013,Enlisted,46714,15,6,9
2013,Enlisted,46750,15,1,14
2013,Enlisted,46809,29,0,29
2013,Enlisted,46825,114,13,101
2013,Enlisted,46901,34,5,29
2013,Enlisted,46947,32,4,28
2013,Enlisted,46970,11,0,11
2013,Enlisted,47150,41,7,34
2013,Enlisted,47167,27,7,20
2013,Enlisted,47170,18,4,14
2013,Enlisted,47203,12,4,8
2013,Enlisted,47250,17,2,15
2013,Enlisted,47265,16,2,14
2013,Enlisted,47274,30,6,24
2013,Enlisted,47303,65,12,53
2013,Enlisted,47331,25,4,21
2013,Enlisted,47348,42,10,32
2013,Enlisted,47374,19,5,14
2013,Enlisted,47394,17,4,13
2013,Enlisted,47401,40,5,35
2013,Enlisted,47421,49,7,42
2013,Enlisted,47441,9,2,7
2013,Enlisted,47501,23,2,21
2013,Enlisted,47546,49,10,39
2013,Enlisted,47591,18,9,9
2013,Enlisted,47715,95,10,85
2013,Enlisted,47804,45,6,39
2013,Enlisted,47834,12,1,11
2013,Enlisted,47872,15,3,12
2013,Enlisted,47904,9,1,8
2013,Enlisted,47905,57,13,44
2013,Enlisted,47933,24,6,18
2013,Enlisted,47960,2,0,2
2013,Enlisted,47977,15,2,13
2013,Enlisted,47978,15,1,14
2013,Enlisted,48060,10,3,7
2013,Enlisted,48180,54,5,49
2013,Enlisted,48197,20,2,18
2013,Enlisted,48208,50,8,42
2013,Enlisted,48234,45,19,26
2013,Enlisted,48341,21,5,16
2013,Enlisted,48446,13,2,11
2013,Enlisted,48503,40,9,31
2013,Enlisted,48601,13,6,7
2013,Enlisted,48640,12,2,10
2013,Enlisted,48642,4,2,2
2013,Enlisted,48706,28,4,24
2013,Enlisted,48801,9,2,7
2013,Enlisted,48813,9,0,9
2013,Enlisted,48817,21,2,19
2013,Enlisted,48837,58,9,49
2013,Enlisted,48838,16,5,11
2013,Enlisted,48843,49,5,44
2013,Enlisted,48906,46,13,33
2013,Enlisted,49009,45,5,40
2013,Enlisted,49012,100,16,84
2013,Enlisted,49047,3,1,2
2013,Enlisted,49091,17,1,16
2013,Enlisted,49201,15,1,14
2013,Enlisted,49202,16,0,16
2013,Enlisted,49221,4,2,2
2013,Enlisted,49224,14,0,14
2013,Enlisted,49307,12,3,9
2013,Enlisted,49437,35,7,28
2013,Enlisted,49509,80,15,65
2013,Enlisted,49601,15,8,7
2013,Enlisted,49660,7,1,6
2013,Enlisted,49707,1,0,1
2013,Enlisted,49721,10,5,5
2013,Enlisted,49739,58,11,47
2013,Enlisted,49783,21,3,18
2013,Enlisted,49802,11,2,9
2013,Enlisted,49837,8,0,8
2013,Enlisted,49849,10,3,7
2013,Enlisted,49855,5,0,5
2013,Enlisted,49908,12,1,11
2013,Enlisted,49913,9,2,7
2013,Enlisted,49935,4,0,4
2013,Enlisted,50025,8,1,7
2013,Enlisted,50036,49,4,45
2013,Enlisted,50126,19,4,15
2013,Enlisted,50131,273,50,223
2013,Enlisted,50138,11,1,10
2013,Enlisted,50158,34,4,30
2013,Enlisted,50220,10,1,9
2013,Enlisted,50401,16,0,16
2013,Enlisted,50501,24,8,16
2013,Enlisted,50511,13,4,9
2013,Enlisted,50533,3,0,3
2013,Enlisted,50566,8,1,7
2013,Enlisted,50588,16,1,15
2013,Enlisted,50616,10,2,8
2013,Enlisted,50662,17,4,13
2013,Enlisted,50703,60,12,48
2013,Enlisted,50841,9,3,6
2013,Enlisted,51031,23,4,19
2013,Enlisted,51111,33,1,32
2013,Enlisted,51201,10,0,10
2013,Enlisted,51301,6,0,6
2013,Enlisted,51334,5,0,5
2013,Enlisted,51401,11,3,8
2013,Enlisted,51442,16,1,15
2013,Enlisted,51503,25,6,19
2013,Enlisted,51601,9,2,7
2013,Enlisted,52002,43,10,33
2013,Enlisted,52246,61,14,47
2013,Enlisted,52353,11,1,10
2013,Enlisted,52404,70,8,62
2013,Enlisted,52501,7,0,7
2013,Enlisted,52544,16,2,14
2013,Enlisted,52556,24,3,21
2013,Enlisted,52577,14,1,13
2013,Enlisted,52632,27,6,21
2013,Enlisted,52638,12,1,11
2013,Enlisted,52641,10,1,9
2013,Enlisted,52732,14,1,13
2013,Enlisted,52761,10,1,9
2013,Enlisted,52806,40,9,31
2013,Enlisted,53027,3,0,3
2013,Enlisted,53066,11,4,7
2013,Enlisted,53073,13,0,13
2013,Enlisted,53089,15,2,13
2013,Enlisted,53094,13,3,10
2013,Enlisted,53095,20,4,16
2013,Enlisted,53105,23,1,22
2013,Enlisted,53121,16,1,15
2013,Enlisted,53144,1,1,0
2013,Enlisted,53154,5,0,5
2013,Enlisted,53186,21,2,19
2013,Enlisted,53190,23,2,21
2013,Enlisted,53212,47,7,40
2013,Enlisted,53511,5,2,3
2013,Enlisted,53538,20,8,12
2013,Enlisted,53545,13,0,13
2013,Enlisted,53581,13,2,11
2013,Enlisted,53704,135,32,103
2013,Enlisted,53818,9,0,9
2013,Enlisted,53821,14,0,14
2013,Enlisted,53901,9,1,8
2013,Enlisted,53913,11,1,10
2013,Enlisted,53948,7,2,5
2013,Enlisted,53959,15,6,9
2013,Enlisted,53963,18,3,15
2013,Enlisted,54017,14,4,10
2013,Enlisted,54022,11,4,7
2013,Enlisted,54143,30,3,27
2013,Enlisted,54241,6,2,4
2013,Enlisted,54303,19,3,16
2013,Enlisted,54401,17,2,15
2013,Enlisted,54405,14,1,13
2013,Enlisted,54409,9,1,8
2013,Enlisted,54449,15,2,13
2013,Enlisted,54451,8,1,7
2013,Enlisted,54452,6,1,5
2013,Enlisted,54455,1,0,1
2013,Enlisted,54456,22,1,21
2013,Enlisted,54481,15,0,15
2013,Enlisted,54487,6,2,4
2013,Enlisted,54495,26,2,24
2013,Enlisted,54501,8,1,7
2013,Enlisted,54612,15,2,13
2013,Enlisted,54615,11,0,11
2013,Enlisted,54618,32,8,24
2013,Enlisted,54650,19,4,15
2013,Enlisted,54656,9,0,9
2013,Enlisted,54660,12,1,11
2013,Enlisted,54665,13,1,12
2013,Enlisted,54703,24,2,22
2013,Enlisted,54729,23,2,21
2013,Enlisted,54751,32,5,27
2013,Enlisted,54801,5,0,5
2013,Enlisted,54806,10,1,9
2013,Enlisted,54843,16,1,15
2013,Enlisted,54868,13,3,10
2013,Enlisted,54880,24,5,19
2013,Enlisted,54901,40,4,36
2013,Enlisted,54914,37,5,32
2013,Enlisted,54923,1,1,0
2013,Enlisted,54929,13,0,13
2013,Enlisted,54935,28,9,19
2013,Enlisted,54971,18,1,17
2013,Enlisted,54981,7,0,7
2013,Enlisted,55008,13,3,10
2013,Enlisted,55016,34,5,29
2013,Enlisted,55021,27,5,22
2013,Enlisted,55033,12,1,11
2013,Enlisted,55057,19,1,18
2013,Enlisted,55060,14,1,13
2013,Enlisted,55063,38,5,33
2013,Enlisted,55066,15,3,12
2013,Enlisted,55068,60,17,43
2013,Enlisted,55077,27,1,26
2013,Enlisted,55082,45,3,42
2013,Enlisted,55101,106,16,90
2013,Enlisted,55106,55,10,45
2013,Enlisted,55107,67,11,56
2013,Enlisted,55112,14,2,12
2013,Enlisted,55113,25,4,21
2013,Enlisted,55118,61,6,55
2013,Enlisted,55122,17,3,14
2013,Enlisted,55303,29,5,24
2013,Enlisted,55350,16,1,15
2013,Enlisted,55355,17,4,13
2013,Enlisted,55362,15,3,12
2013,Enlisted,55413,6,1,5
2013,Enlisted,55431,83,19,64
2013,Enlisted,55443,33,9,24
2013,Enlisted,55719,14,2,12
2013,Enlisted,55720,41,1,40
2013,Enlisted,55744,14,2,12
2013,Enlisted,55746,42,2,40
2013,Enlisted,55811,87,7,80
2013,Enlisted,55904,38,3,35
2013,Enlisted,55912,19,11,8
2013,Enlisted,55987,19,2,17
2013,Enlisted,56001,47,9,38
2013,Enlisted,56007,33,5,28
2013,Enlisted,56021,12,2,10
2013,Enlisted,56031,9,4,5
2013,Enlisted,56073,8,1,7
2013,Enlisted,56081,12,0,12
2013,Enlisted,56082,9,1,8
2013,Enlisted,56143,9,0,9
2013,Enlisted,56156,11,3,8
2013,Enlisted,56164,7,2,5
2013,Enlisted,56201,10,1,9
2013,Enlisted,56208,9,0,9
2013,Enlisted,56256,10,0,10
2013,Enlisted,56258,14,4,10
2013,Enlisted,56265,12,1,11
2013,Enlisted,56267,11,1,10
2013,Enlisted,56277,9,2,7
2013,Enlisted,56278,16,0,16
2013,Enlisted,56283,2,1,1
2013,Enlisted,56303,81,11,70
2013,Enlisted,56308,38,7,31
2013,Enlisted,56345,123,18,105
2013,Enlisted,56347,6,2,4
2013,Enlisted,56378,10,4,6
2013,Enlisted,56401,21,3,18
2013,Enlisted,56482,26,3,23
2013,Enlisted,56501,13,1,12
2013,Enlisted,56537,18,0,18
2013,Enlisted,56560,29,2,27
2013,Enlisted,56601,14,4,10
2013,Enlisted,56701,25,5,20
2013,Enlisted,56716,14,1,13
2013,Enlisted,57006,12,0,12
2013,Enlisted,57028,5,1,4
2013,Enlisted,57042,21,2,19
2013,Enlisted,57069,13,1,12
2013,Enlisted,57078,2,0,2
2013,Enlisted,57104,36,3,33
2013,Enlisted,57201,13,1,12
2013,Enlisted,57231,7,1,6
2013,Enlisted,57252,14,1,13
2013,Enlisted,57274,4,0,4
2013,Enlisted,57301,14,4,10
2013,Enlisted,57325,16,3,13
2013,Enlisted,57350,1,0,1
2013,Enlisted,57366,4,0,4
2013,Enlisted,57380,17,1,16
2013,Enlisted,57401,14,4,10
2013,Enlisted,57469,6,0,6
2013,Enlisted,57501,12,0,12
2013,Enlisted,57601,6,1,5
2013,Enlisted,57702,31,8,23
2013,Enlisted,57703,23,8,15
2013,Enlisted,57717,6,0,6
2013,Enlisted,57783,9,2,7
2013,Enlisted,57785,2,0,2
2013,Enlisted,58054,4,0,4
2013,Enlisted,58072,11,3,8
2013,Enlisted,58075,7,0,7
2013,Enlisted,58102,52,8,44
2013,Enlisted,58201,43,5,38
2013,Enlisted,58220,4,0,4
2013,Enlisted,58237,5,1,4
2013,Enlisted,58257,9,1,8
2013,Enlisted,58301,20,7,13
2013,Enlisted,58318,10,0,10
2013,Enlisted,58324,11,1,10
2013,Enlisted,58368,2,1,1
2013,Enlisted,58402,14,3,11
2013,Enlisted,58421,4,1,3
2013,Enlisted,58433,2,0,2
2013,Enlisted,58495,2,0,2
2013,Enlisted,58506,62,10,52
2013,Enlisted,58545,1,0,1
2013,Enlisted,58601,10,0,10
2013,Enlisted,58646,3,0,3
2013,Enlisted,58702,29,10,19
2013,Enlisted,58802,11,2,9
2013,Enlisted,59036,1,0,1
2013,Enlisted,59047,4,0,4
2013,Enlisted,59102,51,11,40
2013,Enlisted,59218,4,1,3
2013,Enlisted,59230,5,1,4
2013,Enlisted,59270,5,0,5
2013,Enlisted,59301,10,2,8
2013,Enlisted,59405,4,2,2
2013,Enlisted,59457,8,0,8
2013,Enlisted,59501,6,2,4
2013,Enlisted,59538,7,2,5
2013,Enlisted,59601,6,0,6
2013,Enlisted,59602,30,5,25
2013,Enlisted,59604,13,3,10
2013,Enlisted,59636,34,15,19
2013,Enlisted,59701,14,3,11
2013,Enlisted,59711,10,0,10
2013,Enlisted,59714,44,11,33
2013,Enlisted,59725,5,1,4
2013,Enlisted,59808,36,10,26
2013,Enlisted,59840,17,2,15
2013,Enlisted,59901,31,5,26
2013,Enlisted,59923,6,0,6
2013,Enlisted,60085,9,5,4
2013,Enlisted,60098,17,6,11
2013,Enlisted,60120,43,15,28
2013,Enlisted,60178,21,0,21
2013,Enlisted,60435,36,7,29
2013,Enlisted,60472,87,16,71
2013,Enlisted,60505,23,5,18
2013,Enlisted,60546,113,22,91
2013,Enlisted,60615,42,8,34
2013,Enlisted,60616,45,26,19
2013,Enlisted,60638,24,5,19
2013,Enlisted,60651,26,4,22
2013,Enlisted,60901,29,6,23
2013,Enlisted,61021,22,2,20
2013,Enlisted,61032,41,2,39
2013,Enlisted,61071,11,3,8
2013,Enlisted,61115,81,11,70
2013,Enlisted,61264,44,12,32
2013,Enlisted,61341,6,1,5
2013,Enlisted,61364,17,2,15
2013,Enlisted,61401,38,1,37
2013,Enlisted,61434,21,6,15
2013,Enlisted,61443,16,4,12
2013,Enlisted,61455,16,3,13
2013,Enlisted,61607,85,11,74
2013,Enlisted,61701,28,8,20
2013,Enlisted,61734,7,2,5
2013,Enlisted,61764,23,2,21
2013,Enlisted,61801,25,9,16
2013,Enlisted,61820,16,2,14
2013,Enlisted,61834,25,1,24
2013,Enlisted,61938,12,1,11
2013,Enlisted,61944,14,1,13
2013,Enlisted,61951,37,2,35
2013,Enlisted,62056,33,10,23
2013,Enlisted,62205,6,1,5
2013,Enlisted,62269,31,4,27
2013,Enlisted,62286,36,5,31
2013,Enlisted,62305,17,2,15
2013,Enlisted,62401,31,1,30
2013,Enlisted,62439,23,2,21
2013,Enlisted,62521,69,20,49
2013,Enlisted,62618,20,4,16
2013,Enlisted,62702,100,19,81
2013,Enlisted,62864,46,5,41
2013,Enlisted,62896,49,15,34
2013,Enlisted,62959,32,9,23
2013,Enlisted,62966,27,5,22
2013,Enlisted,63020,19,1,18
2013,Enlisted,63028,64,14,50
2013,Enlisted,63044,21,3,18
2013,Enlisted,63077,32,6,26
2013,Enlisted,63109,101,33,68
2013,Enlisted,63125,118,27,91
2013,Enlisted,63383,29,4,25
2013,Enlisted,63401,19,3,16
2013,Enlisted,63552,24,8,16
2013,Enlisted,63640,39,8,31
2013,Enlisted,63645,4,0,4
2013,Enlisted,63703,45,9,36
2013,Enlisted,63755,17,4,13
2013,Enlisted,63775,25,6,19
2013,Enlisted,63801,6,1,5
2013,Enlisted,63841,11,1,10
2013,Enlisted,63857,14,3,11
2013,Enlisted,63873,4,0,4
2013,Enlisted,63901,9,4,5
2013,Enlisted,63935,10,1,9
2013,Enlisted,64052,17,6,11
2013,Enlisted,64067,27,4,23
2013,Enlisted,64085,39,2,37
2013,Enlisted,64093,15,1,14
2013,Enlisted,64129,119,33,86
2013,Enlisted,64402,10,6,4
2013,Enlisted,64468,16,4,12
2013,Enlisted,64506,31,9,22
2013,Enlisted,64601,12,4,8
2013,Enlisted,64683,6,1,5
2013,Enlisted,64701,43,10,33
2013,Enlisted,64735,21,3,18
2013,Enlisted,64759,7,1,6
2013,Enlisted,64772,9,5,4
2013,Enlisted,64804,35,9,26
2013,Enlisted,64831,15,5,10
2013,Enlisted,64836,5,1,4
2013,Enlisted,64850,2,0,2
2013,Enlisted,65101,28,10,18
2013,Enlisted,65109,42,11,31
2013,Enlisted,65202,20,3,17
2013,Enlisted,65233,39,10,29
2013,Enlisted,65251,7,3,4
2013,Enlisted,65265,5,2,3
2013,Enlisted,65270,8,1,7
2013,Enlisted,65301,28,5,23
2013,Enlisted,65305,36,11,25
2013,Enlisted,65340,37,11,26
2013,Enlisted,65401,15,2,13
2013,Enlisted,65473,41,15,26
2013,Enlisted,65536,16,1,15
2013,Enlisted,65605,9,1,8
2013,Enlisted,65708,24,6,18
2013,Enlisted,65723,19,1,18
2013,Enlisted,65775,22,4,18
2013,Enlisted,65802,80,13,67
2013,Enlisted,65803,48,10,38
2013,Enlisted,66027,13,8,5
2013,Enlisted,66044,37,10,27
2013,Enlisted,66061,59,11,48
2013,Enlisted,66067,13,3,10
2013,Enlisted,66071,5,0,5
2013,Enlisted,66102,59,20,39
2013,Enlisted,66219,6,2,4
2013,Enlisted,66220,9,2,7
2013,Enlisted,66434,7,2,5
2013,Enlisted,66436,2,1,1
2013,Enlisted,66441,14,2,12
2013,Enlisted,66503,64,25,39
2013,Enlisted,66508,7,2,5
2013,Enlisted,66611,5,4,1
2013,Enlisted,66619,76,11,65
2013,Enlisted,66749,27,4,23
2013,Enlisted,66762,15,2,13
2013,Enlisted,66801,17,4,13
2013,Enlisted,66901,7,1,6
2013,Enlisted,66967,11,1,10
2013,Enlisted,67010,12,2,10
2013,Enlisted,67114,8,0,8
2013,Enlisted,67124,11,0,11
2013,Enlisted,67208,26,6,20
2013,Enlisted,67213,30,11,19
2013,Enlisted,67217,47,14,33
2013,Enlisted,67337,17,2,15
2013,Enlisted,67401,8,4,4
2013,Enlisted,67410,6,1,5
2013,Enlisted,67432,3,0,3
2013,Enlisted,67501,18,1,17
2013,Enlisted,67530,17,1,16
2013,Enlisted,67601,16,4,12
2013,Enlisted,67654,6,1,5
2013,Enlisted,67701,7,0,7
2013,Enlisted,67801,7,0,7
2013,Enlisted,67901,14,2,12
2013,Enlisted,68003,2,2,0
2013,Enlisted,68025,14,3,11
2013,Enlisted,68041,1,0,1
2013,Enlisted,68066,18,4,14
2013,Enlisted,68106,19,4,15
2013,Enlisted,68142,41,6,35
2013,Enlisted,68310,22,7,15
2013,Enlisted,68410,6,1,5
2013,Enlisted,68434,16,4,12
2013,Enlisted,68467,4,0,4
2013,Enlisted,68503,5,3,2
2013,Enlisted,68508,33,10,23
2013,Enlisted,68524,67,10,57
2013,Enlisted,68602,9,0,9
2013,Enlisted,68701,12,1,11
2013,Enlisted,68763,2,1,1
2013,Enlisted,68787,5,0,5
2013,Enlisted,68803,44,6,38
2013,Enlisted,68822,3,0,3
2013,Enlisted,68847,20,2,18
2013,Enlisted,68901,25,3,22
2013,Enlisted,69001,2,1,1
2013,Enlisted,69101,12,1,11
2013,Enlisted,69162,5,1,4
2013,Enlisted,69337,9,3,6
2013,Enlisted,69361,8,0,8
2013,Enlisted,70072,26,6,20
2013,Enlisted,70084,13,1,12
2013,Enlisted,70117,97,22,75
2013,Enlisted,70364,32,9,23
2013,Enlisted,70390,15,8,7
2013,Enlisted,70401,59,25,34
2013,Enlisted,70403,10,3,7
2013,Enlisted,70427,2,0,2
2013,Enlisted,70433,42,6,36
2013,Enlisted,70438,10,4,6
2013,Enlisted,70460,42,1,41
2013,Enlisted,70508,50,8,42
2013,Enlisted,70510,20,1,19
2013,Enlisted,70517,21,3,18
2013,Enlisted,70526,14,7,7
2013,Enlisted,70538,6,4,2
2013,Enlisted,70544,29,7,22
2013,Enlisted,70546,22,2,20
2013,Enlisted,70563,16,3,13
2013,Enlisted,70570,17,2,15
2013,Enlisted,70582,10,0,10
2013,Enlisted,70586,4,0,4
2013,Enlisted,70601,15,3,12
2013,Enlisted,70605,8,0,8
2013,Enlisted,70633,10,0,10
2013,Enlisted,70634,8,4,4
2013,Enlisted,70714,31,2,29
2013,Enlisted,70721,67,10,57
2013,Enlisted,70737,37,2,35
2013,Enlisted,70760,15,4,11
2013,Enlisted,70764,17,2,15
2013,Enlisted,70807,36,4,32
2013,Enlisted,70820,33,7,26
2013,Enlisted,71019,11,4,7
2013,Enlisted,71023,26,5,21
2013,Enlisted,71055,25,6,19
2013,Enlisted,71101,51,14,37
2013,Enlisted,71111,6,1,5
2013,Enlisted,71203,28,5,23
2013,Enlisted,71220,5,0,5
2013,Enlisted,71232,5,1,4
2013,Enlisted,71241,9,1,8
2013,Enlisted,71251,4,0,4
2013,Enlisted,71263,4,0,4
2013,Enlisted,71270,46,4,42
2013,Enlisted,71292,29,2,27
2013,Enlisted,71295,4,1,3
2013,Enlisted,71303,26,5,21
2013,Enlisted,71322,8,0,8
2013,Enlisted,71342,10,1,9
2013,Enlisted,71343,4,0,4
2013,Enlisted,71351,9,1,8
2013,Enlisted,71360,126,31,95
2013,Enlisted,71373,1,0,1
2013,Enlisted,71415,2,0,2
2013,Enlisted,71417,19,4,15
2013,Enlisted,71457,16,2,14
2013,Enlisted,71459,23,12,11
2013,Enlisted,71463,11,4,7
2013,Enlisted,71483,12,3,9
2013,Enlisted,71601,20,2,18
2013,Enlisted,71602,1,0,1
2013,Enlisted,71635,1,0,1
2013,Enlisted,71639,4,0,4
2013,Enlisted,71653,4,1,3
2013,Enlisted,71655,9,0,9
2013,Enlisted,71671,13,3,10
2013,Enlisted,71701,11,1,10
2013,Enlisted,71730,4,0,4
2013,Enlisted,71742,7,0,7
2013,Enlisted,71753,16,3,13
2013,Enlisted,71801,8,1,7
2013,Enlisted,71823,11,1,10
2013,Enlisted,71854,9,4,5
2013,Enlisted,71857,20,4,16
2013,Enlisted,71913,16,2,14
2013,Enlisted,71923,13,1,12
2013,Enlisted,71953,11,5,6
2013,Enlisted,72007,7,2,5
2013,Enlisted,72012,5,0,5
2013,Enlisted,72015,22,2,20
2013,Enlisted,72021,11,4,7
2013,Enlisted,72023,26,5,21
2013,Enlisted,72032,14,4,10
2013,Enlisted,72034,2,0,2
2013,Enlisted,72064,4,0,4
2013,Enlisted,72086,11,2,9
2013,Enlisted,72104,15,3,12
2013,Enlisted,72110,7,3,4
2013,Enlisted,72112,22,0,22
2013,Enlisted,72114,49,6,43
2013,Enlisted,72119,4,4,0
2013,Enlisted,72126,13,1,12
2013,Enlisted,72143,25,7,18
2013,Enlisted,72144,4,0,4
2013,Enlisted,72150,13,0,13
2013,Enlisted,72160,6,2,4
2013,Enlisted,72199,242,47,195
2013,Enlisted,72205,18,3,15
2013,Enlisted,72301,17,3,14
2013,Enlisted,72315,14,5,9
2013,Enlisted,72335,20,4,16
2013,Enlisted,72390,11,2,9
2013,Enlisted,72396,6,0,6
2013,Enlisted,72401,38,8,30
2013,Enlisted,72432,5,0,5
2013,Enlisted,72450,25,4,21
2013,Enlisted,72461,4,1,3
2013,Enlisted,72476,9,1,8
2013,Enlisted,72501,10,2,8
2013,Enlisted,72543,16,0,16
2013,Enlisted,72601,6,2,4
2013,Enlisted,72616,2,0,2
2013,Enlisted,72650,5,1,4
2013,Enlisted,72653,14,3,11
2013,Enlisted,72701,20,3,17
2013,Enlisted,72712,28,3,25
2013,Enlisted,72744,14,2,12
2013,Enlisted,72756,8,1,7
2013,Enlisted,72761,6,1,5
2013,Enlisted,72801,17,2,15
2013,Enlisted,72802,17,2,15
2013,Enlisted,72830,6,0,6
2013,Enlisted,72834,19,5,14
2013,Enlisted,72855,9,0,9
2013,Enlisted,72905,17,8,9
2013,Enlisted,72923,31,3,28
2013,Enlisted,72927,12,5,7
2013,Enlisted,72949,4,1,3
2013,Enlisted,73034,51,15,36
2013,Enlisted,73051,12,4,8
2013,Enlisted,73064,73,15,58
2013,Enlisted,73069,142,40,102
2013,Enlisted,73111,14,13,1
2013,Enlisted,73141,14,4,10
2013,Enlisted,73179,1,1,0
2013,Enlisted,73401,7,1,6
2013,Enlisted,73503,50,6,44
2013,Enlisted,73521,15,6,9
2013,Enlisted,73542,7,2,5
2013,Enlisted,73705,20,3,17
2013,Enlisted,74003,20,5,15
2013,Enlisted,74012,20,5,15
2013,Enlisted,74014,77,22,55
2013,Enlisted,74017,10,5,5
2013,Enlisted,74067,2,2,0
2013,Enlisted,74075,49,12,37
2013,Enlisted,74107,65,19,46
2013,Enlisted,74116,27,6,21
2013,Enlisted,74301,19,3,16
2013,Enlisted,74403,59,8,51
2013,Enlisted,74423,17,3,14
2013,Enlisted,74447,34,2,32
2013,Enlisted,74501,49,6,43
2013,Enlisted,74601,19,1,18
2013,Enlisted,74701,25,4,21
2013,Enlisted,74804,17,4,13
2013,Enlisted,74820,33,5,28
2013,Enlisted,74834,36,7,29
2013,Enlisted,74848,14,2,12
2013,Enlisted,74953,16,2,14
2013,Enlisted,75020,7,4,3
2013,Enlisted,75051,204,69,135
2013,Enlisted,75077,36,7,29
2013,Enlisted,75098,20,7,13
2013,Enlisted,75110,30,14,16
2013,Enlisted,75159,89,43,46
2013,Enlisted,75160,38,10,28
2013,Enlisted,75237,41,19,22
2013,Enlisted,75402,36,10,26
2013,Enlisted,75570,30,10,20
2013,Enlisted,75662,12,3,9
2013,Enlisted,75672,14,7,7
2013,Enlisted,75709,22,12,10
2013,Enlisted,75803,18,6,12
2013,Enlisted,75901,21,8,13
2013,Enlisted,76086,13,3,10
2013,Enlisted,76105,56,31,25
2013,Enlisted,76108,78,36,42
2013,Enlisted,76115,37,13,24
2013,Enlisted,76234,16,4,12
2013,Enlisted,76302,27,18,9
2013,Enlisted,76401,17,9,8
2013,Enlisted,76502,58,35,23
2013,Enlisted,76528,53,31,22
2013,Enlisted,76542,104,74,30
2013,Enlisted,76574,30,18,12
2013,Enlisted,76707,122,65,57
2013,Enlisted,76801,16,8,8
2013,Enlisted,76905,43,14,29
2013,Enlisted,77034,144,55,89
2013,Enlisted,77067,64,25,39
2013,Enlisted,77082,141,71,70
2013,Enlisted,77340,9,7,2
2013,Enlisted,77437,29,8,21
2013,Enlisted,77471,30,9,21
2013,Enlisted,77515,35,9,26
2013,Enlisted,77568,14,4,10
2013,Enlisted,77802,54,22,32
2013,Enlisted,77833,9,4,5
2013,Enlisted,77904,21,10,11
2013,Enlisted,78041,36,15,21
2013,Enlisted,78130,34,17,17
2013,Enlisted,78155,21,11,10
2013,Enlisted,78218,128,68,60
2013,Enlisted,78219,36,20,16
2013,Enlisted,78257,237,112,125
2013,Enlisted,78363,28,9,19
2013,Enlisted,78416,9,5,4
2013,Enlisted,78520,31,8,23
2013,Enlisted,78596,97,35,62
2013,Enlisted,78602,56,18,38
2013,Enlisted,78624,66,39,27
2013,Enlisted,78665,47,22,25
2013,Enlisted,78666,139,69,70
2013,Enlisted,78703,367,171,196
2013,Enlisted,78719,56,24,32
2013,Enlisted,78723,8,5,3
2013,Enlisted,78746,3,2,1
2013,Enlisted,78763,5,3,2
2013,Enlisted,78861,24,10,14
2013,Enlisted,79095,8,4,4
2013,Enlisted,79107,32,8,24
2013,Enlisted,79205,2,1,1
2013,Enlisted,79403,63,23,40
2013,Enlisted,79607,26,6,20
2013,Enlisted,79706,36,20,16
2013,Enlisted,79924,16,8,8
2013,Enlisted,79936,146,55,91
2013,Enlisted,80011,52,25,27
2013,Enlisted,80012,18,10,8
2013,Enlisted,80112,4,4,0
2013,Enlisted,80137,50,36,14
2013,Enlisted,80216,70,26,44
2013,Enlisted,80304,23,11,12
2013,Enlisted,80501,10,3,7
2013,Enlisted,80504,28,13,15
2013,Enlisted,80521,24,11,13
2013,Enlisted,80621,27,13,14
2013,Enlisted,80751,1,0,1
2013,Enlisted,80907,27,11,16
2013,Enlisted,80913,96,52,44
2013,Enlisted,80916,15,9,6
2013,Enlisted,81004,15,3,12
2013,Enlisted,81050,6,2,4
2013,Enlisted,81101,14,5,9
2013,Enlisted,81303,8,2,6
2013,Enlisted,81401,16,6,10
2013,Enlisted,81501,45,15,30
2013,Enlisted,81637,2,2,0
2013,Enlisted,82009,44,20,24
2013,Enlisted,82072,11,5,6
2013,Enlisted,82214,23,4,19
2013,Enlisted,82240,11,2,9
2013,Enlisted,82431,13,5,8
2013,Enlisted,82435,4,2,2
2013,Enlisted,82520,8,0,8
2013,Enlisted,82604,9,5,4
2013,Enlisted,82633,3,2,1
2013,Enlisted,82716,17,2,15
2013,Enlisted,82801,10,0,10
2013,Enlisted,82901,18,1,17
2013,Enlisted,82931,6,1,5
2013,Enlisted,83110,10,1,9
2013,Enlisted,83202,7,3,4
2013,Enlisted,83221,3,2,1
2013,Enlisted,83263,3,1,2
2013,Enlisted,83301,16,4,12
2013,Enlisted,83318,3,0,3
2013,Enlisted,83330,12,1,11
2013,Enlisted,83338,5,2,3
2013,Enlisted,83402,12,3,9
2013,Enlisted,83422,4,0,4
2013,Enlisted,83440,1,0,1
2013,Enlisted,83442,2,1,1
2013,Enlisted,83501,17,3,14
2013,Enlisted,83530,3,1,2
2013,Enlisted,83544,8,0,8
2013,Enlisted,83605,21,4,17
2013,Enlisted,83617,9,3,6
2013,Enlisted,83647,10,0,10
2013,Enlisted,83661,4,0,4
2013,Enlisted,83676,15,1,14
2013,Enlisted,83687,9,1,8
2013,Enlisted,83705,127,37,90
2013,Enlisted,83805,1,1,0
2013,Enlisted,83843,7,0,7
2013,Enlisted,83854,13,4,9
2013,Enlisted,83864,5,0,5
2013,Enlisted,84003,18,6,12
2013,Enlisted,84020,54,17,37
2013,Enlisted,84043,6,1,5
2013,Enlisted,84058,24,9,15
2013,Enlisted,84065,175,47,128
2013,Enlisted,84074,17,5,12
2013,Enlisted,84084,90,15,75
2013,Enlisted,84116,19,6,13
2013,Enlisted,84321,11,1,10
2013,Enlisted,84323,3,2,1
2013,Enlisted,84404,3,1,2
2013,Enlisted,84405,58,11,47
2013,Enlisted,84501,3,0,3
2013,Enlisted,84511,10,3,7
2013,Enlisted,84631,4,1,3
2013,Enlisted,84642,6,0,6
2013,Enlisted,84647,5,3,2
2013,Enlisted,84660,41,7,34
2013,Enlisted,84663,7,3,4
2013,Enlisted,84701,5,1,4
2013,Enlisted,84713,4,1,3
2013,Enlisted,84720,25,5,20
2013,Enlisted,84770,9,1,8
2013,Enlisted,84790,28,7,21
2013,Enlisted,85008,183,55,128
2013,Enlisted,85015,2,1,1
2013,Enlisted,85020,18,8,10
2013,Enlisted,85122,16,4,12
2013,Enlisted,85128,1,1,0
2013,Enlisted,85132,55,22,33
2013,Enlisted,85201,56,19,37
2013,Enlisted,85222,18,5,13
2013,Enlisted,85228,2,2,0
2013,Enlisted,85281,9,4,5
2013,Enlisted,85286,18,9,9
2013,Enlisted,85301,5,3,2
2013,Enlisted,85364,7,3,4
2013,Enlisted,85396,19,10,9
2013,Enlisted,85607,9,5,4
2013,Enlisted,85653,59,17,42
2013,Enlisted,85706,56,11,45
2013,Enlisted,85713,46,20,26
2013,Enlisted,85901,17,1,16
2013,Enlisted,86015,89,16,73
2013,Enlisted,86301,40,15,25
2013,Enlisted,87002,1,0,1
2013,Enlisted,87123,58,14,44
2013,Enlisted,87144,71,16,55
2013,Enlisted,87305,5,0,5
2013,Enlisted,87401,39,10,29
2013,Enlisted,87508,20,5,15
2013,Enlisted,87532,19,1,18
2013,Enlisted,87557,6,0,6
2013,Enlisted,87701,10,1,9
2013,Enlisted,87740,2,0,2
2013,Enlisted,87747,4,1,3
2013,Enlisted,88007,92,18,74
2013,Enlisted,88026,1,1,0
2013,Enlisted,88101,13,4,9
2013,Enlisted,88203,23,11,12
2013,Enlisted,88220,6,1,5
2013,Enlisted,88240,2,0,2
2013,Enlisted,88310,18,5,13
2013,Enlisted,88401,3,1,2
2013,Enlisted,88415,4,1,3
2013,Enlisted,88435,3,0,3
2013,Enlisted,89002,32,6,26
2013,Enlisted,89032,7,3,4
2013,Enlisted,89115,240,50,190
2013,Enlisted,89139,52,9,43
2013,Enlisted,89301,12,0,12
2013,Enlisted,89406,15,6,9
2013,Enlisted,89445,6,1,5
2013,Enlisted,89447,22,7,15
2013,Enlisted,89506,92,18,74
2013,Enlisted,89509,2,1,1
2013,Enlisted,89701,16,10,6
2013,Enlisted,89801,1,1,0
2013,Enlisted,90025,12,3,9
2013,Enlisted,90201,53,23,30
2013,Enlisted,90249,10,2,8
2013,Enlisted,90266,24,9,15
2013,Enlisted,90302,49,26,23
2013,Enlisted,90501,31,9,22
2013,Enlisted,90640,16,6,10
2013,Enlisted,90720,163,68,95
2013,Enlisted,90731,27,15,12
2013,Enlisted,90813,29,9,20
2013,Enlisted,90822,60,21,39
2013,Enlisted,91205,47,28,19
2013,Enlisted,91342,10,2,8
2013,Enlisted,91406,49,13,36
2013,Enlisted,91505,43,15,28
2013,Enlisted,91702,62,28,34
2013,Enlisted,91764,80,20,60
2013,Enlisted,91766,40,18,22
2013,Enlisted,91950,58,17,41
2013,Enlisted,92020,22,6,16
2013,Enlisted,92025,31,11,20
2013,Enlisted,92111,110,43,67
2013,Enlisted,92220,13,7,6
2013,Enlisted,92227,5,1,4
2013,Enlisted,92243,9,5,4
2013,Enlisted,92307,20,6,14
2013,Enlisted,92311,13,5,8
2013,Enlisted,92324,35,14,21
2013,Enlisted,92410,18,9,9
2013,Enlisted,92501,49,27,22
2013,Enlisted,92518,79,25,54
2013,Enlisted,92707,31,11,20
2013,Enlisted,92833,34,25,9
2013,Enlisted,92866,28,19,9
2013,Enlisted,92879,14,7,7
2013,Enlisted,93003,12,0,12
2013,Enlisted,93030,10,3,7
2013,Enlisted,93103,12,3,9
2013,Enlisted,93257,11,7,4
2013,Enlisted,93291,51,23,28
2013,Enlisted,93307,70,29,41
2013,Enlisted,93405,36,12,24
2013,Enlisted,93422,8,3,5
2013,Enlisted,93451,14,8,6
2013,Enlisted,93454,12,4,8
2013,Enlisted,93536,27,7,20
2013,Enlisted,93550,25,4,21
2013,Enlisted,93638,15,5,10
2013,Enlisted,93727,96,40,56
2013,Enlisted,93955,15,2,13
2013,Enlisted,94035,6,3,3
2013,Enlisted,94043,8,4,4
2013,Enlisted,94061,1,1,0
2013,Enlisted,94066,17,5,12
2013,Enlisted,94132,23,10,13
2013,Enlisted,94401,17,6,11
2013,Enlisted,94510,10,7,3
2013,Enlisted,94519,17,3,14
2013,Enlisted,94533,20,11,9
2013,Enlisted,94565,29,11,18
2013,Enlisted,94568,59,28,31
2013,Enlisted,94590,20,9,11
2013,Enlisted,94596,6,2,4
2013,Enlisted,94804,13,1,12
2013,Enlisted,94903,13,8,5
2013,Enlisted,94952,13,5,8
2013,Enlisted,95020,8,3,5
2013,Enlisted,95023,2,0,2
2013,Enlisted,95065,4,0,4
2013,Enlisted,95110,8,3,5
2013,Enlisted,95206,92,24,68
2013,Enlisted,95240,8,3,5
2013,Enlisted,95341,11,4,7
2013,Enlisted,95351,36,22,14
2013,Enlisted,95361,24,14,10
2013,Enlisted,95380,22,7,15
2013,Enlisted,95401,31,9,22
2013,Enlisted,95453,6,2,4
2013,Enlisted,95503,4,0,4
2013,Enlisted,95603,47,17,30
2013,Enlisted,95655,10,4,6
2013,Enlisted,95667,12,4,8
2013,Enlisted,95670,1,1,0
2013,Enlisted,95678,6,3,3
2013,Enlisted,95815,4,2,2
2013,Enlisted,95819,11,3,8
2013,Enlisted,95826,13,10,3
2013,Enlisted,95828,53,37,16
2013,Enlisted,95832,58,21,37
2013,Enlisted,95926,17,9,8
2013,Enlisted,95965,21,6,15
2013,Enlisted,95991,5,3,2
2013,Enlisted,96001,16,12,4
2013,Enlisted,96080,5,4,1
2013,Enlisted,96130,1,0,1
2013,Enlisted,96707,157,71,86
2013,Enlisted,96716,10,2,8
2013,Enlisted,96720,37,5,32
2013,Enlisted,96746,1,0,1
2013,Enlisted,96748,1,0,1
2013,Enlisted,96750,10,2,8
2013,Enlisted,96753,1,0,1
2013,Enlisted,96782,66,20,46
2013,Enlisted,96786,82,29,53
2013,Enlisted,96816,11,8,3
2013,Enlisted,96857,39,11,28
2013,Enlisted,96913,116,31,85
2013,Enlisted,97015,115,37,78
2013,Enlisted,97030,29,10,19
2013,Enlisted,97031,6,1,5
2013,Enlisted,97051,3,1,2
2013,Enlisted,97058,6,3,3
2013,Enlisted,97071,12,2,10
2013,Enlisted,97116,22,13,9
2013,Enlisted,97124,14,1,13
2013,Enlisted,97128,2,0,2
2013,Enlisted,97146,29,4,25
2013,Enlisted,97211,42,22,20
2013,Enlisted,97218,30,15,15
2013,Enlisted,97301,3,3,0
2013,Enlisted,97302,14,2,12
2013,Enlisted,97303,38,7,31
2013,Enlisted,97309,33,13,20
2013,Enlisted,97321,14,8,6
2013,Enlisted,97330,15,4,11
2013,Enlisted,97338,14,4,10
2013,Enlisted,97355,18,8,10
2013,Enlisted,97361,4,4,0
2013,Enlisted,97365,3,0,3
2013,Enlisted,97401,11,3,8
2013,Enlisted,97420,25,9,16
2013,Enlisted,97470,31,8,23
2013,Enlisted,97477,49,18,31
2013,Enlisted,97501,32,9,23
2013,Enlisted,97520,12,9,3
2013,Enlisted,97526,19,5,14
2013,Enlisted,97601,8,1,7
2013,Enlisted,97603,4,3,1
2013,Enlisted,97702,16,3,13
2013,Enlisted,97720,1,0,1
2013,Enlisted,97754,5,0,5
2013,Enlisted,97756,13,5,8
2013,Enlisted,97801,44,14,30
2013,Enlisted,97814,13,2,11
2013,Enlisted,97838,16,6,10
2013,Enlisted,97850,14,5,9
2013,Enlisted,97862,20,1,19
2013,Enlisted,97914,9,4,5
2013,Enlisted,98032,75,39,36
2013,Enlisted,98052,32,28,4
2013,Enlisted,98108,40,18,22
2013,Enlisted,98119,95,52,43
2013,Enlisted,98221,25,7,18
2013,Enlisted,98271,41,16,25
2013,Enlisted,98290,19,4,15
2013,Enlisted,98312,30,15,15
2013,Enlisted,98321,12,12,0
2013,Enlisted,98366,15,7,8
2013,Enlisted,98372,33,18,15
2013,Enlisted,98430,69,53,16
2013,Enlisted,98433,134,79,55
2013,Enlisted,98499,1,1,0
2013,Enlisted,98501,23,12,11
2013,Enlisted,98531,46,16,30
2013,Enlisted,98563,7,2,5
2013,Enlisted,98632,21,14,7
2013,Enlisted,98682,14,5,9
2013,Enlisted,98801,8,3,5
2013,Enlisted,98823,12,4,8
2013,Enlisted,98837,7,5,2
2013,Enlisted,98901,30,9,21
2013,Enlisted,98903,26,17,9
2013,Enlisted,98930,7,0,7
2013,Enlisted,99011,49,15,34
2013,Enlisted,99217,41,17,24
2013,Enlisted,99219,22,4,18
2013,Enlisted,99224,4,0,4
2013,Enlisted,99301,7,2,5
2013,Enlisted,99362,7,0,7
2013,Enlisted,99505,137,69,68
2013,Enlisted,99559,4,2,2
2013,Enlisted,99581,1,1,0
2013,Enlisted,99611,9,1,8
2013,Enlisted,99615,3,0,3
2013,Enlisted,99654,2,0,2
2013,Enlisted,99687,38,18,20
2013,Enlisted,99701,22,15,7
2013,Enlisted,99723,1,0,1
2013,Enlisted,99731,1,1,0
2013,Enlisted,99762,1,1,0
2013,Enlisted,99821,16,7,9
2013,Enlisted,99835,1,1,0
2013,Enlisted,99901,4,0,4
2013,Officer,     ,2,2,0
2013,Officer,00641,3,3,0
2013,Officer,00681,2,2,0
2013,Officer,00683,2,2,0
2013,Officer,00693,2,2,0
2013,Officer,00725,2,2,0
2013,Officer,00732,1,1,0
2013,Officer,00735,2,2,0
2013,Officer,00737,2,2,0
2013,Officer,00751,2,1,1
2013,Officer,00777,2,2,0
2013,Officer,00792,1,1,0
2013,Officer,00795,7,7,0
2013,Officer,00802,4,4,0
2013,Officer,00820,4,3,1
2013,Officer,00901,6,5,1
2013,Officer,00918,5,5,0
2013,Officer,00960,2,2,0
2013,Officer,01022,1,1,0
2013,Officer,01030,2,2,0
2013,Officer,01082,1,1,0
2013,Officer,01085,2,2,0
2013,Officer,01109,6,6,0
2013,Officer,01301,2,2,0
2013,Officer,01434,4,4,0
2013,Officer,01440,1,1,0
2013,Officer,01588,2,2,0
2013,Officer,01605,4,4,0
2013,Officer,01702,2,2,0
2013,Officer,01731,14,14,0
2013,Officer,01749,1,1,0
2013,Officer,01757,2,2,0
2013,Officer,01844,5,5,0
2013,Officer,01867,10,10,0
2013,Officer,01950,1,1,0
2013,Officer,02043,1,1,0
2013,Officer,02122,1,1,0
2013,Officer,02138,6,6,0
2013,Officer,02169,2,2,0
2013,Officer,02173,2,2,0
2013,Officer,02176,3,3,0
2013,Officer,02184,2,2,0
2013,Officer,02301,1,1,0
2013,Officer,02346,3,3,0
2013,Officer,02420,4,4,0
2013,Officer,02465,3,3,0
2013,Officer,02532,1,1,0
2013,Officer,02542,5,5,0
2013,Officer,02724,1,1,0
2013,Officer,02780,3,3,0
2013,Officer,02809,1,1,0
2013,Officer,02816,2,2,0
2013,Officer,02818,11,11,0
2013,Officer,02842,2,2,0
2013,Officer,02852,5,5,0
2013,Officer,02886,7,7,0
2013,Officer,02896,4,4,0
2013,Officer,02904,3,3,0
2013,Officer,03055,1,1,0
2013,Officer,03060,2,2,0
2013,Officer,03101,5,5,0
2013,Officer,03235,1,1,0
2013,Officer,03301,3,3,0
2013,Officer,03561,1,1,0
2013,Officer,03570,1,1,0
2013,Officer,03878,2,2,0
2013,Officer,04073,1,1,0
2013,Officer,04103,1,1,0
2013,Officer,04268,2,2,0
2013,Officer,04330,3,3,0
2013,Officer,04333,2,1,1
2013,Officer,04345,2,2,0
2013,Officer,04401,7,7,0
2013,Officer,04412,2,2,0
2013,Officer,04736,1,1,0
2013,Officer,05001,1,1,0
2013,Officer,05033,2,2,0
2013,Officer,05201,5,5,0
2013,Officer,05403,2,2,0
2013,Officer,05404,3,2,1
2013,Officer,05446,7,7,0
2013,Officer,05465,13,13,0
2013,Officer,05495,5,5,0
2013,Officer,05661,2,2,0
2013,Officer,05663,4,4,0
2013,Officer,05676,1,1,0
2013,Officer,05701,1,1,0
2013,Officer,05851,1,1,0
2013,Officer,05855,2,2,0
2013,Officer,06051,2,2,0
2013,Officer,06082,1,1,0
2013,Officer,06096,3,3,0
2013,Officer,06105,2,2,0
2013,Officer,06110,2,2,0
2013,Officer,06320,2,2,0
2013,Officer,06340,1,1,0
2013,Officer,06357,2,2,0
2013,Officer,06457,9,6,3
2013,Officer,06489,2,2,0
2013,Officer,06498,1,1,0
2013,Officer,06512,4,4,0
2013,Officer,06614,4,3,1
2013,Officer,06702,1,0,1
2013,Officer,06770,2,2,0
2013,Officer,07052,5,5,0
2013,Officer,07090,2,2,0
2013,Officer,07306,2,2,0
2013,Officer,07457,4,4,0
2013,Officer,07666,1,1,0
2013,Officer,07728,2,2,0
2013,Officer,07801,1,1,0
2013,Officer,07840,3,3,0
2013,Officer,07865,2,2,0
2013,Officer,07960,4,4,0
2013,Officer,08002,3,3,0
2013,Officer,08016,1,1,0
2013,Officer,08037,1,1,0
2013,Officer,08096,6,6,0
2013,Officer,08210,2,2,0
2013,Officer,08360,1,1,0
2013,Officer,08401,2,2,0
2013,Officer,08533,1,1,0
2013,Officer,08640,4,4,0
2013,Officer,08648,4,4,0
2013,Officer,08733,4,4,0
2013,Officer,08750,9,9,0
2013,Officer,08822,2,2,0
2013,Officer,08873,5,5,0
2013,Officer,10010,9,8,1
2013,Officer,10021,4,4,0
2013,Officer,10037,11,10,1
2013,Officer,10314,3,3,0
2013,Officer,10566,2,2,0
2013,Officer,10567,5,4,1
2013,Officer,10962,1,1,0
2013,Officer,11252,7,7,0
2013,Officer,11357,4,4,0
2013,Officer,11433,3,3,0
2013,Officer,11735,5,5,0
2013,Officer,11779,2,2,0
2013,Officer,12078,1,1,0
2013,Officer,12110,15,12,3
2013,Officer,12180,9,7,2
2013,Officer,12189,1,1,0
2013,Officer,12302,2,2,0
2013,Officer,12401,4,4,0
2013,Officer,12553,1,1,0
2013,Officer,12601,1,1,0
2013,Officer,12804,1,1,0
2013,Officer,13021,1,1,0
2013,Officer,13211,10,10,0
2013,Officer,13501,6,5,1
2013,Officer,13669,1,1,0
2013,Officer,13856,1,0,1
2013,Officer,13905,2,2,0
2013,Officer,14204,4,4,0
2013,Officer,14213,3,3,0
2013,Officer,14454,1,1,0
2013,Officer,14456,1,1,0
2013,Officer,14624,6,5,1
2013,Officer,14850,1,1,0
2013,Officer,15206,2,2,0
2013,Officer,15216,4,4,0
2013,Officer,15301,6,5,1
2013,Officer,15370,1,1,0
2013,Officer,15425,1,1,0
2013,Officer,15666,5,3,2
2013,Officer,15701,2,2,0
2013,Officer,15767,1,1,0
2013,Officer,15779,1,1,0
2013,Officer,15902,4,2,2
2013,Officer,15904,6,6,0
2013,Officer,16001,3,2,1
2013,Officer,16148,2,1,1
2013,Officer,16226,1,0,1
2013,Officer,16403,5,4,1
2013,Officer,16635,3,3,0
2013,Officer,16735,1,1,0
2013,Officer,16738,2,2,0
2013,Officer,16830,1,1,0
2013,Officer,16901,1,1,0
2013,Officer,17003,18,15,3
2013,Officer,17013,1,1,0
2013,Officer,17022,7,6,1
2013,Officer,17042,7,5,2
2013,Officer,17044,1,1,0
2013,Officer,17098,1,1,0
2013,Officer,17103,17,13,4
2013,Officer,17201,1,1,0
2013,Officer,17222,3,3,0
2013,Officer,17331,3,2,1
2013,Officer,17701,1,1,0
2013,Officer,17745,2,2,0
2013,Officer,17821,7,6,1
2013,Officer,18040,4,3,1
2013,Officer,18102,5,4,1
2013,Officer,18201,1,1,0
2013,Officer,18235,1,1,0
2013,Officer,18252,1,1,0
2013,Officer,18509,5,5,0
2013,Officer,18510,1,1,0
2013,Officer,18634,1,1,0
2013,Officer,18643,1,1,0
2013,Officer,18651,1,1,0
2013,Officer,18704,3,3,0
2013,Officer,18834,2,0,2
2013,Officer,18960,3,2,1
2013,Officer,19044,5,3,2
2013,Officer,19104,5,4,1
2013,Officer,19154,10,7,3
2013,Officer,19460,1,1,0
2013,Officer,19462,2,2,0
2013,Officer,19475,3,2,1
2013,Officer,19526,1,1,0
2013,Officer,19605,2,2,0
2013,Officer,19711,1,1,0
2013,Officer,19720,1,1,0
2013,Officer,19808,4,3,1
2013,Officer,19930,2,2,0
2013,Officer,19939,2,2,0
2013,Officer,19973,2,2,0
2013,Officer,19977,3,3,0
2013,Officer,20003,14,12,2
2013,Officer,20112,1,1,0
2013,Officer,20373,3,3,0
2013,Officer,20623,1,1,0
2013,Officer,20646,2,1,1
2013,Officer,20708,2,2,0
2013,Officer,20755,1,1,0
2013,Officer,20882,4,3,1
2013,Officer,20904,2,1,1
2013,Officer,21010,8,8,0
2013,Officer,21043,1,1,0
2013,Officer,21057,1,1,0
2013,Officer,21061,1,0,1
2013,Officer,21078,3,2,1
2013,Officer,21136,5,4,1
2013,Officer,21201,5,3,2
2013,Officer,21204,7,6,1
2013,Officer,21208,5,5,0
2013,Officer,21216,1,1,0
2013,Officer,21228,3,3,0
2013,Officer,21401,8,7,1
2013,Officer,21502,2,2,0
2013,Officer,21601,2,2,0
2013,Officer,21740,2,2,0
2013,Officer,21921,1,1,0
2013,Officer,22032,1,1,0
2013,Officer,22060,3,2,1
2013,Officer,22401,3,3,0
2013,Officer,22427,3,3,0
2013,Officer,22601,3,3,0
2013,Officer,22731,1,1,0
2013,Officer,22902,2,1,1
2013,Officer,23139,1,1,0
2013,Officer,23150,7,7,0
2013,Officer,23181,2,2,0
2013,Officer,23237,1,1,0
2013,Officer,23451,2,2,0
2013,Officer,23502,3,3,0
2013,Officer,23666,1,0,1
2013,Officer,23701,9,8,1
2013,Officer,23805,1,1,0
2013,Officer,23824,3,2,1
2013,Officer,23847,1,1,0
2013,Officer,23851,1,0,1
2013,Officer,24073,2,1,1
2013,Officer,24251,2,2,0
2013,Officer,24301,3,2,1
2013,Officer,24450,1,1,0
2013,Officer,24502,4,4,0
2013,Officer,24523,1,0,1
2013,Officer,24541,2,2,0
2013,Officer,24592,1,1,0
2013,Officer,24609,1,0,1
2013,Officer,24701,2,2,0
2013,Officer,24957,1,1,0
2013,Officer,25168,4,4,0
2013,Officer,25311,12,12,0
2013,Officer,25401,1,1,0
2013,Officer,25530,3,3,0
2013,Officer,25846,3,3,0
2013,Officer,26187,1,1,0
2013,Officer,26241,1,1,0
2013,Officer,26301,1,1,0
2013,Officer,26452,1,1,0
2013,Officer,26505,1,1,0
2013,Officer,26537,3,3,0
2013,Officer,26554,4,4,0
2013,Officer,26624,1,1,0
2013,Officer,26651,1,1,0
2013,Officer,26726,1,1,0
2013,Officer,27028,1,1,0
2013,Officer,27103,2,1,1
2013,Officer,27217,1,1,0
2013,Officer,27260,1,1,0
2013,Officer,27264,2,2,0
2013,Officer,27320,1,1,0
2013,Officer,27401,2,2,0
2013,Officer,27504,3,3,0
2013,Officer,27530,2,1,1
2013,Officer,27560,4,3,1
2013,Officer,27577,1,1,0
2013,Officer,27581,5,5,0
2013,Officer,27607,7,7,0
2013,Officer,27704,8,7,1
2013,Officer,27828,2,2,0
2013,Officer,27870,3,3,0
2013,Officer,28001,1,1,0
2013,Officer,28012,3,2,1
2013,Officer,28043,1,0,1
2013,Officer,28086,2,2,0
2013,Officer,28092,1,1,0
2013,Officer,28110,2,2,0
2013,Officer,28170,3,3,0
2013,Officer,28208,10,9,1
2013,Officer,28306,3,3,0
2013,Officer,28328,4,4,0
2013,Officer,28337,1,1,0
2013,Officer,28352,1,1,0
2013,Officer,28359,1,1,0
2013,Officer,28371,2,2,0
2013,Officer,28376,2,2,0
2013,Officer,28379,4,4,0
2013,Officer,28405,3,2,1
2013,Officer,28504,3,3,0
2013,Officer,28518,1,1,0
2013,Officer,28540,1,1,0
2013,Officer,28590,3,3,0
2013,Officer,28601,1,0,1
2013,Officer,28645,2,2,0
2013,Officer,28655,1,1,0
2013,Officer,28659,1,1,0
2013,Officer,28734,1,1,0
2013,Officer,28845,1,1,0
2013,Officer,29006,1,1,0
2013,Officer,29020,1,1,0
2013,Officer,29044,14,12,2
2013,Officer,29102,2,2,0
2013,Officer,29108,4,4,0
2013,Officer,29115,1,1,0
2013,Officer,29138,3,3,0
2013,Officer,29151,2,2,0
2013,Officer,29161,4,4,0
2013,Officer,29201,12,11,1
2013,Officer,29303,3,3,0
2013,Officer,29325,4,4,0
2013,Officer,29379,5,5,0
2013,Officer,29385,1,1,0
2013,Officer,29403,1,1,0
2013,Officer,29418,2,2,0
2013,Officer,29440,1,1,0
2013,Officer,29461,1,1,0
2013,Officer,29483,1,1,0
2013,Officer,29488,1,1,0
2013,Officer,29510,1,1,0
2013,Officer,29512,2,2,0
2013,Officer,29520,2,2,0
2013,Officer,29526,2,2,0
2013,Officer,29544,1,1,0
2013,Officer,29556,1,1,0
2013,Officer,29574,2,1,1
2013,Officer,29605,1,1,0
2013,Officer,29620,3,3,0
2013,Officer,29625,3,3,0
2013,Officer,29646,1,1,0
2013,Officer,29651,3,3,0
2013,Officer,29653,2,2,0
2013,Officer,29720,2,2,0
2013,Officer,29732,2,2,0
2013,Officer,29810,1,1,0
2013,Officer,29812,1,1,0
2013,Officer,29824,1,1,0
2013,Officer,29829,3,3,0
2013,Officer,29906,2,2,0
2013,Officer,29944,1,1,0
2013,Officer,30014,1,1,0
2013,Officer,30032,3,3,0
2013,Officer,30040,6,6,0
2013,Officer,30045,2,2,0
2013,Officer,30060,12,12,0
2013,Officer,30069,3,3,0
2013,Officer,30114,3,3,0
2013,Officer,30125,1,1,0
2013,Officer,30134,1,1,0
2013,Officer,30144,4,4,0
2013,Officer,30224,2,2,0
2013,Officer,30233,1,1,0
2013,Officer,30241,1,1,0
2013,Officer,30263,1,1,0
2013,Officer,30294,8,8,0
2013,Officer,30297,9,9,0
2013,Officer,30336,7,7,0
2013,Officer,30427,1,1,0
2013,Officer,30439,2,2,0
2013,Officer,30461,3,3,0
2013,Officer,30501,3,3,0
2013,Officer,30577,2,2,0
2013,Officer,30635,4,4,0
2013,Officer,30643,1,1,0
2013,Officer,30655,2,2,0
2013,Officer,30680,10,10,0
2013,Officer,30701,6,6,0
2013,Officer,30720,1,1,0
2013,Officer,30824,3,3,0
2013,Officer,30830,3,3,0
2013,Officer,30904,7,7,0
2013,Officer,30905,5,5,0
2013,Officer,31015,2,2,0
2013,Officer,31029,5,5,0
2013,Officer,31040,5,5,0
2013,Officer,31061,2,2,0
2013,Officer,31211,5,5,0
2013,Officer,31313,2,2,0
2013,Officer,31329,2,2,0
2013,Officer,31406,3,3,0
2013,Officer,31409,1,1,0
2013,Officer,31416,1,1,0
2013,Officer,31533,1,1,0
2013,Officer,31701,1,1,0
2013,Officer,31792,2,2,0
2013,Officer,31901,7,7,0
2013,Officer,31905,2,2,0
2013,Officer,32055,1,1,0
2013,Officer,32064,1,1,0
2013,Officer,32084,2,2,0
2013,Officer,32085,4,4,0
2013,Officer,32086,1,1,0
2013,Officer,32091,13,13,0
2013,Officer,32114,1,1,0
2013,Officer,32177,1,1,0
2013,Officer,32221,5,5,0
2013,Officer,32311,1,1,0
2013,Officer,32351,2,2,0
2013,Officer,32406,1,1,0
2013,Officer,32425,1,1,0
2013,Officer,32428,1,1,0
2013,Officer,32447,2,2,0
2013,Officer,32536,1,1,0
2013,Officer,32724,3,3,0
2013,Officer,32727,1,1,0
2013,Officer,32771,2,2,0
2013,Officer,32806,2,2,0
2013,Officer,32827,3,3,0
2013,Officer,33020,1,1,0
2013,Officer,33127,6,6,0
2013,Officer,33315,3,3,0
2013,Officer,33406,4,4,0
2013,Officer,33563,3,3,0
2013,Officer,33606,1,1,0
2013,Officer,33711,5,5,0
2013,Officer,33782,9,9,0
2013,Officer,33811,1,1,0
2013,Officer,33830,4,4,0
2013,Officer,33844,1,1,0
2013,Officer,33859,1,1,0
2013,Officer,33880,4,4,0
2013,Officer,34142,1,1,0
2013,Officer,34208,1,1,0
2013,Officer,34221,1,1,0
2013,Officer,34237,1,1,0
2013,Officer,34266,1,1,0
2013,Officer,34429,1,1,0
2013,Officer,34474,2,2,0
2013,Officer,34748,1,1,0
2013,Officer,35010,2,2,0
2013,Officer,35042,3,3,0
2013,Officer,35121,1,1,0
2013,Officer,35146,1,1,0
2013,Officer,35150,2,2,0
2013,Officer,35161,1,1,0
2013,Officer,35178,2,2,0
2013,Officer,35209,3,3,0
2013,Officer,35217,4,4,0
2013,Officer,35405,1,1,0
2013,Officer,35442,1,1,0
2013,Officer,35476,1,1,0
2013,Officer,35501,1,1,0
2013,Officer,35555,1,1,0
2013,Officer,35565,5,5,0
2013,Officer,35594,2,2,0
2013,Officer,35601,4,4,0
2013,Officer,35613,2,2,0
2013,Officer,35630,4,4,0
2013,Officer,35803,5,5,0
2013,Officer,35805,2,2,0
2013,Officer,35904,4,4,0
2013,Officer,35967,1,1,0
2013,Officer,36009,1,1,0
2013,Officer,36010,1,1,0
2013,Officer,36032,5,5,0
2013,Officer,36043,5,5,0
2013,Officer,36067,1,1,0
2013,Officer,36072,1,1,0
2013,Officer,36078,3,3,0
2013,Officer,36092,1,1,0
2013,Officer,36109,5,5,0
2013,Officer,36117,1,1,0
2013,Officer,36205,7,7,0
2013,Officer,36251,2,2,0
2013,Officer,36265,1,1,0
2013,Officer,36322,3,3,0
2013,Officer,36330,4,4,0
2013,Officer,36340,1,1,0
2013,Officer,36344,1,1,0
2013,Officer,36421,3,3,0
2013,Officer,36426,1,1,0
2013,Officer,36442,1,1,0
2013,Officer,36460,2,2,0
2013,Officer,36502,1,1,0
2013,Officer,36522,1,1,0
2013,Officer,36535,2,2,0
2013,Officer,36545,1,1,0
2013,Officer,36605,6,6,0
2013,Officer,36701,2,2,0
2013,Officer,36801,2,2,0
2013,Officer,36854,1,1,0
2013,Officer,36867,1,1,0
2013,Officer,36904,1,1,0
2013,Officer,37033,1,1,0
2013,Officer,37066,4,4,0
2013,Officer,37090,3,3,0
2013,Officer,37129,2,2,0
2013,Officer,37167,5,5,0
2013,Officer,37204,6,5,1
2013,Officer,37303,1,1,0
2013,Officer,37323,1,1,0
2013,Officer,37398,1,1,0
2013,Officer,37404,3,3,0
2013,Officer,37620,1,1,0
2013,Officer,37644,1,1,0
2013,Officer,37645,3,2,1
2013,Officer,37717,2,2,0
2013,Officer,37743,1,1,0
2013,Officer,37760,1,1,0
2013,Officer,37771,1,1,0
2013,Officer,37777,5,5,0
2013,Officer,37801,2,2,0
2013,Officer,37841,1,1,0
2013,Officer,37854,2,1,1
2013,Officer,37863,1,1,0
2013,Officer,37919,2,2,0
2013,Officer,37939,3,3,0
2013,Officer,38019,1,1,0
2013,Officer,38024,1,1,0
2013,Officer,38063,1,0,1
2013,Officer,38118,1,0,1
2013,Officer,38340,1,1,0
2013,Officer,38343,1,1,0
2013,Officer,38363,1,1,0
2013,Officer,38375,3,3,0
2013,Officer,38382,2,2,0
2013,Officer,38401,1,1,0
2013,Officer,38464,1,0,1
2013,Officer,38478,1,1,0
2013,Officer,38485,1,0,1
2013,Officer,38506,1,1,0
2013,Officer,38556,1,1,0
2013,Officer,38606,1,1,0
2013,Officer,38635,1,1,0
2013,Officer,38668,2,2,0
2013,Officer,38737,1,1,0
2013,Officer,38801,4,4,0
2013,Officer,38803,3,3,0
2013,Officer,38821,3,3,0
2013,Officer,38829,1,0,1
2013,Officer,38843,1,1,0
2013,Officer,38851,1,1,0
2013,Officer,38915,1,1,0
2013,Officer,38916,1,1,0
2013,Officer,38926,2,1,1
2013,Officer,39046,5,5,0
2013,Officer,39051,1,1,0
2013,Officer,39059,2,2,0
2013,Officer,39060,1,1,0
2013,Officer,39074,4,4,0
2013,Officer,39114,1,1,0
2013,Officer,39117,1,1,0
2013,Officer,39120,1,1,0
2013,Officer,39159,1,1,0
2013,Officer,39183,1,1,0
2013,Officer,39204,12,10,2
2013,Officer,39209,1,1,0
2013,Officer,39216,4,4,0
2013,Officer,39296,10,8,2
2013,Officer,39307,2,1,1
2013,Officer,39328,1,1,0
2013,Officer,39345,1,1,0
2013,Officer,39350,1,1,0
2013,Officer,39407,1,1,0
2013,Officer,39422,1,1,0
2013,Officer,39429,1,1,0
2013,Officer,39452,1,1,0
2013,Officer,39470,3,3,0
2013,Officer,39505,1,1,0
2013,Officer,39507,3,3,0
2013,Officer,39532,3,3,0
2013,Officer,39556,1,1,0
2013,Officer,39648,3,3,0
2013,Officer,39654,2,2,0
2013,Officer,39730,1,1,0
2013,Officer,39735,1,1,0
2013,Officer,39744,1,1,0
2013,Officer,39760,2,2,0
2013,Officer,39819,2,2,0
2013,Officer,40065,2,1,1
2013,Officer,40209,2,1,1
2013,Officer,40218,1,1,0
2013,Officer,40330,2,2,0
2013,Officer,40351,1,1,0
2013,Officer,40472,3,3,0
2013,Officer,40475,7,7,0
2013,Officer,40510,3,3,0
2013,Officer,40512,2,2,0
2013,Officer,40516,3,2,1
2013,Officer,40601,8,8,0
2013,Officer,40831,3,1,2
2013,Officer,40906,4,4,0
2013,Officer,40965,1,1,0
2013,Officer,41056,3,3,0
2013,Officer,41094,2,2,0
2013,Officer,41101,6,6,0
2013,Officer,41701,1,1,0
2013,Officer,42101,1,1,0
2013,Officer,42141,5,5,0
2013,Officer,42240,1,1,0
2013,Officer,42301,3,3,0
2013,Officer,42431,1,0,1
2013,Officer,42501,2,2,0
2013,Officer,42701,1,1,0
2013,Officer,42718,2,2,0
2013,Officer,43040,4,3,1
2013,Officer,43055,4,3,1
2013,Officer,43213,9,8,1
2013,Officer,43217,12,12,0
2013,Officer,43228,1,0,1
2013,Officer,43235,9,5,4
2013,Officer,43402,1,1,0
2013,Officer,43465,8,7,1
2013,Officer,43756,12,8,4
2013,Officer,43812,2,1,1
2013,Officer,44055,1,1,0
2013,Officer,44128,6,5,1
2013,Officer,44142,5,5,0
2013,Officer,44224,6,6,0
2013,Officer,44256,4,3,1
2013,Officer,44313,1,1,0
2013,Officer,44444,2,2,0
2013,Officer,44515,2,2,0
2013,Officer,44601,1,1,0
2013,Officer,44691,1,1,0
2013,Officer,44720,3,2,1
2013,Officer,44870,2,2,0
2013,Officer,44883,1,0,1
2013,Officer,44903,2,2,0
2013,Officer,45015,5,3,2
2013,Officer,45036,2,2,0
2013,Officer,45215,7,3,4
2013,Officer,45331,1,0,1
2013,Officer,45385,2,2,0
2013,Officer,45430,5,5,0
2013,Officer,45505,7,5,2
2013,Officer,45601,1,1,0
2013,Officer,45662,3,1,2
2013,Officer,45885,2,1,1
2013,Officer,46012,5,5,0
2013,Officer,46041,2,2,0
2013,Officer,46052,2,2,0
2013,Officer,46060,2,2,0
2013,Officer,46122,3,3,0
2013,Officer,46124,1,1,0
2013,Officer,46131,5,4,1
2013,Officer,46135,2,2,0
2013,Officer,46140,2,2,0
2013,Officer,46151,3,3,0
2013,Officer,46176,5,4,1
2013,Officer,46216,3,3,0
2013,Officer,46241,24,17,7
2013,Officer,46323,1,1,0
2013,Officer,46360,1,1,0
2013,Officer,46383,1,1,0
2013,Officer,46402,6,6,0
2013,Officer,46406,2,2,0
2013,Officer,46517,1,1,0
2013,Officer,46563,1,1,0
2013,Officer,46580,1,1,0
2013,Officer,46703,1,1,0
2013,Officer,46714,1,1,0
2013,Officer,46825,2,2,0
2013,Officer,46901,1,1,0
2013,Officer,46947,1,1,0
2013,Officer,46970,1,1,0
2013,Officer,47150,5,5,0
2013,Officer,47167,3,3,0
2013,Officer,47170,1,1,0
2013,Officer,47203,3,3,0
2013,Officer,47274,1,1,0
2013,Officer,47303,3,3,0
2013,Officer,47374,1,1,0
2013,Officer,47394,1,1,0
2013,Officer,47401,3,3,0
2013,Officer,47421,2,2,0
2013,Officer,47441,1,1,0
2013,Officer,47501,1,1,0
2013,Officer,47546,3,3,0
2013,Officer,47715,6,6,0
2013,Officer,47804,4,3,1
2013,Officer,47834,1,1,0
2013,Officer,47872,1,1,0
2013,Officer,47905,10,9,1
2013,Officer,47933,1,1,0
2013,Officer,47978,2,2,0
2013,Officer,48060,1,1,0
2013,Officer,48180,2,2,0
2013,Officer,48197,2,2,0
2013,Officer,48208,2,2,0
2013,Officer,48234,8,6,2
2013,Officer,48341,1,1,0
2013,Officer,48503,3,3,0
2013,Officer,48601,1,1,0
2013,Officer,48706,1,1,0
2013,Officer,48801,1,1,0
2013,Officer,48813,3,3,0
2013,Officer,48817,1,1,0
2013,Officer,48837,6,6,0
2013,Officer,48838,2,2,0
2013,Officer,48906,7,5,2
2013,Officer,49009,2,1,1
2013,Officer,49012,7,7,0
2013,Officer,49201,3,3,0
2013,Officer,49221,1,1,0
2013,Officer,49224,1,1,0
2013,Officer,49307,2,2,0
2013,Officer,49509,5,3,2
2013,Officer,49660,1,0,1
2013,Officer,49739,7,6,1
2013,Officer,49837,1,1,0
2013,Officer,49855,1,1,0
2013,Officer,49908,1,1,0
2013,Officer,49935,1,0,1
2013,Officer,50036,8,6,2
2013,Officer,50126,2,2,0
2013,Officer,50131,23,22,1
2013,Officer,50138,1,1,0
2013,Officer,50501,2,2,0
2013,Officer,50616,2,2,0
2013,Officer,50662,1,1,0
2013,Officer,50703,3,3,0
2013,Officer,51031,1,1,0
2013,Officer,51111,4,3,1
2013,Officer,51442,1,1,0
2013,Officer,51503,2,1,1
2013,Officer,52002,3,1,2
2013,Officer,52353,2,2,0
2013,Officer,52404,3,3,0
2013,Officer,52556,2,1,1
2013,Officer,52632,1,1,0
2013,Officer,52641,1,1,0
2013,Officer,53027,1,1,0
2013,Officer,53089,2,1,1
2013,Officer,53094,1,1,0
2013,Officer,53105,1,1,0
2013,Officer,53190,2,1,1
2013,Officer,53212,4,4,0
2013,Officer,53511,2,2,0
2013,Officer,53538,1,1,0
2013,Officer,53545,1,1,0
2013,Officer,53704,6,6,0
2013,Officer,53708,2,2,0
2013,Officer,53818,2,2,0
2013,Officer,53948,2,2,0
2013,Officer,53959,2,2,0
2013,Officer,54022,1,1,0
2013,Officer,54143,2,2,0
2013,Officer,54303,2,1,1
2013,Officer,54401,1,1,0
2013,Officer,54409,1,1,0
2013,Officer,54449,1,1,0
2013,Officer,54455,1,1,0
2013,Officer,54481,1,0,1
2013,Officer,54487,1,1,0
2013,Officer,54495,1,1,0
2013,Officer,54501,1,1,0
2013,Officer,54612,1,1,0
2013,Officer,54615,1,1,0
2013,Officer,54618,4,4,0
2013,Officer,54656,3,3,0
2013,Officer,54703,4,4,0
2013,Officer,54729,1,1,0
2013,Officer,54751,1,1,0
2013,Officer,54801,2,2,0
2013,Officer,54843,1,0,1
2013,Officer,54868,1,1,0
2013,Officer,54880,2,2,0
2013,Officer,54901,1,1,0
2013,Officer,54914,4,4,0
2013,Officer,54929,3,3,0
2013,Officer,54935,1,0,1
2013,Officer,54971,1,1,0
2013,Officer,55016,6,4,2
2013,Officer,55021,3,3,0
2013,Officer,55057,1,1,0
2013,Officer,55060,1,0,1
2013,Officer,55063,1,0,1
2013,Officer,55068,6,4,2
2013,Officer,55082,1,1,0
2013,Officer,55101,14,13,1
2013,Officer,55106,2,2,0
2013,Officer,55107,6,5,1
2013,Officer,55113,5,4,1
2013,Officer,55122,2,2,0
2013,Officer,55303,3,3,0
2013,Officer,55362,1,1,0
2013,Officer,55431,5,4,1
2013,Officer,55443,2,2,0
2013,Officer,55720,1,1,0
2013,Officer,55744,1,1,0
2013,Officer,55746,1,1,0
2013,Officer,55904,1,1,0
2013,Officer,56001,4,3,1
2013,Officer,56021,1,1,0
2013,Officer,56073,1,1,0
2013,Officer,56082,1,1,0
2013,Officer,56201,2,2,0
2013,Officer,56258,2,2,0
2013,Officer,56265,3,3,0
2013,Officer,56267,1,1,0
2013,Officer,56277,1,0,1
2013,Officer,56278,2,2,0
2013,Officer,56303,4,4,0
2013,Officer,56345,3,2,1
2013,Officer,56347,1,1,0
2013,Officer,56378,2,2,0
2013,Officer,56401,3,3,0
2013,Officer,56482,1,1,0
2013,Officer,56501,1,1,0
2013,Officer,56560,2,2,0
2013,Officer,57006,1,1,0
2013,Officer,57069,3,1,2
2013,Officer,57104,1,1,0
2013,Officer,57201,1,1,0
2013,Officer,57350,1,1,0
2013,Officer,57380,1,1,0
2013,Officer,57601,1,1,0
2013,Officer,57702,8,8,0
2013,Officer,57703,1,1,0
2013,Officer,57717,1,1,0
2013,Officer,57783,1,1,0
2013,Officer,58054,1,1,0
2013,Officer,58072,2,2,0
2013,Officer,58075,1,1,0
2013,Officer,58102,5,5,0
2013,Officer,58201,3,3,0
2013,Officer,58301,4,4,0
2013,Officer,58433,1,1,0
2013,Officer,58495,1,1,0
2013,Officer,58506,7,6,1
2013,Officer,58702,2,2,0
2013,Officer,59102,1,1,0
2013,Officer,59405,1,1,0
2013,Officer,59501,1,1,0
2013,Officer,59602,4,4,0
2013,Officer,59604,2,2,0
2013,Officer,59636,4,4,0
2013,Officer,59701,1,1,0
2013,Officer,59714,3,3,0
2013,Officer,59808,2,2,0
2013,Officer,59901,1,1,0
2013,Officer,60037,1,1,0
2013,Officer,60085,1,1,0
2013,Officer,60098,3,3,0
2013,Officer,60120,2,2,0
2013,Officer,60178,3,3,0
2013,Officer,60435,4,4,0
2013,Officer,60472,4,4,0
2013,Officer,60505,2,2,0
2013,Officer,60546,9,9,0
2013,Officer,60615,7,7,0
2013,Officer,60616,7,7,0
2013,Officer,60651,1,1,0
2013,Officer,61021,1,1,0
2013,Officer,61032,5,5,0
2013,Officer,61071,1,1,0
2013,Officer,61115,6,6,0
2013,Officer,61264,2,2,0
2013,Officer,61341,4,4,0
2013,Officer,61364,1,1,0
2013,Officer,61434,3,3,0
2013,Officer,61443,1,1,0
2013,Officer,61607,11,11,0
2013,Officer,61701,4,4,0
2013,Officer,61764,5,5,0
2013,Officer,61801,1,1,0
2013,Officer,61820,1,1,0
2013,Officer,61834,1,1,0
2013,Officer,61938,1,1,0
2013,Officer,61951,1,1,0
2013,Officer,62056,1,1,0
2013,Officer,62269,2,2,0
2013,Officer,62286,5,5,0
2013,Officer,62401,1,1,0
2013,Officer,62521,3,3,0
2013,Officer,62702,18,18,0
2013,Officer,62864,4,4,0
2013,Officer,62896,1,1,0
2013,Officer,62959,2,2,0
2013,Officer,62966,1,1,0
2013,Officer,63044,1,1,0
2013,Officer,63077,1,1,0
2013,Officer,63109,1,1,0
2013,Officer,63125,3,2,1
2013,Officer,63383,1,0,1
2013,Officer,63401,2,1,1
2013,Officer,63703,2,2,0
2013,Officer,63755,1,1,0
2013,Officer,63873,1,1,0
2013,Officer,64067,1,1,0
2013,Officer,64085,1,1,0
2013,Officer,64129,11,9,2
2013,Officer,64468,1,1,0
2013,Officer,64506,2,2,0
2013,Officer,64601,1,1,0
2013,Officer,64701,2,2,0
2013,Officer,64772,1,1,0
2013,Officer,64804,3,2,1
2013,Officer,64831,1,1,0
2013,Officer,65101,13,11,2
2013,Officer,65109,1,1,0
2013,Officer,65265,1,0,1
2013,Officer,65301,3,3,0
2013,Officer,65305,1,0,1
2013,Officer,65473,3,3,0
2013,Officer,65775,1,1,0
2013,Officer,65802,4,3,1
2013,Officer,65803,1,1,0
2013,Officer,66027,4,4,0
2013,Officer,66061,2,1,1
2013,Officer,66102,5,4,1
2013,Officer,66219,5,3,2
2013,Officer,66220,2,1,1
2013,Officer,66434,7,7,0
2013,Officer,66436,1,1,0
2013,Officer,66503,1,1,0
2013,Officer,66508,2,1,1
2013,Officer,66619,8,8,0
2013,Officer,66749,2,2,0
2013,Officer,66762,2,2,0
2013,Officer,67114,1,0,1
2013,Officer,67217,1,1,0
2013,Officer,67337,1,0,1
2013,Officer,67401,1,1,0
2013,Officer,67410,2,2,0
2013,Officer,67501,3,3,0
2013,Officer,67801,1,1,0
2013,Officer,67901,1,1,0
2013,Officer,68066,1,1,0
2013,Officer,68106,3,3,0
2013,Officer,68142,1,1,0
2013,Officer,68310,1,1,0
2013,Officer,68434,2,2,0
2013,Officer,68503,1,1,0
2013,Officer,68508,3,2,1
2013,Officer,68524,10,9,1
2013,Officer,68803,3,3,0
2013,Officer,68847,1,1,0
2013,Officer,68901,3,3,0
2013,Officer,69361,1,1,0
2013,Officer,70072,3,2,1
2013,Officer,70117,12,7,5
2013,Officer,70364,2,1,1
2013,Officer,70390,1,1,0
2013,Officer,70401,6,6,0
2013,Officer,70438,1,1,0
2013,Officer,70508,4,4,0
2013,Officer,70510,2,1,1
2013,Officer,70526,2,1,1
2013,Officer,70546,2,2,0
2013,Officer,70570,2,2,0
2013,Officer,70582,2,2,0
2013,Officer,70601,2,2,0
2013,Officer,70633,2,2,0
2013,Officer,70714,1,1,0
2013,Officer,70721,9,8,1
2013,Officer,70737,1,1,0
2013,Officer,70764,1,1,0
2013,Officer,70820,3,3,0
2013,Officer,71101,3,3,0
2013,Officer,71203,1,1,0
2013,Officer,71251,2,2,0
2013,Officer,71270,3,3,0
2013,Officer,71292,1,1,0
2013,Officer,71303,1,1,0
2013,Officer,71322,2,2,0
2013,Officer,71360,10,9,1
2013,Officer,71417,1,1,0
2013,Officer,71463,1,1,0
2013,Officer,71483,2,2,0
2013,Officer,71602,1,1,0
2013,Officer,71639,1,1,0
2013,Officer,71753,1,1,0
2013,Officer,71857,1,1,0
2013,Officer,71913,1,1,0
2013,Officer,72032,1,1,0
2013,Officer,72086,4,3,1
2013,Officer,72104,1,1,0
2013,Officer,72110,1,1,0
2013,Officer,72112,1,1,0
2013,Officer,72114,5,4,1
2013,Officer,72199,20,17,3
2013,Officer,72205,3,3,0
2013,Officer,72401,3,3,0
2013,Officer,72476,1,1,0
2013,Officer,72543,1,1,0
2013,Officer,72701,6,4,2
2013,Officer,72712,4,4,0
2013,Officer,72756,2,1,1
2013,Officer,72761,3,3,0
2013,Officer,72830,1,1,0
2013,Officer,72923,1,1,0
2013,Officer,72949,1,1,0
2013,Officer,73034,3,3,0
2013,Officer,73064,2,2,0
2013,Officer,73069,8,7,1
2013,Officer,73111,5,4,1
2013,Officer,73141,3,3,0
2013,Officer,73401,1,1,0
2013,Officer,73503,2,2,0
2013,Officer,73521,1,1,0
2013,Officer,73705,2,1,1
2013,Officer,74003,1,1,0
2013,Officer,74012,1,1,0
2013,Officer,74014,7,7,0
2013,Officer,74017,2,2,0
2013,Officer,74075,3,3,0
2013,Officer,74107,2,2,0
2013,Officer,74301,1,1,0
2013,Officer,74501,1,1,0
2013,Officer,74601,3,3,0
2013,Officer,74701,2,2,0
2013,Officer,74804,1,1,0
2013,Officer,74820,3,2,1
2013,Officer,74834,1,1,0
2013,Officer,74848,1,1,0
2013,Officer,74953,2,2,0
2013,Officer,75051,20,18,2
2013,Officer,75077,7,7,0
2013,Officer,75098,3,3,0
2013,Officer,75110,1,1,0
2013,Officer,75159,1,1,0
2013,Officer,75160,1,1,0
2013,Officer,75237,1,1,0
2013,Officer,75402,3,3,0
2013,Officer,75672,2,2,0
2013,Officer,75901,3,3,0
2013,Officer,76086,2,2,0
2013,Officer,76105,3,2,1
2013,Officer,76108,2,2,0
2013,Officer,76115,4,4,0
2013,Officer,76302,2,2,0
2013,Officer,76502,3,3,0
2013,Officer,76542,2,2,0
2013,Officer,76574,2,2,0
2013,Officer,76707,11,10,1
2013,Officer,76905,1,1,0
2013,Officer,77034,8,6,2
2013,Officer,77067,10,10,0
2013,Officer,77082,16,16,0
2013,Officer,77340,1,1,0
2013,Officer,77437,1,1,0
2013,Officer,77471,1,0,1
2013,Officer,77515,5,5,0
2013,Officer,77568,2,1,1
2013,Officer,77802,10,10,0
2013,Officer,78041,2,2,0
2013,Officer,78130,6,6,0
2013,Officer,78218,7,7,0
2013,Officer,78219,3,3,0
2013,Officer,78257,23,22,1
2013,Officer,78416,4,4,0
2013,Officer,78520,1,1,0
2013,Officer,78596,3,2,1
2013,Officer,78624,1,1,0
2013,Officer,78665,8,8,0
2013,Officer,78666,12,11,1
2013,Officer,78703,51,49,2
2013,Officer,78719,4,4,0
2013,Officer,78723,4,4,0
2013,Officer,78746,6,6,0
2013,Officer,78763,7,6,1
2013,Officer,79107,2,2,0
2013,Officer,79607,1,1,0
2013,Officer,79706,3,3,0
2013,Officer,79924,4,4,0
2013,Officer,79936,3,3,0
2013,Officer,80011,9,9,0
2013,Officer,80112,9,9,0
2013,Officer,80137,1,1,0
2013,Officer,80216,4,4,0
2013,Officer,80304,2,2,0
2013,Officer,80501,1,1,0
2013,Officer,80504,1,1,0
2013,Officer,80521,2,2,0
2013,Officer,80621,1,1,0
2013,Officer,80907,1,1,0
2013,Officer,80913,7,7,0
2013,Officer,80916,4,4,0
2013,Officer,81004,1,1,0
2013,Officer,81401,2,2,0
2013,Officer,82009,14,11,3
2013,Officer,82072,1,1,0
2013,Officer,82431,2,0,2
2013,Officer,82604,1,1,0
2013,Officer,82716,2,2,0
2013,Officer,82801,1,0,1
2013,Officer,82931,2,2,0
2013,Officer,83330,1,1,0
2013,Officer,83445,1,1,0
2013,Officer,83501,1,1,0
2013,Officer,83605,1,1,0
2013,Officer,83617,1,1,0
2013,Officer,83647,2,2,0
2013,Officer,83676,1,1,0
2013,Officer,83705,13,13,0
2013,Officer,83854,2,2,0
2013,Officer,84003,5,5,0
2013,Officer,84020,18,17,1
2013,Officer,84043,2,2,0
2013,Officer,84058,3,3,0
2013,Officer,84065,22,19,3
2013,Officer,84074,1,1,0
2013,Officer,84084,5,5,0
2013,Officer,84116,2,2,0
2013,Officer,84302,1,1,0
2013,Officer,84323,2,2,0
2013,Officer,84404,1,1,0
2013,Officer,84405,3,2,1
2013,Officer,84660,1,1,0
2013,Officer,84701,3,3,0
2013,Officer,84720,2,2,0
2013,Officer,84770,1,1,0
2013,Officer,84790,1,1,0
2013,Officer,85008,17,17,0
2013,Officer,85122,1,1,0
2013,Officer,85128,1,1,0
2013,Officer,85132,4,4,0
2013,Officer,85201,3,3,0
2013,Officer,85281,2,1,1
2013,Officer,85301,2,2,0
2013,Officer,85364,1,1,0
2013,Officer,85396,4,4,0
2013,Officer,85653,7,7,0
2013,Officer,85706,1,1,0
2013,Officer,85713,1,1,0
2013,Officer,85901,1,1,0
2013,Officer,86015,2,2,0
2013,Officer,86301,1,1,0
2013,Officer,87002,5,5,0
2013,Officer,87123,9,7,2
2013,Officer,87144,13,13,0
2013,Officer,87401,2,2,0
2013,Officer,87508,3,3,0
2013,Officer,88007,6,6,0
2013,Officer,88026,1,1,0
2013,Officer,89115,14,14,0
2013,Officer,89139,5,4,1
2013,Officer,89447,1,1,0
2013,Officer,89506,9,9,0
2013,Officer,89509,8,8,0
2013,Officer,89701,3,3,0
2013,Officer,90025,1,1,0
2013,Officer,90201,6,6,0
2013,Officer,90249,1,1,0
2013,Officer,90266,1,1,0
2013,Officer,90302,6,6,0
2013,Officer,90640,2,1,1
2013,Officer,90720,14,10,4
2013,Officer,90813,1,1,0
2013,Officer,90822,8,8,0
2013,Officer,91205,2,2,0
2013,Officer,91406,1,1,0
2013,Officer,91505,3,3,0
2013,Officer,91702,2,2,0
2013,Officer,91764,4,4,0
2013,Officer,91766,2,2,0
2013,Officer,92111,9,9,0
2013,Officer,92243,2,2,0
2013,Officer,92324,2,2,0
2013,Officer,92518,1,1,0
2013,Officer,92866,1,1,0
2013,Officer,92879,1,1,0
2013,Officer,93030,1,1,0
2013,Officer,93307,3,3,0
2013,Officer,93405,3,3,0
2013,Officer,93451,1,1,0
2013,Officer,93550,1,1,0
2013,Officer,93638,1,1,0
2013,Officer,93727,5,5,0
2013,Officer,93955,1,1,0
2013,Officer,94035,1,1,0
2013,Officer,94043,3,3,0
2013,Officer,94132,1,1,0
2013,Officer,94533,3,2,1
2013,Officer,94545,1,1,0
2013,Officer,94565,1,1,0
2013,Officer,94568,2,2,0
2013,Officer,94590,1,1,0
2013,Officer,94596,1,1,0
2013,Officer,94804,2,2,0
2013,Officer,94903,6,6,0
2013,Officer,94909,1,1,0
2013,Officer,95206,1,0,1
2013,Officer,95240,3,2,1
2013,Officer,95341,2,2,0
2013,Officer,95361,1,1,0
2013,Officer,95380,3,3,0
2013,Officer,95401,2,2,0
2013,Officer,95603,3,3,0
2013,Officer,95667,1,1,0
2013,Officer,95819,1,1,0
2013,Officer,95826,9,8,1
2013,Officer,95828,6,3,3
2013,Officer,95832,3,3,0
2013,Officer,96001,1,1,0
2013,Officer,96707,18,14,4
2013,Officer,96716,1,0,1
2013,Officer,96782,2,2,0
2013,Officer,96786,2,1,1
2013,Officer,96816,2,2,0
2013,Officer,96857,3,3,0
2013,Officer,96913,9,7,2
2013,Officer,97015,9,7,2
2013,Officer,97030,1,1,0
2013,Officer,97031,3,2,1
2013,Officer,97058,3,3,0
2013,Officer,97116,1,1,0
2013,Officer,97124,2,2,0
2013,Officer,97128,2,2,0
2013,Officer,97211,7,5,2
2013,Officer,97218,1,1,0
2013,Officer,97302,5,5,0
2013,Officer,97303,1,1,0
2013,Officer,97309,10,8,2
2013,Officer,97355,2,2,0
2013,Officer,97361,1,1,0
2013,Officer,97420,1,1,0
2013,Officer,97470,1,1,0
2013,Officer,97477,6,4,2
2013,Officer,97526,1,0,1
2013,Officer,97702,3,3,0
2013,Officer,97838,2,0,2
2013,Officer,97850,1,1,0
2013,Officer,97862,1,1,0
2013,Officer,97914,1,1,0
2013,Officer,98032,10,9,1
2013,Officer,98052,1,1,0
2013,Officer,98108,1,1,0
2013,Officer,98119,7,7,0
2013,Officer,98221,2,2,0
2013,Officer,98271,2,2,0
2013,Officer,98290,2,2,0
2013,Officer,98312,1,1,0
2013,Officer,98366,4,4,0
2013,Officer,98372,1,1,0
2013,Officer,98430,26,23,3
2013,Officer,98433,6,6,0
2013,Officer,98501,1,1,0
2013,Officer,98531,1,1,0
2013,Officer,98563,3,3,0
2013,Officer,98632,1,1,0
2013,Officer,98682,1,1,0
2013,Officer,98901,2,2,0
2013,Officer,98903,2,2,0
2013,Officer,99217,5,5,0
2013,Officer,99362,1,1,0
2013,Officer,99505,16,13,3
2013,Officer,99654,1,1,0
2013,Officer,99687,1,1,0
2013,Officer,99701,4,4,0
2013,Warrant Officer,00725,1,1,0
2013,Warrant Officer,00735,1,1,0
2013,Warrant Officer,00751,1,1,0
2013,Warrant Officer,00795,1,1,0
2013,Warrant Officer,00820,2,2,0
2013,Warrant Officer,00901,4,4,0
2013,Warrant Officer,00918,1,1,0
2013,Warrant Officer,01013,1,1,0
2013,Warrant Officer,01085,5,5,0
2013,Warrant Officer,01109,1,1,0
2013,Warrant Officer,01731,1,1,0
2013,Warrant Officer,02542,1,1,0
2013,Warrant Officer,02852,3,3,0
2013,Warrant Officer,02886,1,1,0
2013,Warrant Officer,03301,3,3,0
2013,Warrant Officer,04330,3,3,0
2013,Warrant Officer,04401,4,4,0
2013,Warrant Officer,05403,3,3,0
2013,Warrant Officer,05446,1,1,0
2013,Warrant Officer,05465,1,1,0
2013,Warrant Officer,05663,1,1,0
2013,Warrant Officer,06096,2,2,0
2013,Warrant Officer,06105,2,2,0
2013,Warrant Officer,06340,1,1,0
2013,Warrant Officer,06614,2,2,0
2013,Warrant Officer,07052,1,1,0
2013,Warrant Officer,08210,1,1,0
2013,Warrant Officer,08628,1,1,0
2013,Warrant Officer,08733,3,3,0
2013,Warrant Officer,08873,1,1,0
2013,Warrant Officer,11779,3,3,0
2013,Warrant Officer,12110,1,1,0
2013,Warrant Officer,12180,2,2,0
2013,Warrant Officer,13211,1,1,0
2013,Warrant Officer,13905,1,1,0
2013,Warrant Officer,14624,2,2,0
2013,Warrant Officer,15301,1,1,0
2013,Warrant Officer,15902,10,10,0
2013,Warrant Officer,15904,1,1,0
2013,Warrant Officer,17003,12,12,0
2013,Warrant Officer,17103,3,3,0
2013,Warrant Officer,17745,1,1,0
2013,Warrant Officer,18040,1,1,0
2013,Warrant Officer,18509,2,2,0
2013,Warrant Officer,19154,1,1,0
2013,Warrant Officer,19720,6,6,0
2013,Warrant Officer,19930,1,1,0
2013,Warrant Officer,19963,1,1,0
2013,Warrant Officer,19977,1,1,0
2013,Warrant Officer,20003,4,4,0
2013,Warrant Officer,20708,2,2,0
2013,Warrant Officer,21010,3,3,0
2013,Warrant Officer,21043,1,1,0
2013,Warrant Officer,21057,2,2,0
2013,Warrant Officer,21204,3,3,0
2013,Warrant Officer,21740,1,1,0
2013,Warrant Officer,22032,1,1,0
2013,Warrant Officer,22060,1,1,0
2013,Warrant Officer,22427,1,1,0
2013,Warrant Officer,22601,1,1,0
2013,Warrant Officer,23150,11,11,0
2013,Warrant Officer,23237,1,1,0
2013,Warrant Officer,23451,1,1,0
2013,Warrant Officer,23824,4,4,0
2013,Warrant Officer,24251,1,1,0
2013,Warrant Officer,24401,2,2,0
2013,Warrant Officer,25311,1,1,0
2013,Warrant Officer,25704,1,1,0
2013,Warrant Officer,26003,4,4,0
2013,Warrant Officer,26187,8,8,0
2013,Warrant Officer,27217,1,1,0
2013,Warrant Officer,27401,1,1,0
2013,Warrant Officer,27560,9,9,0
2013,Warrant Officer,27607,1,1,0
2013,Warrant Officer,27830,1,1,0
2013,Warrant Officer,28001,1,1,0
2013,Warrant Officer,28147,4,4,0
2013,Warrant Officer,28310,1,1,0
2013,Warrant Officer,28328,2,2,0
2013,Warrant Officer,28334,1,1,0
2013,Warrant Officer,28376,1,1,0
2013,Warrant Officer,28580,1,1,0
2013,Warrant Officer,28658,1,1,0
2013,Warrant Officer,29044,11,11,0
2013,Warrant Officer,29170,1,1,0
2013,Warrant Officer,29201,1,1,0
2013,Warrant Officer,29303,1,1,0
2013,Warrant Officer,29556,1,1,0
2013,Warrant Officer,29625,1,1,0
2013,Warrant Officer,30032,3,3,0
2013,Warrant Officer,30040,1,1,0
2013,Warrant Officer,30060,4,4,0
2013,Warrant Officer,30069,1,1,0
2013,Warrant Officer,30162,1,1,0
2013,Warrant Officer,30294,1,1,0
2013,Warrant Officer,30439,1,1,0
2013,Warrant Officer,30461,1,1,0
2013,Warrant Officer,30680,6,6,0
2013,Warrant Officer,30755,1,1,0
2013,Warrant Officer,30904,1,1,0
2013,Warrant Officer,31314,1,1,0
2013,Warrant Officer,31409,3,3,0
2013,Warrant Officer,31901,1,1,0
2013,Warrant Officer,32085,1,1,0
2013,Warrant Officer,32221,10,10,0
2013,Warrant Officer,32311,1,1,0
2013,Warrant Officer,33127,1,1,0
2013,Warrant Officer,33782,3,3,0
2013,Warrant Officer,34604,2,2,0
2013,Warrant Officer,35042,1,1,0
2013,Warrant Officer,35045,1,1,0
2013,Warrant Officer,35209,1,1,0
2013,Warrant Officer,35217,4,4,0
2013,Warrant Officer,35601,1,1,0
2013,Warrant Officer,35630,1,1,0
2013,Warrant Officer,36109,2,2,0
2013,Warrant Officer,36205,1,1,0
2013,Warrant Officer,36251,1,1,0
2013,Warrant Officer,36535,1,1,0
2013,Warrant Officer,36605,1,1,0
2013,Warrant Officer,36608,10,10,0
2013,Warrant Officer,36701,1,1,0
2013,Warrant Officer,37033,1,1,0
2013,Warrant Officer,37167,5,5,0
2013,Warrant Officer,37204,1,1,0
2013,Warrant Officer,37388,1,1,0
2013,Warrant Officer,37777,6,6,0
2013,Warrant Officer,37825,1,1,0
2013,Warrant Officer,38301,4,4,0
2013,Warrant Officer,38671,1,1,0
2013,Warrant Officer,38801,1,1,0
2013,Warrant Officer,38803,1,1,0
2013,Warrant Officer,38901,4,4,0
2013,Warrant Officer,39046,1,1,0
2013,Warrant Officer,39204,1,1,0
2013,Warrant Officer,39209,4,4,0
2013,Warrant Officer,39296,1,1,0
2013,Warrant Officer,39307,2,2,0
2013,Warrant Officer,39407,1,1,0
2013,Warrant Officer,39501,1,1,0
2013,Warrant Officer,39505,2,2,0
2013,Warrant Officer,39730,1,1,0
2013,Warrant Officer,40422,1,1,0
2013,Warrant Officer,40475,4,4,0
2013,Warrant Officer,40601,7,7,0
2013,Warrant Officer,41005,1,1,0
2013,Warrant Officer,41101,1,1,0
2013,Warrant Officer,42086,1,1,0
2013,Warrant Officer,42101,2,2,0
2013,Warrant Officer,43055,2,2,0
2013,Warrant Officer,43213,5,5,0
2013,Warrant Officer,43217,5,5,0
2013,Warrant Officer,44720,6,6,0
2013,Warrant Officer,45502,1,1,0
2013,Warrant Officer,45601,2,2,0
2013,Warrant Officer,46131,1,1,0
2013,Warrant Officer,46176,5,5,0
2013,Warrant Officer,46216,2,2,0
2013,Warrant Officer,46241,3,3,0
2013,Warrant Officer,47303,1,1,0
2013,Warrant Officer,47421,1,1,0
2013,Warrant Officer,47591,1,1,0
2013,Warrant Officer,47804,2,2,0
2013,Warrant Officer,47933,1,1,0
2013,Warrant Officer,48180,1,1,0
2013,Warrant Officer,48837,6,6,0
2013,Warrant Officer,50036,2,2,0
2013,Warrant Officer,50131,3,3,0
2013,Warrant Officer,50566,1,1,0
2013,Warrant Officer,50703,2,2,0
2013,Warrant Officer,52404,1,1,0
2013,Warrant Officer,52806,4,4,0
2013,Warrant Officer,53095,6,6,0
2013,Warrant Officer,53144,1,1,0
2013,Warrant Officer,53190,1,1,0
2013,Warrant Officer,53212,2,2,0
2013,Warrant Officer,53704,3,3,0
2013,Warrant Officer,53708,1,1,0
2013,Warrant Officer,54615,1,1,0
2013,Warrant Officer,54618,2,2,0
2013,Warrant Officer,54901,1,1,0
2013,Warrant Officer,55021,1,1,0
2013,Warrant Officer,55068,3,3,0
2013,Warrant Officer,55101,3,3,0
2013,Warrant Officer,55107,6,6,0
2013,Warrant Officer,55113,1,1,0
2013,Warrant Officer,55431,1,1,0
2013,Warrant Officer,56303,6,6,0
2013,Warrant Officer,56345,2,2,0
2013,Warrant Officer,57006,1,1,0
2013,Warrant Officer,57104,1,1,0
2013,Warrant Officer,57380,1,1,0
2013,Warrant Officer,57703,4,4,0
2013,Warrant Officer,58102,1,1,0
2013,Warrant Officer,58201,1,1,0
2013,Warrant Officer,58506,4,4,0
2013,Warrant Officer,58702,1,1,0
2013,Warrant Officer,59102,1,1,0
2013,Warrant Officer,59602,1,1,0
2013,Warrant Officer,60616,2,2,0
2013,Warrant Officer,60638,2,2,0
2013,Warrant Officer,60651,1,1,0
2013,Warrant Officer,62521,4,4,0
2013,Warrant Officer,62702,2,2,0
2013,Warrant Officer,63125,1,1,0
2013,Warrant Officer,63901,1,1,0
2013,Warrant Officer,64129,2,2,0
2013,Warrant Officer,64468,1,1,0
2013,Warrant Officer,64506,2,2,0
2013,Warrant Officer,64683,1,1,0
2013,Warrant Officer,65251,1,1,0
2013,Warrant Officer,65305,3,3,0
2013,Warrant Officer,65473,2,2,0
2013,Warrant Officer,65536,1,1,0
2013,Warrant Officer,65803,1,1,0
2013,Warrant Officer,66619,2,2,0
2013,Warrant Officer,66749,1,1,0
2013,Warrant Officer,66901,1,1,0
2013,Warrant Officer,67208,1,1,0
2013,Warrant Officer,67401,2,2,0
2013,Warrant Officer,67501,2,2,0
2013,Warrant Officer,67530,1,1,0
2013,Warrant Officer,67701,1,1,0
2013,Warrant Officer,68041,1,1,0
2013,Warrant Officer,68524,2,2,0
2013,Warrant Officer,68803,3,3,0
2013,Warrant Officer,68847,1,1,0
2013,Warrant Officer,68901,1,1,0
2013,Warrant Officer,69101,1,1,0
2013,Warrant Officer,70401,8,8,0
2013,Warrant Officer,70508,1,1,0
2013,Warrant Officer,71360,5,5,0
2013,Warrant Officer,72199,10,10,0
2013,Warrant Officer,72205,1,1,0
2013,Warrant Officer,72401,1,1,0
2013,Warrant Officer,72650,1,1,0
2013,Warrant Officer,72653,1,1,0
2013,Warrant Officer,72701,1,1,0
2013,Warrant Officer,73051,6,6,0
2013,Warrant Officer,73064,2,2,0
2013,Warrant Officer,73111,2,2,0
2013,Warrant Officer,73179,1,1,0
2013,Warrant Officer,73503,2,2,0
2013,Warrant Officer,74116,4,4,0
2013,Warrant Officer,75051,4,4,0
2013,Warrant Officer,75237,2,2,0
2013,Warrant Officer,76115,1,1,0
2013,Warrant Officer,76502,1,1,0
2013,Warrant Officer,76542,1,1,0
2013,Warrant Officer,76801,1,1,0
2013,Warrant Officer,77034,6,6,0
2013,Warrant Officer,78155,1,1,0
2013,Warrant Officer,78218,2,2,0
2013,Warrant Officer,78257,1,1,0
2013,Warrant Officer,78596,1,1,0
2013,Warrant Officer,78602,1,1,0
2013,Warrant Officer,78703,6,6,0
2013,Warrant Officer,78719,5,5,0
2013,Warrant Officer,80011,5,5,0
2013,Warrant Officer,80112,2,2,0
2013,Warrant Officer,80137,1,1,0
2013,Warrant Officer,80216,1,1,0
2013,Warrant Officer,80304,1,1,0
2013,Warrant Officer,80504,1,1,0
2013,Warrant Officer,80907,1,1,0
2013,Warrant Officer,82009,5,5,0
2013,Warrant Officer,82931,1,1,0
2013,Warrant Officer,83705,6,6,0
2013,Warrant Officer,83854,1,1,0
2013,Warrant Officer,84003,1,1,0
2013,Warrant Officer,84020,3,3,0
2013,Warrant Officer,84058,1,1,0
2013,Warrant Officer,84065,2,2,0
2013,Warrant Officer,84790,1,1,0
2013,Warrant Officer,85008,9,9,0
2013,Warrant Officer,85132,2,2,0
2013,Warrant Officer,85201,1,1,0
2013,Warrant Officer,85653,9,9,0
2013,Warrant Officer,87508,2,2,0
2013,Warrant Officer,88007,2,2,0
2013,Warrant Officer,89032,1,1,0
2013,Warrant Officer,89115,1,1,0
2013,Warrant Officer,89506,3,3,0
2013,Warrant Officer,89701,1,1,0
2013,Warrant Officer,90501,1,1,0
2013,Warrant Officer,90720,4,4,0
2013,Warrant Officer,90822,1,1,0
2013,Warrant Officer,92111,1,1,0
2013,Warrant Officer,93405,1,1,0
2013,Warrant Officer,93451,2,2,0
2013,Warrant Officer,93727,5,5,0
2013,Warrant Officer,94533,1,1,0
2013,Warrant Officer,94565,1,1,0
2013,Warrant Officer,94903,1,1,0
2013,Warrant Officer,95206,4,4,0
2013,Warrant Officer,95655,2,2,0
2013,Warrant Officer,95678,1,1,0
2013,Warrant Officer,95828,2,2,0
2013,Warrant Officer,95832,1,1,0
2013,Warrant Officer,96707,2,2,0
2013,Warrant Officer,96720,5,5,0
2013,Warrant Officer,96786,1,1,0
2013,Warrant Officer,96857,7,7,0
2013,Warrant Officer,96913,1,1,0
2013,Warrant Officer,97015,3,3,0
2013,Warrant Officer,97116,1,1,0
2013,Warrant Officer,97146,1,1,0
2013,Warrant Officer,97302,7,7,0
2013,Warrant Officer,97309,1,1,0
2013,Warrant Officer,97477,1,1,0
2013,Warrant Officer,97754,1,1,0
2013,Warrant Officer,97801,4,4,0
2013,Warrant Officer,98032,1,1,0
2013,Warrant Officer,98108,4,4,0
2013,Warrant Officer,98430,1,1,0
2013,Warrant Officer,98433,7,7,0
2013,Warrant Officer,98682,1,1,0
2013,Warrant Officer,98823,1,1,0
2013,Warrant Officer,98903,2,2,0
2013,Warrant Officer,99011,1,1,0
2013,Warrant Officer,99505,4,4,0
2014,Enlisted,     ,1,1,0
2014,Enlisted,00602,29,4,25
2014,Enlisted,00605,7,0,7
2014,Enlisted,00612,20,1,19
2014,Enlisted,00623,13,0,13
2014,Enlisted,00624,6,2,4
2014,Enlisted,00641,20,3,17
2014,Enlisted,00681,23,4,19
2014,Enlisted,00683,11,2,9
2014,Enlisted,00693,17,1,16
2014,Enlisted,00705,12,2,10
2014,Enlisted,00714,3,0,3
2014,Enlisted,00725,9,1,8
2014,Enlisted,00732,12,1,11
2014,Enlisted,00733,4,1,3
2014,Enlisted,00735,7,2,5
2014,Enlisted,00736,15,4,11
2014,Enlisted,00737,10,1,9
2014,Enlisted,00751,35,13,22
2014,Enlisted,00769,14,1,13
2014,Enlisted,00777,16,1,15
2014,Enlisted,00778,6,3,3
2014,Enlisted,00785,10,2,8
2014,Enlisted,00792,25,1,24
2014,Enlisted,00795,229,12,217
2014,Enlisted,00802,27,3,24
2014,Enlisted,00820,71,6,65
2014,Enlisted,00901,26,6,20
2014,Enlisted,00918,26,7,19
2014,Enlisted,00934,22,3,19
2014,Enlisted,00949,3,0,3
2014,Enlisted,00951,9,3,6
2014,Enlisted,00960,11,2,9
2014,Enlisted,00986,6,2,4
2014,Enlisted,01013,14,7,7
2014,Enlisted,01022,1,1,0
2014,Enlisted,01030,34,4,30
2014,Enlisted,01062,11,4,7
2014,Enlisted,01082,26,2,24
2014,Enlisted,01085,17,4,13
2014,Enlisted,01109,31,4,27
2014,Enlisted,01201,1,1,0
2014,Enlisted,01301,15,0,15
2014,Enlisted,01434,72,18,54
2014,Enlisted,01440,9,6,3
2014,Enlisted,01453,32,2,30
2014,Enlisted,01588,14,3,11
2014,Enlisted,01605,78,14,64
2014,Enlisted,01702,27,3,24
2014,Enlisted,01731,5,5,0
2014,Enlisted,01749,8,1,7
2014,Enlisted,01844,31,8,23
2014,Enlisted,01867,72,9,63
2014,Enlisted,01923,6,0,6
2014,Enlisted,01950,27,3,24
2014,Enlisted,02043,42,5,37
2014,Enlisted,02122,36,8,28
2014,Enlisted,02138,40,8,32
2014,Enlisted,02169,15,2,13
2014,Enlisted,02176,34,8,26
2014,Enlisted,02184,31,3,28
2014,Enlisted,02301,14,3,11
2014,Enlisted,02324,5,0,5
2014,Enlisted,02346,18,7,11
2014,Enlisted,02420,13,7,6
2014,Enlisted,02465,3,1,2
2014,Enlisted,02532,4,3,1
2014,Enlisted,02542,74,16,58
2014,Enlisted,02724,9,2,7
2014,Enlisted,02780,33,3,30
2014,Enlisted,02809,8,2,6
2014,Enlisted,02818,125,34,91
2014,Enlisted,02842,15,13,2
2014,Enlisted,02852,24,3,21
2014,Enlisted,02885,43,7,36
2014,Enlisted,02886,14,5,9
2014,Enlisted,02896,7,2,5
2014,Enlisted,02904,22,6,16
2014,Enlisted,02920,2,2,0
2014,Enlisted,03055,36,9,27
2014,Enlisted,03060,8,0,8
2014,Enlisted,03101,50,7,43
2014,Enlisted,03235,6,2,4
2014,Enlisted,03244,17,3,14
2014,Enlisted,03264,8,0,8
2014,Enlisted,03301,29,7,22
2014,Enlisted,03561,11,1,10
2014,Enlisted,03570,19,2,17
2014,Enlisted,03766,20,1,19
2014,Enlisted,03801,8,1,7
2014,Enlisted,03815,1,1,0
2014,Enlisted,03878,14,2,12
2014,Enlisted,04073,12,1,11
2014,Enlisted,04092,9,0,9
2014,Enlisted,04103,17,0,17
2014,Enlisted,04240,20,2,18
2014,Enlisted,04268,21,6,15
2014,Enlisted,04330,22,5,17
2014,Enlisted,04333,4,1,3
2014,Enlisted,04345,2,1,1
2014,Enlisted,04401,52,13,39
2014,Enlisted,04412,33,10,23
2014,Enlisted,04619,9,2,7
2014,Enlisted,04730,9,2,7
2014,Enlisted,04736,7,1,6
2014,Enlisted,04901,25,3,22
2014,Enlisted,04915,5,0,5
2014,Enlisted,04976,15,2,13
2014,Enlisted,05001,15,2,13
2014,Enlisted,05033,11,2,9
2014,Enlisted,05158,22,2,20
2014,Enlisted,05201,10,2,8
2014,Enlisted,05403,12,1,11
2014,Enlisted,05404,4,0,4
2014,Enlisted,05446,23,5,18
2014,Enlisted,05450,2,0,2
2014,Enlisted,05465,61,18,43
2014,Enlisted,05478,11,4,7
2014,Enlisted,05488,10,1,9
2014,Enlisted,05491,3,0,3
2014,Enlisted,05495,10,1,9
2014,Enlisted,05602,8,0,8
2014,Enlisted,05661,14,1,13
2014,Enlisted,05663,20,4,16
2014,Enlisted,05676,7,1,6
2014,Enlisted,05701,11,1,10
2014,Enlisted,05851,12,3,9
2014,Enlisted,05855,5,1,4
2014,Enlisted,06051,33,8,25
2014,Enlisted,06066,4,1,3
2014,Enlisted,06082,8,2,6
2014,Enlisted,06096,47,8,39
2014,Enlisted,06110,31,7,24
2014,Enlisted,06320,32,7,25
2014,Enlisted,06333,2,0,2
2014,Enlisted,06340,34,12,22
2014,Enlisted,06357,29,7,22
2014,Enlisted,06360,19,3,16
2014,Enlisted,06457,74,14,60
2014,Enlisted,06489,13,3,10
2014,Enlisted,06498,21,1,20
2014,Enlisted,06512,50,9,41
2014,Enlisted,06614,35,2,33
2014,Enlisted,06702,6,1,5
2014,Enlisted,06770,2,1,1
2014,Enlisted,06810,29,5,24
2014,Enlisted,06850,11,3,8
2014,Enlisted,07052,82,30,52
2014,Enlisted,07090,20,9,11
2014,Enlisted,07095,51,12,39
2014,Enlisted,07107,26,11,15
2014,Enlisted,07306,75,15,60
2014,Enlisted,07457,41,14,27
2014,Enlisted,07666,92,26,66
2014,Enlisted,07728,25,6,19
2014,Enlisted,07801,19,5,14
2014,Enlisted,07840,25,5,20
2014,Enlisted,07865,20,3,17
2014,Enlisted,07960,37,11,26
2014,Enlisted,08002,55,13,42
2014,Enlisted,08012,31,8,23
2014,Enlisted,08016,18,3,15
2014,Enlisted,08037,2,2,0
2014,Enlisted,08060,16,6,10
2014,Enlisted,08087,13,3,10
2014,Enlisted,08096,33,14,19
2014,Enlisted,08098,25,6,19
2014,Enlisted,08210,32,4,28
2014,Enlisted,08360,23,4,19
2014,Enlisted,08401,11,3,8
2014,Enlisted,08533,12,2,10
2014,Enlisted,08628,20,1,19
2014,Enlisted,08640,9,6,3
2014,Enlisted,08648,20,4,16
2014,Enlisted,08733,40,6,34
2014,Enlisted,08750,41,9,32
2014,Enlisted,08753,17,2,15
2014,Enlisted,08822,16,2,14
2014,Enlisted,08873,31,5,26
2014,Enlisted,10010,93,20,73
2014,Enlisted,10021,2,0,2
2014,Enlisted,10037,53,15,38
2014,Enlisted,10314,71,9,62
2014,Enlisted,10468,14,3,11
2014,Enlisted,10566,30,1,29
2014,Enlisted,10567,50,15,35
2014,Enlisted,10701,29,6,23
2014,Enlisted,10962,27,6,21
2014,Enlisted,11225,1,0,1
2014,Enlisted,11252,103,23,80
2014,Enlisted,11357,24,1,23
2014,Enlisted,11433,72,13,59
2014,Enlisted,11735,96,17,79
2014,Enlisted,11779,36,10,26
2014,Enlisted,12078,23,7,16
2014,Enlisted,12110,40,7,33
2014,Enlisted,12180,31,10,21
2014,Enlisted,12189,7,2,5
2014,Enlisted,12302,49,11,38
2014,Enlisted,12401,22,4,18
2014,Enlisted,12451,8,5,3
2014,Enlisted,12553,24,6,18
2014,Enlisted,12804,34,4,30
2014,Enlisted,12962,9,2,7
2014,Enlisted,12983,9,3,6
2014,Enlisted,13021,15,2,13
2014,Enlisted,13211,75,26,49
2014,Enlisted,13501,49,13,36
2014,Enlisted,13602,28,14,14
2014,Enlisted,13669,9,4,5
2014,Enlisted,13856,8,2,6
2014,Enlisted,13905,22,5,17
2014,Enlisted,14048,10,0,10
2014,Enlisted,14094,3,0,3
2014,Enlisted,14204,53,12,41
2014,Enlisted,14213,67,10,57
2014,Enlisted,14304,24,4,20
2014,Enlisted,14454,32,8,24
2014,Enlisted,14456,25,7,18
2014,Enlisted,14624,98,23,75
2014,Enlisted,14701,22,5,17
2014,Enlisted,14843,1,0,1
2014,Enlisted,14845,18,2,16
2014,Enlisted,14850,13,6,7
2014,Enlisted,15010,14,0,14
2014,Enlisted,15206,49,8,41
2014,Enlisted,15216,29,5,24
2014,Enlisted,15301,36,5,31
2014,Enlisted,15370,41,6,35
2014,Enlisted,15425,26,5,21
2014,Enlisted,15537,27,9,18
2014,Enlisted,15541,10,2,8
2014,Enlisted,15601,11,4,7
2014,Enlisted,15666,43,8,35
2014,Enlisted,15701,22,5,17
2014,Enlisted,15767,25,3,22
2014,Enlisted,15779,14,1,13
2014,Enlisted,15902,51,9,42
2014,Enlisted,15904,96,21,75
2014,Enlisted,16001,44,5,39
2014,Enlisted,16101,21,3,18
2014,Enlisted,16127,4,0,4
2014,Enlisted,16148,20,4,16
2014,Enlisted,16226,26,3,23
2014,Enlisted,16301,13,2,11
2014,Enlisted,16403,55,9,46
2014,Enlisted,16635,21,5,16
2014,Enlisted,16648,3,0,3
2014,Enlisted,16652,9,2,7
2014,Enlisted,16735,4,0,4
2014,Enlisted,16738,14,1,13
2014,Enlisted,16803,35,5,30
2014,Enlisted,16830,30,5,25
2014,Enlisted,16901,5,2,3
2014,Enlisted,17003,286,46,240
2014,Enlisted,17013,23,6,17
2014,Enlisted,17022,45,5,40
2014,Enlisted,17033,29,0,29
2014,Enlisted,17042,37,2,35
2014,Enlisted,17044,40,8,32
2014,Enlisted,17098,19,2,17
2014,Enlisted,17103,63,11,52
2014,Enlisted,17201,26,4,22
2014,Enlisted,17222,21,3,18
2014,Enlisted,17331,13,2,11
2014,Enlisted,17404,4,1,3
2014,Enlisted,17701,44,4,40
2014,Enlisted,17745,65,7,58
2014,Enlisted,17821,58,15,43
2014,Enlisted,17837,32,5,27
2014,Enlisted,18040,41,3,38
2014,Enlisted,18102,31,1,30
2014,Enlisted,18201,16,3,13
2014,Enlisted,18235,16,1,15
2014,Enlisted,18252,13,2,11
2014,Enlisted,18301,7,1,6
2014,Enlisted,18407,18,10,8
2014,Enlisted,18431,25,3,22
2014,Enlisted,18466,9,0,9
2014,Enlisted,18509,94,9,85
2014,Enlisted,18634,23,0,23
2014,Enlisted,18643,10,0,10
2014,Enlisted,18651,20,3,17
2014,Enlisted,18704,52,5,47
2014,Enlisted,18834,21,2,19
2014,Enlisted,18960,13,1,12
2014,Enlisted,19044,24,1,23
2014,Enlisted,19103,25,2,23
2014,Enlisted,19104,44,3,41
2014,Enlisted,19141,24,1,23
2014,Enlisted,19153,4,0,4
2014,Enlisted,19154,160,25,135
2014,Enlisted,19320,50,9,41
2014,Enlisted,19460,16,0,16
2014,Enlisted,19462,34,10,24
2014,Enlisted,19475,33,3,30
2014,Enlisted,19526,20,3,17
2014,Enlisted,19530,31,6,25
2014,Enlisted,19605,20,1,19
2014,Enlisted,19701,3,0,3
2014,Enlisted,19706,22,1,21
2014,Enlisted,19711,9,2,7
2014,Enlisted,19720,25,9,16
2014,Enlisted,19804,19,6,13
2014,Enlisted,19808,7,0,7
2014,Enlisted,19930,2,0,2
2014,Enlisted,19939,12,0,12
2014,Enlisted,19947,16,1,15
2014,Enlisted,19963,1,0,1
2014,Enlisted,19973,33,1,32
2014,Enlisted,19977,7,0,7
2014,Enlisted,20003,116,53,63
2014,Enlisted,20112,58,17,41
2014,Enlisted,20175,27,8,19
2014,Enlisted,20186,19,4,15
2014,Enlisted,20373,52,9,43
2014,Enlisted,20623,18,6,12
2014,Enlisted,20646,18,3,15
2014,Enlisted,20653,12,3,9
2014,Enlisted,20708,24,16,8
2014,Enlisted,20770,17,4,13
2014,Enlisted,20783,2,1,1
2014,Enlisted,20882,19,5,14
2014,Enlisted,20904,34,8,26
2014,Enlisted,21010,83,24,59
2014,Enlisted,21043,18,10,8
2014,Enlisted,21057,15,9,6
2014,Enlisted,21061,33,13,20
2014,Enlisted,21078,29,10,19
2014,Enlisted,21136,33,10,23
2014,Enlisted,21201,5,4,1
2014,Enlisted,21204,30,11,19
2014,Enlisted,21208,51,17,34
2014,Enlisted,21216,29,7,22
2014,Enlisted,21228,36,11,25
2014,Enlisted,21236,31,8,23
2014,Enlisted,21401,16,8,8
2014,Enlisted,21502,9,2,7
2014,Enlisted,21601,12,4,8
2014,Enlisted,21701,21,12,9
2014,Enlisted,21719,21,4,17
2014,Enlisted,21740,26,14,12
2014,Enlisted,21801,14,7,7
2014,Enlisted,21921,17,4,13
2014,Enlisted,22032,6,3,3
2014,Enlisted,22060,35,14,21
2014,Enlisted,22401,70,14,56
2014,Enlisted,22427,52,11,41
2014,Enlisted,22601,44,10,34
2014,Enlisted,22664,5,0,5
2014,Enlisted,22731,13,0,13
2014,Enlisted,22801,17,0,17
2014,Enlisted,22902,19,3,16
2014,Enlisted,23139,27,4,23
2014,Enlisted,23150,68,13,55
2014,Enlisted,23181,17,6,11
2014,Enlisted,23237,16,6,10
2014,Enlisted,23417,6,0,6
2014,Enlisted,23434,28,5,23
2014,Enlisted,23451,72,16,56
2014,Enlisted,23502,62,14,48
2014,Enlisted,23666,30,7,23
2014,Enlisted,23701,34,7,27
2014,Enlisted,23805,27,10,17
2014,Enlisted,23824,78,15,63
2014,Enlisted,23847,25,0,25
2014,Enlisted,23851,6,0,6
2014,Enlisted,23901,10,1,9
2014,Enlisted,24073,27,4,23
2014,Enlisted,24112,18,3,15
2014,Enlisted,24151,21,0,21
2014,Enlisted,24210,13,1,12
2014,Enlisted,24251,35,2,33
2014,Enlisted,24301,17,0,17
2014,Enlisted,24401,16,7,9
2014,Enlisted,24422,11,1,10
2014,Enlisted,24450,11,0,11
2014,Enlisted,24502,70,9,61
2014,Enlisted,24523,22,2,20
2014,Enlisted,24531,3,1,2
2014,Enlisted,24541,7,0,7
2014,Enlisted,24592,10,0,10
2014,Enlisted,24609,9,0,9
2014,Enlisted,24701,24,5,19
2014,Enlisted,24801,2,0,2
2014,Enlisted,24957,12,3,9
2014,Enlisted,25064,1,0,1
2014,Enlisted,25168,67,5,62
2014,Enlisted,25262,8,2,6
2014,Enlisted,25311,8,1,7
2014,Enlisted,25401,35,7,28
2014,Enlisted,25530,31,12,19
2014,Enlisted,25550,9,3,6
2014,Enlisted,25601,6,1,5
2014,Enlisted,25661,19,2,17
2014,Enlisted,25704,16,1,15
2014,Enlisted,25846,67,5,62
2014,Enlisted,26003,18,0,18
2014,Enlisted,26041,27,2,25
2014,Enlisted,26101,30,3,27
2014,Enlisted,26187,18,4,14
2014,Enlisted,26201,5,1,4
2014,Enlisted,26241,4,1,3
2014,Enlisted,26250,1,0,1
2014,Enlisted,26301,15,0,15
2014,Enlisted,26330,1,0,1
2014,Enlisted,26426,13,2,11
2014,Enlisted,26452,5,0,5
2014,Enlisted,26505,11,4,7
2014,Enlisted,26537,31,15,16
2014,Enlisted,26554,14,6,8
2014,Enlisted,26624,8,2,6
2014,Enlisted,26651,15,4,11
2014,Enlisted,26726,7,3,4
2014,Enlisted,26836,15,1,14
2014,Enlisted,27028,16,3,13
2014,Enlisted,27030,9,0,9
2014,Enlisted,27103,59,12,47
2014,Enlisted,27204,13,1,12
2014,Enlisted,27217,13,8,5
2014,Enlisted,27260,30,2,28
2014,Enlisted,27264,16,1,15
2014,Enlisted,27293,16,2,14
2014,Enlisted,27320,25,0,25
2014,Enlisted,27344,13,4,9
2014,Enlisted,27360,2,1,1
2014,Enlisted,27401,29,13,16
2014,Enlisted,27504,27,7,20
2014,Enlisted,27509,11,0,11
2014,Enlisted,27530,9,4,5
2014,Enlisted,27549,13,3,10
2014,Enlisted,27560,82,20,62
2014,Enlisted,27573,1,1,0
2014,Enlisted,27577,30,9,21
2014,Enlisted,27581,10,6,4
2014,Enlisted,27596,8,0,8
2014,Enlisted,27607,26,17,9
2014,Enlisted,27704,83,16,67
2014,Enlisted,27803,11,4,7
2014,Enlisted,27828,5,1,4
2014,Enlisted,27856,5,2,3
2014,Enlisted,27870,10,9,1
2014,Enlisted,27874,5,1,4
2014,Enlisted,27886,10,1,9
2014,Enlisted,27889,6,2,4
2014,Enlisted,27892,23,9,14
2014,Enlisted,27897,5,0,5
2014,Enlisted,27909,7,2,5
2014,Enlisted,27932,8,1,7
2014,Enlisted,28001,12,11,1
2014,Enlisted,28012,11,7,4
2014,Enlisted,28027,22,6,16
2014,Enlisted,28043,13,4,9
2014,Enlisted,28054,24,7,17
2014,Enlisted,28086,4,0,4
2014,Enlisted,28092,8,3,5
2014,Enlisted,28110,11,4,7
2014,Enlisted,28115,5,0,5
2014,Enlisted,28147,13,2,11
2014,Enlisted,28170,9,1,8
2014,Enlisted,28208,54,10,44
2014,Enlisted,28306,34,19,15
2014,Enlisted,28307,4,4,0
2014,Enlisted,28310,15,8,7
2014,Enlisted,28328,11,5,6
2014,Enlisted,28334,15,4,11
2014,Enlisted,28337,15,2,13
2014,Enlisted,28345,9,3,6
2014,Enlisted,28352,23,3,20
2014,Enlisted,28359,21,10,11
2014,Enlisted,28365,1,0,1
2014,Enlisted,28371,9,1,8
2014,Enlisted,28376,35,15,20
2014,Enlisted,28377,19,6,13
2014,Enlisted,28379,9,3,6
2014,Enlisted,28382,14,0,14
2014,Enlisted,28384,12,4,8
2014,Enlisted,28387,4,0,4
2014,Enlisted,28388,10,2,8
2014,Enlisted,28401,9,1,8
2014,Enlisted,28405,17,10,7
2014,Enlisted,28439,3,0,3
2014,Enlisted,28466,3,0,3
2014,Enlisted,28470,8,6,2
2014,Enlisted,28472,18,5,13
2014,Enlisted,28504,25,10,15
2014,Enlisted,28518,11,4,7
2014,Enlisted,28540,16,3,13
2014,Enlisted,28560,32,12,20
2014,Enlisted,28577,7,1,6
2014,Enlisted,28580,19,4,15
2014,Enlisted,28590,62,5,57
2014,Enlisted,28601,20,5,15
2014,Enlisted,28607,8,0,8
2014,Enlisted,28621,3,0,3
2014,Enlisted,28640,4,1,3
2014,Enlisted,28645,19,5,14
2014,Enlisted,28655,13,1,12
2014,Enlisted,28658,10,1,9
2014,Enlisted,28659,19,1,18
2014,Enlisted,28677,8,2,6
2014,Enlisted,28681,10,1,9
2014,Enlisted,28721,17,5,12
2014,Enlisted,28726,15,3,12
2014,Enlisted,28734,11,3,8
2014,Enlisted,28752,4,0,4
2014,Enlisted,28779,9,1,8
2014,Enlisted,28806,19,5,14
2014,Enlisted,28906,15,0,15
2014,Enlisted,29006,18,1,17
2014,Enlisted,29020,17,6,11
2014,Enlisted,29044,157,29,128
2014,Enlisted,29102,9,2,7
2014,Enlisted,29108,9,2,7
2014,Enlisted,29115,8,1,7
2014,Enlisted,29138,11,7,4
2014,Enlisted,29151,6,1,5
2014,Enlisted,29161,26,0,26
2014,Enlisted,29170,8,2,6
2014,Enlisted,29201,7,5,2
2014,Enlisted,29303,20,5,15
2014,Enlisted,29325,11,1,10
2014,Enlisted,29341,25,9,16
2014,Enlisted,29360,20,5,15
2014,Enlisted,29379,36,14,22
2014,Enlisted,29385,21,3,18
2014,Enlisted,29403,20,6,14
2014,Enlisted,29418,54,15,39
2014,Enlisted,29440,14,3,11
2014,Enlisted,29461,29,5,24
2014,Enlisted,29465,27,6,21
2014,Enlisted,29483,37,7,30
2014,Enlisted,29488,13,4,9
2014,Enlisted,29506,13,2,11
2014,Enlisted,29510,13,2,11
2014,Enlisted,29512,15,1,14
2014,Enlisted,29520,13,1,12
2014,Enlisted,29526,3,1,2
2014,Enlisted,29532,5,0,5
2014,Enlisted,29536,14,2,12
2014,Enlisted,29544,7,0,7
2014,Enlisted,29550,9,2,7
2014,Enlisted,29556,23,2,21
2014,Enlisted,29571,17,2,15
2014,Enlisted,29574,34,6,28
2014,Enlisted,29577,2,2,0
2014,Enlisted,29605,25,2,23
2014,Enlisted,29620,18,6,12
2014,Enlisted,29625,71,9,62
2014,Enlisted,29631,8,2,6
2014,Enlisted,29633,2,0,2
2014,Enlisted,29641,2,0,2
2014,Enlisted,29644,20,6,14
2014,Enlisted,29646,29,9,20
2014,Enlisted,29651,35,2,33
2014,Enlisted,29653,26,2,24
2014,Enlisted,29679,1,1,0
2014,Enlisted,29706,7,1,6
2014,Enlisted,29715,17,4,13
2014,Enlisted,29720,24,2,22
2014,Enlisted,29732,39,2,37
2014,Enlisted,29810,2,0,2
2014,Enlisted,29812,6,0,6
2014,Enlisted,29824,18,3,15
2014,Enlisted,29829,43,8,35
2014,Enlisted,29845,8,1,7
2014,Enlisted,29885,1,0,1
2014,Enlisted,29906,42,10,32
2014,Enlisted,29944,10,4,6
2014,Enlisted,30014,44,6,38
2014,Enlisted,30032,41,5,36
2014,Enlisted,30040,86,40,46
2014,Enlisted,30045,29,11,18
2014,Enlisted,30060,186,49,137
2014,Enlisted,30069,44,14,30
2014,Enlisted,30114,15,3,12
2014,Enlisted,30125,18,1,17
2014,Enlisted,30134,4,0,4
2014,Enlisted,30144,115,33,82
2014,Enlisted,30162,26,7,19
2014,Enlisted,30224,16,3,13
2014,Enlisted,30233,13,3,10
2014,Enlisted,30241,33,8,25
2014,Enlisted,30263,61,15,46
2014,Enlisted,30294,45,12,33
2014,Enlisted,30297,47,15,32
2014,Enlisted,30336,40,14,26
2014,Enlisted,30401,2,0,2
2014,Enlisted,30427,8,1,7
2014,Enlisted,30439,3,2,1
2014,Enlisted,30461,31,7,24
2014,Enlisted,30501,24,3,21
2014,Enlisted,30577,12,3,9
2014,Enlisted,30635,6,2,4
2014,Enlisted,30655,31,5,26
2014,Enlisted,30673,28,11,17
2014,Enlisted,30680,115,30,85
2014,Enlisted,30701,50,11,39
2014,Enlisted,30720,40,11,29
2014,Enlisted,30824,6,2,4
2014,Enlisted,30830,3,2,1
2014,Enlisted,30904,89,21,68
2014,Enlisted,30905,38,17,21
2014,Enlisted,31015,19,8,11
2014,Enlisted,31029,32,12,20
2014,Enlisted,31040,34,17,17
2014,Enlisted,31061,13,4,9
2014,Enlisted,31211,59,15,44
2014,Enlisted,31313,13,4,9
2014,Enlisted,31314,28,3,25
2014,Enlisted,31329,11,1,10
2014,Enlisted,31406,32,6,26
2014,Enlisted,31409,29,14,15
2014,Enlisted,31416,61,19,42
2014,Enlisted,31520,11,2,9
2014,Enlisted,31533,13,2,11
2014,Enlisted,31601,14,7,7
2014,Enlisted,31701,23,3,20
2014,Enlisted,31719,14,6,8
2014,Enlisted,31792,19,14,5
2014,Enlisted,31794,4,0,4
2014,Enlisted,31901,39,19,20
2014,Enlisted,31905,26,12,14
2014,Enlisted,32055,9,1,8
2014,Enlisted,32064,33,4,29
2014,Enlisted,32084,25,4,21
2014,Enlisted,32085,5,5,0
2014,Enlisted,32086,4,4,0
2014,Enlisted,32091,114,46,68
2014,Enlisted,32114,26,8,18
2014,Enlisted,32177,12,2,10
2014,Enlisted,32221,117,41,76
2014,Enlisted,32311,26,7,19
2014,Enlisted,32351,33,5,28
2014,Enlisted,32406,32,11,21
2014,Enlisted,32425,20,4,16
2014,Enlisted,32428,16,1,15
2014,Enlisted,32447,24,12,12
2014,Enlisted,32514,30,13,17
2014,Enlisted,32536,14,4,10
2014,Enlisted,32609,3,1,2
2014,Enlisted,32724,15,2,13
2014,Enlisted,32727,22,5,17
2014,Enlisted,32771,38,9,29
2014,Enlisted,32806,43,18,25
2014,Enlisted,32827,2,2,0
2014,Enlisted,32924,28,15,13
2014,Enlisted,32935,23,6,17
2014,Enlisted,33020,29,10,19
2014,Enlisted,33024,3,0,3
2014,Enlisted,33039,3,1,2
2014,Enlisted,33092,2,2,0
2014,Enlisted,33127,101,38,63
2014,Enlisted,33315,67,20,47
2014,Enlisted,33405,25,8,17
2014,Enlisted,33406,36,8,28
2014,Enlisted,33523,15,1,14
2014,Enlisted,33563,16,2,14
2014,Enlisted,33606,13,2,11
2014,Enlisted,33711,21,7,14
2014,Enlisted,33782,145,46,99
2014,Enlisted,33811,12,3,9
2014,Enlisted,33825,12,5,7
2014,Enlisted,33830,13,2,11
2014,Enlisted,33844,18,6,12
2014,Enlisted,33859,16,5,11
2014,Enlisted,33873,5,5,0
2014,Enlisted,33880,15,2,13
2014,Enlisted,33916,12,1,11
2014,Enlisted,34142,34,8,26
2014,Enlisted,34208,30,8,22
2014,Enlisted,34221,14,1,13
2014,Enlisted,34237,15,3,12
2014,Enlisted,34266,4,1,3
2014,Enlisted,34429,38,6,32
2014,Enlisted,34474,47,19,28
2014,Enlisted,34604,2,2,0
2014,Enlisted,34748,26,13,13
2014,Enlisted,34947,19,6,13
2014,Enlisted,35010,17,0,17
2014,Enlisted,35016,10,0,10
2014,Enlisted,35040,16,0,16
2014,Enlisted,35042,20,2,18
2014,Enlisted,35045,1,0,1
2014,Enlisted,35055,34,10,24
2014,Enlisted,35072,31,4,27
2014,Enlisted,35121,43,0,43
2014,Enlisted,35124,40,6,34
2014,Enlisted,35146,7,1,6
2014,Enlisted,35150,16,4,12
2014,Enlisted,35161,32,5,27
2014,Enlisted,35178,13,4,9
2014,Enlisted,35209,11,8,3
2014,Enlisted,35217,68,18,50
2014,Enlisted,35405,11,1,10
2014,Enlisted,35442,5,0,5
2014,Enlisted,35476,12,1,11
2014,Enlisted,35501,7,1,6
2014,Enlisted,35555,10,0,10
2014,Enlisted,35565,13,1,12
2014,Enlisted,35592,7,0,7
2014,Enlisted,35594,23,3,20
2014,Enlisted,35601,66,5,61
2014,Enlisted,35613,31,3,28
2014,Enlisted,35630,30,8,22
2014,Enlisted,35660,10,1,9
2014,Enlisted,35768,3,3,0
2014,Enlisted,35803,41,2,39
2014,Enlisted,35805,20,9,11
2014,Enlisted,35904,63,19,44
2014,Enlisted,35950,12,0,12
2014,Enlisted,35967,31,14,17
2014,Enlisted,36009,11,3,8
2014,Enlisted,36010,8,0,8
2014,Enlisted,36016,16,1,15
2014,Enlisted,36032,21,1,20
2014,Enlisted,36043,30,4,26
2014,Enlisted,36067,37,4,33
2014,Enlisted,36072,6,0,6
2014,Enlisted,36078,6,0,6
2014,Enlisted,36081,24,8,16
2014,Enlisted,36083,9,1,8
2014,Enlisted,36109,71,12,59
2014,Enlisted,36117,1,0,1
2014,Enlisted,36121,7,1,6
2014,Enlisted,36203,28,2,26
2014,Enlisted,36205,32,8,24
2014,Enlisted,36250,5,2,3
2014,Enlisted,36251,20,6,14
2014,Enlisted,36265,34,7,27
2014,Enlisted,36301,22,3,19
2014,Enlisted,36322,26,7,19
2014,Enlisted,36323,10,5,5
2014,Enlisted,36330,13,2,11
2014,Enlisted,36331,14,1,13
2014,Enlisted,36340,26,9,17
2014,Enlisted,36344,7,2,5
2014,Enlisted,36421,3,0,3
2014,Enlisted,36426,8,3,5
2014,Enlisted,36442,9,0,9
2014,Enlisted,36460,13,5,8
2014,Enlisted,36502,21,2,19
2014,Enlisted,36532,13,3,10
2014,Enlisted,36535,12,3,9
2014,Enlisted,36545,8,1,7
2014,Enlisted,36605,67,11,56
2014,Enlisted,36608,10,1,9
2014,Enlisted,36701,2,2,0
2014,Enlisted,36726,9,4,5
2014,Enlisted,36732,15,0,15
2014,Enlisted,36748,4,0,4
2014,Enlisted,36756,11,0,11
2014,Enlisted,36784,9,0,9
2014,Enlisted,36801,19,2,17
2014,Enlisted,36832,17,1,16
2014,Enlisted,36854,25,4,21
2014,Enlisted,36867,15,3,12
2014,Enlisted,36904,5,0,5
2014,Enlisted,37015,11,4,7
2014,Enlisted,37033,7,0,7
2014,Enlisted,37042,10,7,3
2014,Enlisted,37056,14,3,11
2014,Enlisted,37066,17,7,10
2014,Enlisted,37083,21,6,15
2014,Enlisted,37090,37,14,23
2014,Enlisted,37091,12,3,9
2014,Enlisted,37097,7,4,3
2014,Enlisted,37110,37,7,30
2014,Enlisted,37129,30,9,21
2014,Enlisted,37160,9,2,7
2014,Enlisted,37167,76,32,44
2014,Enlisted,37172,13,6,7
2014,Enlisted,37178,4,1,3
2014,Enlisted,37185,13,4,9
2014,Enlisted,37204,117,60,57
2014,Enlisted,37303,15,2,13
2014,Enlisted,37321,7,1,6
2014,Enlisted,37323,31,6,25
2014,Enlisted,37327,5,1,4
2014,Enlisted,37334,2,1,1
2014,Enlisted,37356,5,1,4
2014,Enlisted,37388,26,11,15
2014,Enlisted,37398,15,3,12
2014,Enlisted,37404,40,11,29
2014,Enlisted,37615,10,3,7
2014,Enlisted,37620,14,3,11
2014,Enlisted,37644,9,2,7
2014,Enlisted,37645,20,8,12
2014,Enlisted,37650,6,3,3
2014,Enlisted,37683,6,2,4
2014,Enlisted,37717,9,3,6
2014,Enlisted,37743,28,9,19
2014,Enlisted,37757,4,1,3
2014,Enlisted,37760,15,6,9
2014,Enlisted,37771,33,8,25
2014,Enlisted,37777,26,9,17
2014,Enlisted,37801,3,1,2
2014,Enlisted,37821,16,4,12
2014,Enlisted,37825,12,3,9
2014,Enlisted,37841,10,3,7
2014,Enlisted,37854,4,2,2
2014,Enlisted,37857,4,2,2
2014,Enlisted,37860,7,3,4
2014,Enlisted,37863,3,2,1
2014,Enlisted,37874,19,3,16
2014,Enlisted,37919,51,20,31
2014,Enlisted,37939,28,9,19
2014,Enlisted,38001,19,3,16
2014,Enlisted,38008,9,1,8
2014,Enlisted,38012,17,9,8
2014,Enlisted,38019,2,1,1
2014,Enlisted,38024,6,2,4
2014,Enlisted,38053,25,7,18
2014,Enlisted,38063,9,2,7
2014,Enlisted,38079,2,0,2
2014,Enlisted,38118,23,8,15
2014,Enlisted,38201,15,1,14
2014,Enlisted,38225,11,6,5
2014,Enlisted,38242,5,2,3
2014,Enlisted,38261,8,0,8
2014,Enlisted,38301,7,1,6
2014,Enlisted,38302,14,3,11
2014,Enlisted,38320,6,4,2
2014,Enlisted,38340,24,4,20
2014,Enlisted,38343,15,5,10
2014,Enlisted,38344,6,3,3
2014,Enlisted,38348,2,2,0
2014,Enlisted,38351,3,1,2
2014,Enlisted,38358,7,2,5
2014,Enlisted,38363,11,3,8
2014,Enlisted,38372,4,1,3
2014,Enlisted,38375,16,0,16
2014,Enlisted,38382,18,2,16
2014,Enlisted,38401,22,7,15
2014,Enlisted,38462,8,5,3
2014,Enlisted,38464,5,2,3
2014,Enlisted,38478,1,0,1
2014,Enlisted,38485,22,9,13
2014,Enlisted,38506,20,7,13
2014,Enlisted,38556,22,12,10
2014,Enlisted,38563,7,2,5
2014,Enlisted,38570,9,3,6
2014,Enlisted,38572,4,2,2
2014,Enlisted,38583,3,1,2
2014,Enlisted,38606,27,8,19
2014,Enlisted,38614,10,2,8
2014,Enlisted,38632,21,7,14
2014,Enlisted,38635,20,7,13
2014,Enlisted,38655,9,4,5
2014,Enlisted,38663,11,0,11
2014,Enlisted,38668,28,9,19
2014,Enlisted,38671,41,8,33
2014,Enlisted,38701,22,0,22
2014,Enlisted,38703,3,2,1
2014,Enlisted,38732,5,2,3
2014,Enlisted,38737,15,1,14
2014,Enlisted,38751,17,1,16
2014,Enlisted,38801,51,8,43
2014,Enlisted,38803,17,7,10
2014,Enlisted,38821,11,2,9
2014,Enlisted,38829,24,2,22
2014,Enlisted,38835,17,3,14
2014,Enlisted,38843,8,1,7
2014,Enlisted,38851,29,0,29
2014,Enlisted,38852,4,2,2
2014,Enlisted,38858,6,1,5
2014,Enlisted,38860,6,0,6
2014,Enlisted,38863,18,0,18
2014,Enlisted,38901,8,5,3
2014,Enlisted,38902,17,2,15
2014,Enlisted,38915,11,1,10
2014,Enlisted,38916,23,3,20
2014,Enlisted,38921,15,2,13
2014,Enlisted,38926,1,1,0
2014,Enlisted,38935,19,2,17
2014,Enlisted,38965,7,1,6
2014,Enlisted,38967,15,0,15
2014,Enlisted,39043,27,7,20
2014,Enlisted,39046,32,11,21
2014,Enlisted,39051,19,5,14
2014,Enlisted,39059,13,2,11
2014,Enlisted,39060,34,2,32
2014,Enlisted,39074,16,4,12
2014,Enlisted,39090,15,2,13
2014,Enlisted,39111,11,2,9
2014,Enlisted,39114,10,1,9
2014,Enlisted,39117,14,1,13
2014,Enlisted,39120,10,0,10
2014,Enlisted,39159,6,2,4
2014,Enlisted,39168,5,1,4
2014,Enlisted,39183,31,3,28
2014,Enlisted,39194,12,1,11
2014,Enlisted,39202,2,2,0
2014,Enlisted,39204,28,4,24
2014,Enlisted,39209,37,5,32
2014,Enlisted,39216,19,13,6
2014,Enlisted,39296,11,2,9
2014,Enlisted,39307,18,4,14
2014,Enlisted,39328,8,1,7
2014,Enlisted,39339,10,0,10
2014,Enlisted,39345,40,8,32
2014,Enlisted,39350,10,1,9
2014,Enlisted,39355,7,2,5
2014,Enlisted,39367,12,2,10
2014,Enlisted,39403,2,2,0
2014,Enlisted,39407,70,19,51
2014,Enlisted,39422,11,4,7
2014,Enlisted,39429,18,5,13
2014,Enlisted,39440,5,1,4
2014,Enlisted,39452,24,5,19
2014,Enlisted,39455,7,3,4
2014,Enlisted,39466,11,2,9
2014,Enlisted,39470,31,7,24
2014,Enlisted,39475,7,0,7
2014,Enlisted,39476,4,1,3
2014,Enlisted,39501,14,2,12
2014,Enlisted,39505,31,17,14
2014,Enlisted,39507,23,5,18
2014,Enlisted,39532,28,3,25
2014,Enlisted,39556,8,2,6
2014,Enlisted,39567,14,4,10
2014,Enlisted,39577,7,3,4
2014,Enlisted,39601,28,6,22
2014,Enlisted,39638,6,1,5
2014,Enlisted,39648,21,2,19
2014,Enlisted,39654,31,8,23
2014,Enlisted,39667,18,5,13
2014,Enlisted,39704,19,1,18
2014,Enlisted,39730,12,0,12
2014,Enlisted,39735,10,0,10
2014,Enlisted,39744,11,0,11
2014,Enlisted,39760,16,1,15
2014,Enlisted,39773,7,0,7
2014,Enlisted,40004,5,1,4
2014,Enlisted,40065,16,2,14
2014,Enlisted,40069,6,0,6
2014,Enlisted,40108,24,1,23
2014,Enlisted,40121,1,0,1
2014,Enlisted,40209,44,12,32
2014,Enlisted,40213,13,8,5
2014,Enlisted,40218,38,4,34
2014,Enlisted,40311,4,1,3
2014,Enlisted,40330,9,3,6
2014,Enlisted,40351,29,3,26
2014,Enlisted,40422,6,0,6
2014,Enlisted,40472,26,2,24
2014,Enlisted,40475,149,21,128
2014,Enlisted,40510,25,5,20
2014,Enlisted,40516,4,1,3
2014,Enlisted,40601,49,15,34
2014,Enlisted,40741,28,2,26
2014,Enlisted,40769,12,3,9
2014,Enlisted,40831,22,0,22
2014,Enlisted,40906,17,6,11
2014,Enlisted,40965,29,4,25
2014,Enlisted,41005,46,11,35
2014,Enlisted,41008,13,1,12
2014,Enlisted,41031,12,3,9
2014,Enlisted,41056,11,1,10
2014,Enlisted,41094,55,8,47
2014,Enlisted,41101,30,1,29
2014,Enlisted,41164,6,1,5
2014,Enlisted,41339,15,1,14
2014,Enlisted,41653,26,3,23
2014,Enlisted,41701,13,0,13
2014,Enlisted,42025,7,2,5
2014,Enlisted,42064,5,0,5
2014,Enlisted,42071,39,2,37
2014,Enlisted,42086,21,6,15
2014,Enlisted,42101,45,9,36
2014,Enlisted,42141,15,3,12
2014,Enlisted,42167,4,0,4
2014,Enlisted,42240,13,2,11
2014,Enlisted,42276,8,5,3
2014,Enlisted,42301,21,11,10
2014,Enlisted,42330,5,0,5
2014,Enlisted,42345,9,2,7
2014,Enlisted,42420,2,0,2
2014,Enlisted,42431,14,3,11
2014,Enlisted,42501,31,3,28
2014,Enlisted,42633,4,1,3
2014,Enlisted,42701,6,3,3
2014,Enlisted,42718,4,0,4
2014,Enlisted,42754,17,1,16
2014,Enlisted,43040,57,4,53
2014,Enlisted,43055,43,7,36
2014,Enlisted,43102,17,1,16
2014,Enlisted,43213,106,12,94
2014,Enlisted,43217,50,13,37
2014,Enlisted,43228,23,3,20
2014,Enlisted,43235,16,10,6
2014,Enlisted,43302,25,2,23
2014,Enlisted,43402,29,7,22
2014,Enlisted,43452,1,1,0
2014,Enlisted,43465,133,22,111
2014,Enlisted,43614,61,5,56
2014,Enlisted,43756,58,3,55
2014,Enlisted,43812,19,0,19
2014,Enlisted,44023,48,3,45
2014,Enlisted,44055,19,3,16
2014,Enlisted,44128,76,7,69
2014,Enlisted,44142,26,2,24
2014,Enlisted,44224,79,5,74
2014,Enlisted,44256,43,3,40
2014,Enlisted,44313,13,1,12
2014,Enlisted,44444,67,8,59
2014,Enlisted,44515,47,4,43
2014,Enlisted,44601,15,0,15
2014,Enlisted,44622,11,0,11
2014,Enlisted,44691,17,1,16
2014,Enlisted,44720,152,12,140
2014,Enlisted,44857,27,1,26
2014,Enlisted,44870,22,6,16
2014,Enlisted,44883,39,6,33
2014,Enlisted,44903,40,3,37
2014,Enlisted,45015,45,3,42
2014,Enlisted,45036,20,2,18
2014,Enlisted,45044,45,1,44
2014,Enlisted,45215,95,12,83
2014,Enlisted,45331,20,2,18
2014,Enlisted,45346,20,0,20
2014,Enlisted,45356,22,0,22
2014,Enlisted,45385,19,7,12
2014,Enlisted,45430,28,0,28
2014,Enlisted,45502,14,4,10
2014,Enlisted,45505,63,2,61
2014,Enlisted,45601,28,0,28
2014,Enlisted,45662,27,0,27
2014,Enlisted,45804,25,5,20
2014,Enlisted,45885,16,0,16
2014,Enlisted,46012,27,2,25
2014,Enlisted,46036,6,2,4
2014,Enlisted,46041,22,3,19
2014,Enlisted,46052,4,0,4
2014,Enlisted,46060,12,1,11
2014,Enlisted,46122,26,4,22
2014,Enlisted,46124,30,8,22
2014,Enlisted,46131,108,19,89
2014,Enlisted,46135,9,2,7
2014,Enlisted,46140,6,0,6
2014,Enlisted,46151,30,8,22
2014,Enlisted,46176,50,4,46
2014,Enlisted,46208,11,2,9
2014,Enlisted,46216,67,19,48
2014,Enlisted,46241,162,31,131
2014,Enlisted,46249,16,2,14
2014,Enlisted,46323,12,1,11
2014,Enlisted,46350,12,1,11
2014,Enlisted,46360,2,0,2
2014,Enlisted,46383,17,1,16
2014,Enlisted,46402,23,4,19
2014,Enlisted,46406,39,12,27
2014,Enlisted,46517,27,3,24
2014,Enlisted,46563,23,5,18
2014,Enlisted,46580,22,4,18
2014,Enlisted,46613,60,8,52
2014,Enlisted,46703,15,3,12
2014,Enlisted,46714,9,3,6
2014,Enlisted,46750,25,2,23
2014,Enlisted,46809,19,2,17
2014,Enlisted,46825,92,14,78
2014,Enlisted,46901,15,5,10
2014,Enlisted,46947,30,3,27
2014,Enlisted,46953,16,2,14
2014,Enlisted,46970,7,2,5
2014,Enlisted,47150,45,4,41
2014,Enlisted,47167,12,3,9
2014,Enlisted,47170,17,0,17
2014,Enlisted,47203,15,2,13
2014,Enlisted,47250,22,1,21
2014,Enlisted,47265,7,2,5
2014,Enlisted,47274,40,4,36
2014,Enlisted,47303,40,5,35
2014,Enlisted,47331,20,7,13
2014,Enlisted,47348,30,3,27
2014,Enlisted,47374,10,1,9
2014,Enlisted,47394,12,2,10
2014,Enlisted,47401,31,2,29
2014,Enlisted,47421,32,4,28
2014,Enlisted,47441,23,2,21
2014,Enlisted,47501,21,4,17
2014,Enlisted,47546,34,3,31
2014,Enlisted,47591,19,0,19
2014,Enlisted,47715,76,13,63
2014,Enlisted,47804,42,7,35
2014,Enlisted,47834,18,1,17
2014,Enlisted,47872,11,2,9
2014,Enlisted,47905,63,10,53
2014,Enlisted,47933,17,2,15
2014,Enlisted,47960,16,1,15
2014,Enlisted,47977,15,1,14
2014,Enlisted,47978,2,1,1
2014,Enlisted,48060,13,1,12
2014,Enlisted,48180,82,11,71
2014,Enlisted,48197,22,1,21
2014,Enlisted,48208,42,8,34
2014,Enlisted,48234,108,16,92
2014,Enlisted,48341,56,7,49
2014,Enlisted,48446,14,2,12
2014,Enlisted,48503,1,0,1
2014,Enlisted,48601,90,27,63
2014,Enlisted,48642,19,5,14
2014,Enlisted,48706,26,5,21
2014,Enlisted,48801,18,5,13
2014,Enlisted,48813,1,0,1
2014,Enlisted,48817,25,5,20
2014,Enlisted,48837,67,8,59
2014,Enlisted,48838,20,6,14
2014,Enlisted,48843,32,5,27
2014,Enlisted,48906,34,12,22
2014,Enlisted,48912,13,2,11
2014,Enlisted,49009,34,10,24
2014,Enlisted,49012,80,8,72
2014,Enlisted,49047,25,8,17
2014,Enlisted,49091,12,1,11
2014,Enlisted,49201,7,1,6
2014,Enlisted,49202,28,5,23
2014,Enlisted,49221,2,0,2
2014,Enlisted,49224,8,4,4
2014,Enlisted,49306,4,0,4
2014,Enlisted,49307,22,4,18
2014,Enlisted,49437,21,0,21
2014,Enlisted,49509,109,16,93
2014,Enlisted,49601,7,2,5
2014,Enlisted,49660,12,4,8
2014,Enlisted,49707,10,2,8
2014,Enlisted,49721,20,2,18
2014,Enlisted,49739,67,21,46
2014,Enlisted,49783,17,1,16
2014,Enlisted,49802,3,1,2
2014,Enlisted,49837,19,1,18
2014,Enlisted,49849,22,7,15
2014,Enlisted,49855,13,4,9
2014,Enlisted,49908,2,1,1
2014,Enlisted,49913,5,1,4
2014,Enlisted,49935,4,0,4
2014,Enlisted,50025,4,0,4
2014,Enlisted,50036,38,5,33
2014,Enlisted,50126,18,1,17
2014,Enlisted,50131,229,39,190
2014,Enlisted,50138,7,0,7
2014,Enlisted,50158,20,1,19
2014,Enlisted,50220,8,2,6
2014,Enlisted,50401,13,3,10
2014,Enlisted,50501,25,4,21
2014,Enlisted,50511,10,2,8
2014,Enlisted,50566,11,0,11
2014,Enlisted,50588,21,1,20
2014,Enlisted,50616,8,0,8
2014,Enlisted,50662,22,1,21
2014,Enlisted,50703,52,6,46
2014,Enlisted,50841,21,0,21
2014,Enlisted,51031,20,4,16
2014,Enlisted,51111,34,2,32
2014,Enlisted,51201,4,0,4
2014,Enlisted,51301,5,0,5
2014,Enlisted,51334,13,4,9
2014,Enlisted,51401,5,1,4
2014,Enlisted,51442,9,2,7
2014,Enlisted,51503,45,13,32
2014,Enlisted,51601,5,3,2
2014,Enlisted,52002,29,4,25
2014,Enlisted,52246,71,9,62
2014,Enlisted,52353,15,2,13
2014,Enlisted,52404,77,5,72
2014,Enlisted,52501,23,0,23
2014,Enlisted,52544,10,1,9
2014,Enlisted,52556,19,0,19
2014,Enlisted,52577,10,1,9
2014,Enlisted,52632,5,1,4
2014,Enlisted,52638,13,4,9
2014,Enlisted,52641,5,1,4
2014,Enlisted,52732,11,2,9
2014,Enlisted,52761,9,3,6
2014,Enlisted,52806,38,7,31
2014,Enlisted,53027,6,0,6
2014,Enlisted,53066,13,0,13
2014,Enlisted,53073,10,0,10
2014,Enlisted,53089,30,2,28
2014,Enlisted,53094,19,4,15
2014,Enlisted,53095,19,3,16
2014,Enlisted,53105,11,1,10
2014,Enlisted,53121,15,2,13
2014,Enlisted,53144,8,0,8
2014,Enlisted,53154,2,0,2
2014,Enlisted,53186,8,0,8
2014,Enlisted,53190,17,1,16
2014,Enlisted,53212,42,8,34
2014,Enlisted,53403,6,0,6
2014,Enlisted,53511,18,3,15
2014,Enlisted,53538,9,3,6
2014,Enlisted,53545,18,3,15
2014,Enlisted,53581,11,2,9
2014,Enlisted,53704,142,34,108
2014,Enlisted,53818,6,0,6
2014,Enlisted,53821,10,0,10
2014,Enlisted,53901,6,0,6
2014,Enlisted,53913,9,0,9
2014,Enlisted,53948,10,1,9
2014,Enlisted,53959,13,3,10
2014,Enlisted,53963,14,2,12
2014,Enlisted,54017,16,5,11
2014,Enlisted,54022,13,3,10
2014,Enlisted,54143,13,1,12
2014,Enlisted,54241,3,0,3
2014,Enlisted,54303,21,7,14
2014,Enlisted,54401,26,5,21
2014,Enlisted,54405,14,3,11
2014,Enlisted,54409,7,1,6
2014,Enlisted,54449,20,3,17
2014,Enlisted,54451,11,1,10
2014,Enlisted,54452,10,2,8
2014,Enlisted,54455,9,1,8
2014,Enlisted,54456,11,0,11
2014,Enlisted,54481,20,2,18
2014,Enlisted,54487,5,0,5
2014,Enlisted,54495,30,4,26
2014,Enlisted,54501,6,0,6
2014,Enlisted,54612,19,3,16
2014,Enlisted,54615,16,0,16
2014,Enlisted,54618,28,4,24
2014,Enlisted,54650,27,4,23
2014,Enlisted,54656,22,2,20
2014,Enlisted,54660,18,2,16
2014,Enlisted,54665,12,0,12
2014,Enlisted,54703,25,0,25
2014,Enlisted,54729,21,0,21
2014,Enlisted,54751,34,3,31
2014,Enlisted,54801,4,0,4
2014,Enlisted,54806,5,0,5
2014,Enlisted,54843,17,0,17
2014,Enlisted,54868,8,1,7
2014,Enlisted,54880,13,0,13
2014,Enlisted,54901,46,3,43
2014,Enlisted,54902,2,0,2
2014,Enlisted,54914,36,7,29
2014,Enlisted,54929,12,1,11
2014,Enlisted,54935,26,4,22
2014,Enlisted,54971,15,1,14
2014,Enlisted,54981,11,1,10
2014,Enlisted,55008,31,3,28
2014,Enlisted,55016,37,8,29
2014,Enlisted,55021,14,4,10
2014,Enlisted,55033,24,3,21
2014,Enlisted,55057,11,2,9
2014,Enlisted,55060,5,0,5
2014,Enlisted,55063,18,3,15
2014,Enlisted,55066,12,2,10
2014,Enlisted,55068,46,11,35
2014,Enlisted,55077,21,1,20
2014,Enlisted,55082,35,6,29
2014,Enlisted,55101,28,4,24
2014,Enlisted,55106,52,5,47
2014,Enlisted,55107,50,5,45
2014,Enlisted,55112,90,4,86
2014,Enlisted,55113,21,7,14
2014,Enlisted,55118,36,5,31
2014,Enlisted,55303,43,2,41
2014,Enlisted,55350,24,4,20
2014,Enlisted,55355,33,5,28
2014,Enlisted,55362,63,3,60
2014,Enlisted,55413,11,3,8
2014,Enlisted,55431,77,10,67
2014,Enlisted,55443,37,8,29
2014,Enlisted,55719,6,2,4
2014,Enlisted,55720,11,3,8
2014,Enlisted,55744,10,1,9
2014,Enlisted,55746,16,1,15
2014,Enlisted,55811,57,4,53
2014,Enlisted,55904,40,5,35
2014,Enlisted,55912,15,4,11
2014,Enlisted,55987,32,1,31
2014,Enlisted,56001,33,5,28
2014,Enlisted,56007,22,4,18
2014,Enlisted,56031,17,1,16
2014,Enlisted,56073,14,1,13
2014,Enlisted,56081,15,4,11
2014,Enlisted,56082,14,3,11
2014,Enlisted,56143,15,3,12
2014,Enlisted,56156,12,2,10
2014,Enlisted,56164,10,0,10
2014,Enlisted,56201,44,6,38
2014,Enlisted,56208,16,0,16
2014,Enlisted,56256,15,3,12
2014,Enlisted,56258,20,0,20
2014,Enlisted,56265,9,1,8
2014,Enlisted,56267,10,0,10
2014,Enlisted,56277,8,1,7
2014,Enlisted,56278,9,3,6
2014,Enlisted,56283,11,2,9
2014,Enlisted,56303,114,10,104
2014,Enlisted,56308,22,5,17
2014,Enlisted,56345,162,16,146
2014,Enlisted,56347,18,1,17
2014,Enlisted,56378,17,2,15
2014,Enlisted,56401,25,4,21
2014,Enlisted,56482,12,0,12
2014,Enlisted,56501,14,2,12
2014,Enlisted,56537,16,1,15
2014,Enlisted,56560,37,3,34
2014,Enlisted,56601,26,5,21
2014,Enlisted,56701,16,1,15
2014,Enlisted,56716,28,2,26
2014,Enlisted,57006,9,1,8
2014,Enlisted,57042,8,1,7
2014,Enlisted,57069,9,1,8
2014,Enlisted,57078,4,1,3
2014,Enlisted,57104,52,4,48
2014,Enlisted,57201,39,6,33
2014,Enlisted,57231,5,0,5
2014,Enlisted,57252,1,0,1
2014,Enlisted,57301,3,0,3
2014,Enlisted,57325,1,1,0
2014,Enlisted,57350,9,1,8
2014,Enlisted,57366,1,0,1
2014,Enlisted,57380,10,0,10
2014,Enlisted,57401,20,4,16
2014,Enlisted,57501,17,3,14
2014,Enlisted,57601,15,0,15
2014,Enlisted,57702,25,8,17
2014,Enlisted,57703,10,2,8
2014,Enlisted,57717,28,1,27
2014,Enlisted,57783,6,1,5
2014,Enlisted,57785,2,0,2
2014,Enlisted,58054,4,0,4
2014,Enlisted,58072,12,5,7
2014,Enlisted,58075,11,0,11
2014,Enlisted,58102,53,22,31
2014,Enlisted,58201,44,20,24
2014,Enlisted,58220,1,0,1
2014,Enlisted,58237,2,2,0
2014,Enlisted,58257,18,8,10
2014,Enlisted,58301,16,3,13
2014,Enlisted,58318,2,1,1
2014,Enlisted,58324,2,1,1
2014,Enlisted,58368,4,0,4
2014,Enlisted,58402,13,2,11
2014,Enlisted,58421,9,0,9
2014,Enlisted,58433,4,0,4
2014,Enlisted,58474,4,0,4
2014,Enlisted,58495,3,1,2
2014,Enlisted,58506,66,17,49
2014,Enlisted,58545,1,0,1
2014,Enlisted,58601,3,3,0
2014,Enlisted,58702,17,4,13
2014,Enlisted,58802,10,4,6
2014,Enlisted,59047,4,1,3
2014,Enlisted,59102,52,12,40
2014,Enlisted,59218,4,1,3
2014,Enlisted,59230,8,1,7
2014,Enlisted,59270,1,1,0
2014,Enlisted,59301,14,3,11
2014,Enlisted,59405,8,0,8
2014,Enlisted,59457,9,2,7
2014,Enlisted,59501,4,0,4
2014,Enlisted,59538,20,1,19
2014,Enlisted,59601,6,0,6
2014,Enlisted,59602,24,3,21
2014,Enlisted,59604,15,5,10
2014,Enlisted,59636,38,9,29
2014,Enlisted,59701,18,2,16
2014,Enlisted,59711,4,0,4
2014,Enlisted,59714,37,3,34
2014,Enlisted,59725,8,0,8
2014,Enlisted,59808,46,11,35
2014,Enlisted,59840,15,2,13
2014,Enlisted,59901,19,4,15
2014,Enlisted,59923,2,1,1
2014,Enlisted,60037,47,5,42
2014,Enlisted,60098,36,10,26
2014,Enlisted,60120,38,6,32
2014,Enlisted,60178,10,6,4
2014,Enlisted,60435,42,7,35
2014,Enlisted,60472,100,15,85
2014,Enlisted,60505,18,4,14
2014,Enlisted,60546,125,20,105
2014,Enlisted,60615,42,11,31
2014,Enlisted,60616,35,10,25
2014,Enlisted,60638,36,7,29
2014,Enlisted,60651,15,0,15
2014,Enlisted,60901,24,8,16
2014,Enlisted,61021,23,9,14
2014,Enlisted,61032,27,2,25
2014,Enlisted,61071,16,1,15
2014,Enlisted,61115,53,5,48
2014,Enlisted,61264,59,9,50
2014,Enlisted,61341,14,4,10
2014,Enlisted,61364,14,3,11
2014,Enlisted,61401,35,2,33
2014,Enlisted,61434,9,1,8
2014,Enlisted,61443,18,4,14
2014,Enlisted,61455,27,4,23
2014,Enlisted,61607,96,16,80
2014,Enlisted,61701,20,6,14
2014,Enlisted,61734,3,1,2
2014,Enlisted,61764,27,5,22
2014,Enlisted,61801,17,5,12
2014,Enlisted,61820,16,2,14
2014,Enlisted,61834,8,0,8
2014,Enlisted,61938,29,1,28
2014,Enlisted,61944,15,3,12
2014,Enlisted,61951,12,1,11
2014,Enlisted,62056,30,9,21
2014,Enlisted,62205,17,5,12
2014,Enlisted,62269,16,5,11
2014,Enlisted,62286,38,4,34
2014,Enlisted,62301,1,0,1
2014,Enlisted,62305,9,0,9
2014,Enlisted,62401,31,2,29
2014,Enlisted,62439,12,2,10
2014,Enlisted,62521,54,10,44
2014,Enlisted,62618,7,1,6
2014,Enlisted,62702,116,20,96
2014,Enlisted,62864,45,5,40
2014,Enlisted,62896,31,10,21
2014,Enlisted,62959,32,11,21
2014,Enlisted,62966,16,4,12
2014,Enlisted,63020,12,4,8
2014,Enlisted,63028,34,3,31
2014,Enlisted,63044,29,4,25
2014,Enlisted,63077,37,6,31
2014,Enlisted,63109,86,21,65
2014,Enlisted,63125,91,14,77
2014,Enlisted,63383,29,4,25
2014,Enlisted,63401,19,2,17
2014,Enlisted,63552,23,4,19
2014,Enlisted,63640,18,5,13
2014,Enlisted,63645,8,2,6
2014,Enlisted,63703,40,2,38
2014,Enlisted,63755,18,4,14
2014,Enlisted,63775,25,7,18
2014,Enlisted,63801,8,1,7
2014,Enlisted,63841,11,1,10
2014,Enlisted,63857,16,2,14
2014,Enlisted,63873,9,1,8
2014,Enlisted,63901,11,3,8
2014,Enlisted,63935,17,4,13
2014,Enlisted,64052,13,7,6
2014,Enlisted,64067,25,2,23
2014,Enlisted,64085,21,1,20
2014,Enlisted,64093,17,2,15
2014,Enlisted,64129,119,24,95
2014,Enlisted,64402,5,1,4
2014,Enlisted,64468,13,4,9
2014,Enlisted,64506,22,3,19
2014,Enlisted,64601,9,1,8
2014,Enlisted,64683,29,5,24
2014,Enlisted,64701,38,1,37
2014,Enlisted,64735,4,1,3
2014,Enlisted,64759,10,3,7
2014,Enlisted,64772,7,0,7
2014,Enlisted,64804,27,2,25
2014,Enlisted,64831,15,2,13
2014,Enlisted,64836,9,1,8
2014,Enlisted,64850,3,1,2
2014,Enlisted,65101,31,8,23
2014,Enlisted,65109,51,10,41
2014,Enlisted,65202,14,2,12
2014,Enlisted,65233,35,4,31
2014,Enlisted,65251,8,1,7
2014,Enlisted,65265,14,3,11
2014,Enlisted,65270,12,0,12
2014,Enlisted,65301,22,4,18
2014,Enlisted,65305,33,8,25
2014,Enlisted,65340,29,2,27
2014,Enlisted,65401,18,1,17
2014,Enlisted,65473,38,15,23
2014,Enlisted,65536,2,0,2
2014,Enlisted,65605,25,3,22
2014,Enlisted,65708,21,6,15
2014,Enlisted,65723,11,3,8
2014,Enlisted,65775,11,1,10
2014,Enlisted,65802,76,14,62
2014,Enlisted,65803,54,12,42
2014,Enlisted,66027,16,4,12
2014,Enlisted,66044,26,9,17
2014,Enlisted,66061,26,4,22
2014,Enlisted,66067,7,1,6
2014,Enlisted,66071,4,3,1
2014,Enlisted,66102,41,11,30
2014,Enlisted,66219,6,1,5
2014,Enlisted,66220,8,1,7
2014,Enlisted,66434,8,1,7
2014,Enlisted,66436,6,2,4
2014,Enlisted,66441,12,7,5
2014,Enlisted,66502,3,1,2
2014,Enlisted,66503,23,8,15
2014,Enlisted,66508,4,1,3
2014,Enlisted,66611,6,3,3
2014,Enlisted,66619,70,15,55
2014,Enlisted,66749,22,2,20
2014,Enlisted,66762,30,4,26
2014,Enlisted,66801,6,3,3
2014,Enlisted,66901,6,1,5
2014,Enlisted,66967,3,0,3
2014,Enlisted,67010,17,3,14
2014,Enlisted,67114,10,4,6
2014,Enlisted,67124,9,4,5
2014,Enlisted,67208,1,0,1
2014,Enlisted,67213,11,2,9
2014,Enlisted,67217,36,10,26
2014,Enlisted,67219,37,12,25
2014,Enlisted,67337,11,1,10
2014,Enlisted,67401,10,6,4
2014,Enlisted,67410,11,3,8
2014,Enlisted,67432,2,1,1
2014,Enlisted,67501,10,1,9
2014,Enlisted,67530,8,0,8
2014,Enlisted,67601,1,0,1
2014,Enlisted,67654,6,1,5
2014,Enlisted,67701,5,1,4
2014,Enlisted,67801,4,1,3
2014,Enlisted,67901,3,1,2
2014,Enlisted,68025,11,2,9
2014,Enlisted,68041,21,1,20
2014,Enlisted,68066,14,3,11
2014,Enlisted,68106,18,2,16
2014,Enlisted,68142,20,3,17
2014,Enlisted,68310,19,2,17
2014,Enlisted,68410,10,4,6
2014,Enlisted,68434,9,1,8
2014,Enlisted,68467,8,1,7
2014,Enlisted,68503,15,1,14
2014,Enlisted,68508,17,4,13
2014,Enlisted,68524,69,14,55
2014,Enlisted,68602,14,2,12
2014,Enlisted,68701,12,3,9
2014,Enlisted,68763,3,0,3
2014,Enlisted,68801,6,1,5
2014,Enlisted,68803,18,3,15
2014,Enlisted,68822,2,0,2
2014,Enlisted,68847,16,2,14
2014,Enlisted,68901,40,8,32
2014,Enlisted,69001,2,1,1
2014,Enlisted,69101,4,0,4
2014,Enlisted,69162,11,2,9
2014,Enlisted,69337,5,0,5
2014,Enlisted,69361,5,0,5
2014,Enlisted,70072,22,3,19
2014,Enlisted,70084,7,1,6
2014,Enlisted,70117,101,28,73
2014,Enlisted,70364,40,0,40
2014,Enlisted,70390,27,2,25
2014,Enlisted,70401,60,7,53
2014,Enlisted,70403,24,2,22
2014,Enlisted,70427,11,3,8
2014,Enlisted,70433,24,6,18
2014,Enlisted,70438,10,1,9
2014,Enlisted,70460,15,1,14
2014,Enlisted,70508,58,9,49
2014,Enlisted,70510,19,4,15
2014,Enlisted,70517,12,0,12
2014,Enlisted,70526,19,2,17
2014,Enlisted,70544,22,1,21
2014,Enlisted,70563,13,2,11
2014,Enlisted,70570,10,1,9
2014,Enlisted,70582,11,0,11
2014,Enlisted,70586,3,1,2
2014,Enlisted,70601,31,5,26
2014,Enlisted,70605,9,0,9
2014,Enlisted,70633,3,2,1
2014,Enlisted,70634,5,3,2
2014,Enlisted,70714,18,5,13
2014,Enlisted,70721,70,9,61
2014,Enlisted,70737,28,5,23
2014,Enlisted,70760,10,2,8
2014,Enlisted,70764,19,4,15
2014,Enlisted,70820,76,6,70
2014,Enlisted,71019,13,1,12
2014,Enlisted,71023,21,3,18
2014,Enlisted,71055,31,2,29
2014,Enlisted,71101,46,10,36
2014,Enlisted,71111,18,0,18
2014,Enlisted,71203,38,5,33
2014,Enlisted,71220,7,0,7
2014,Enlisted,71232,7,0,7
2014,Enlisted,71241,4,3,1
2014,Enlisted,71251,6,0,6
2014,Enlisted,71263,8,1,7
2014,Enlisted,71270,47,2,45
2014,Enlisted,71292,20,2,18
2014,Enlisted,71295,4,1,3
2014,Enlisted,71303,13,3,10
2014,Enlisted,71322,11,2,9
2014,Enlisted,71342,6,3,3
2014,Enlisted,71351,13,2,11
2014,Enlisted,71360,98,22,76
2014,Enlisted,71373,4,0,4
2014,Enlisted,71405,1,0,1
2014,Enlisted,71415,12,1,11
2014,Enlisted,71417,23,5,18
2014,Enlisted,71457,28,3,25
2014,Enlisted,71459,11,2,9
2014,Enlisted,71602,29,4,25
2014,Enlisted,71635,11,1,10
2014,Enlisted,71655,15,0,15
2014,Enlisted,71671,13,1,12
2014,Enlisted,71701,18,5,13
2014,Enlisted,71730,4,0,4
2014,Enlisted,71753,21,2,19
2014,Enlisted,71801,4,1,3
2014,Enlisted,71823,4,1,3
2014,Enlisted,71854,16,3,13
2014,Enlisted,71857,16,3,13
2014,Enlisted,71913,16,2,14
2014,Enlisted,71923,5,0,5
2014,Enlisted,71953,10,2,8
2014,Enlisted,72007,7,1,6
2014,Enlisted,72015,10,0,10
2014,Enlisted,72021,10,1,9
2014,Enlisted,72023,13,1,12
2014,Enlisted,72032,1,1,0
2014,Enlisted,72034,20,3,17
2014,Enlisted,72064,12,1,11
2014,Enlisted,72086,14,3,11
2014,Enlisted,72104,20,2,18
2014,Enlisted,72110,5,2,3
2014,Enlisted,72112,17,0,17
2014,Enlisted,72114,46,5,41
2014,Enlisted,72119,1,1,0
2014,Enlisted,72143,9,1,8
2014,Enlisted,72150,14,0,14
2014,Enlisted,72160,7,1,6
2014,Enlisted,72199,175,40,135
2014,Enlisted,72205,20,7,13
2014,Enlisted,72301,22,0,22
2014,Enlisted,72315,12,1,11
2014,Enlisted,72335,18,1,17
2014,Enlisted,72390,1,0,1
2014,Enlisted,72396,9,4,5
2014,Enlisted,72401,45,7,38
2014,Enlisted,72432,5,1,4
2014,Enlisted,72450,21,2,19
2014,Enlisted,72461,6,0,6
2014,Enlisted,72476,19,2,17
2014,Enlisted,72501,14,2,12
2014,Enlisted,72543,10,0,10
2014,Enlisted,72601,11,1,10
2014,Enlisted,72616,3,0,3
2014,Enlisted,72650,5,0,5
2014,Enlisted,72653,7,1,6
2014,Enlisted,72701,11,3,8
2014,Enlisted,72712,41,12,29
2014,Enlisted,72744,10,2,8
2014,Enlisted,72756,19,1,18
2014,Enlisted,72761,9,2,7
2014,Enlisted,72801,5,0,5
2014,Enlisted,72802,5,2,3
2014,Enlisted,72830,19,3,16
2014,Enlisted,72834,5,0,5
2014,Enlisted,72855,24,2,22
2014,Enlisted,72905,19,8,11
2014,Enlisted,72923,37,7,30
2014,Enlisted,72927,17,2,15
2014,Enlisted,72949,2,1,1
2014,Enlisted,73034,54,9,45
2014,Enlisted,73036,25,2,23
2014,Enlisted,73051,27,5,22
2014,Enlisted,73064,75,10,65
2014,Enlisted,73069,158,36,122
2014,Enlisted,73111,10,7,3
2014,Enlisted,73141,14,2,12
2014,Enlisted,73179,4,2,2
2014,Enlisted,73401,3,1,2
2014,Enlisted,73503,57,14,43
2014,Enlisted,73521,9,1,8
2014,Enlisted,73542,3,0,3
2014,Enlisted,73705,32,2,30
2014,Enlisted,74003,13,4,9
2014,Enlisted,74012,37,9,28
2014,Enlisted,74014,95,14,81
2014,Enlisted,74017,18,2,16
2014,Enlisted,74075,37,5,32
2014,Enlisted,74107,48,3,45
2014,Enlisted,74116,29,4,25
2014,Enlisted,74301,25,3,22
2014,Enlisted,74403,30,9,21
2014,Enlisted,74423,15,5,10
2014,Enlisted,74447,13,2,11
2014,Enlisted,74501,23,3,20
2014,Enlisted,74601,15,2,13
2014,Enlisted,74701,26,2,24
2014,Enlisted,74804,15,3,12
2014,Enlisted,74820,43,10,33
2014,Enlisted,74834,34,8,26
2014,Enlisted,74848,9,1,8
2014,Enlisted,74953,23,0,23
2014,Enlisted,75020,14,5,9
2014,Enlisted,75051,158,75,83
2014,Enlisted,75077,56,12,44
2014,Enlisted,75098,23,8,15
2014,Enlisted,75110,23,11,12
2014,Enlisted,75159,53,31,22
2014,Enlisted,75160,41,10,31
2014,Enlisted,75165,1,1,0
2014,Enlisted,75220,4,4,0
2014,Enlisted,75237,40,11,29
2014,Enlisted,75402,30,16,14
2014,Enlisted,75473,1,1,0
2014,Enlisted,75570,14,4,10
2014,Enlisted,75662,18,6,12
2014,Enlisted,75672,9,4,5
2014,Enlisted,75709,13,6,7
2014,Enlisted,75803,4,2,2
2014,Enlisted,75901,10,2,8
2014,Enlisted,76011,4,4,0
2014,Enlisted,76086,14,3,11
2014,Enlisted,76105,25,16,9
2014,Enlisted,76108,49,18,31
2014,Enlisted,76115,17,12,5
2014,Enlisted,76207,5,1,4
2014,Enlisted,76234,13,2,11
2014,Enlisted,76302,53,18,35
2014,Enlisted,76401,20,8,12
2014,Enlisted,76502,57,40,17
2014,Enlisted,76528,31,19,12
2014,Enlisted,76542,48,31,17
2014,Enlisted,76574,23,13,10
2014,Enlisted,76707,80,42,38
2014,Enlisted,76801,25,7,18
2014,Enlisted,76905,8,3,5
2014,Enlisted,77034,154,58,96
2014,Enlisted,77067,67,27,40
2014,Enlisted,77082,119,41,78
2014,Enlisted,77340,21,13,8
2014,Enlisted,77437,13,3,10
2014,Enlisted,77471,11,7,4
2014,Enlisted,77515,29,7,22
2014,Enlisted,77568,18,7,11
2014,Enlisted,77802,32,17,15
2014,Enlisted,77833,8,2,6
2014,Enlisted,77904,13,5,8
2014,Enlisted,78041,38,14,24
2014,Enlisted,78130,23,8,15
2014,Enlisted,78155,9,8,1
2014,Enlisted,78218,63,30,33
2014,Enlisted,78219,104,31,73
2014,Enlisted,78257,176,75,101
2014,Enlisted,78363,20,3,17
2014,Enlisted,78416,13,3,10
2014,Enlisted,78520,27,7,20
2014,Enlisted,78596,89,27,62
2014,Enlisted,78602,28,15,13
2014,Enlisted,78617,97,39,58
2014,Enlisted,78624,20,14,6
2014,Enlisted,78665,43,20,23
2014,Enlisted,78666,84,44,40
2014,Enlisted,78703,273,103,170
2014,Enlisted,78719,12,6,6
2014,Enlisted,78731,13,7,6
2014,Enlisted,78746,2,2,0
2014,Enlisted,78861,22,6,16
2014,Enlisted,79107,34,13,21
2014,Enlisted,79403,64,29,35
2014,Enlisted,79607,41,9,32
2014,Enlisted,79706,34,16,18
2014,Enlisted,79924,39,4,35
2014,Enlisted,79936,139,50,89
2014,Enlisted,80011,101,39,62
2014,Enlisted,80012,25,9,16
2014,Enlisted,80112,5,4,1
2014,Enlisted,80137,22,13,9
2014,Enlisted,80216,49,19,30
2014,Enlisted,80304,20,12,8
2014,Enlisted,80501,10,0,10
2014,Enlisted,80504,13,2,11
2014,Enlisted,80521,1,0,1
2014,Enlisted,80550,13,6,7
2014,Enlisted,80621,28,17,11
2014,Enlisted,80751,4,3,1
2014,Enlisted,80907,18,4,14
2014,Enlisted,80913,95,50,45
2014,Enlisted,80916,16,11,5
2014,Enlisted,81004,6,4,2
2014,Enlisted,81050,3,2,1
2014,Enlisted,81101,7,2,5
2014,Enlisted,81212,2,0,2
2014,Enlisted,81303,6,2,4
2014,Enlisted,81401,17,3,14
2014,Enlisted,81501,30,14,16
2014,Enlisted,82009,36,17,19
2014,Enlisted,82072,17,3,14
2014,Enlisted,82201,1,1,0
2014,Enlisted,82214,10,9,1
2014,Enlisted,82240,8,1,7
2014,Enlisted,82431,9,2,7
2014,Enlisted,82435,7,0,7
2014,Enlisted,82520,7,3,4
2014,Enlisted,82604,5,3,2
2014,Enlisted,82633,10,3,7
2014,Enlisted,82716,5,1,4
2014,Enlisted,82801,10,3,7
2014,Enlisted,82901,13,3,10
2014,Enlisted,82931,7,2,5
2014,Enlisted,83110,7,2,5
2014,Enlisted,83202,13,6,7
2014,Enlisted,83221,10,4,6
2014,Enlisted,83263,3,2,1
2014,Enlisted,83301,15,6,9
2014,Enlisted,83318,9,1,8
2014,Enlisted,83330,21,5,16
2014,Enlisted,83333,1,0,1
2014,Enlisted,83338,9,3,6
2014,Enlisted,83402,14,10,4
2014,Enlisted,83440,7,0,7
2014,Enlisted,83442,6,3,3
2014,Enlisted,83445,6,2,4
2014,Enlisted,83501,11,4,7
2014,Enlisted,83530,6,1,5
2014,Enlisted,83544,2,0,2
2014,Enlisted,83605,14,5,9
2014,Enlisted,83617,8,2,6
2014,Enlisted,83647,19,4,15
2014,Enlisted,83661,3,0,3
2014,Enlisted,83676,6,2,4
2014,Enlisted,83687,17,1,16
2014,Enlisted,83705,101,37,64
2014,Enlisted,83716,1,1,0
2014,Enlisted,83805,3,2,1
2014,Enlisted,83843,2,0,2
2014,Enlisted,83854,23,7,16
2014,Enlisted,83864,1,0,1
2014,Enlisted,84003,30,7,23
2014,Enlisted,84020,80,32,48
2014,Enlisted,84043,24,6,18
2014,Enlisted,84058,22,6,16
2014,Enlisted,84065,114,45,69
2014,Enlisted,84074,11,2,9
2014,Enlisted,84078,1,0,1
2014,Enlisted,84084,86,18,68
2014,Enlisted,84116,27,1,26
2014,Enlisted,84302,6,1,5
2014,Enlisted,84321,15,5,10
2014,Enlisted,84323,6,2,4
2014,Enlisted,84404,12,3,9
2014,Enlisted,84405,33,6,27
2014,Enlisted,84501,17,3,14
2014,Enlisted,84511,4,2,2
2014,Enlisted,84631,2,0,2
2014,Enlisted,84642,2,0,2
2014,Enlisted,84647,3,1,2
2014,Enlisted,84660,43,10,33
2014,Enlisted,84663,14,4,10
2014,Enlisted,84701,9,2,7
2014,Enlisted,84713,3,0,3
2014,Enlisted,84720,11,2,9
2014,Enlisted,84790,44,7,37
2014,Enlisted,85008,200,48,152
2014,Enlisted,85020,15,6,9
2014,Enlisted,85122,38,10,28
2014,Enlisted,85128,3,1,2
2014,Enlisted,85132,56,12,44
2014,Enlisted,85201,33,13,20
2014,Enlisted,85281,7,3,4
2014,Enlisted,85286,21,4,17
2014,Enlisted,85301,6,3,3
2014,Enlisted,85312,3,1,2
2014,Enlisted,85364,8,4,4
2014,Enlisted,85396,5,4,1
2014,Enlisted,85546,1,0,1
2014,Enlisted,85607,6,2,4
2014,Enlisted,85653,80,18,62
2014,Enlisted,85706,49,16,33
2014,Enlisted,85713,39,17,22
2014,Enlisted,85901,3,3,0
2014,Enlisted,86015,54,8,46
2014,Enlisted,86301,63,32,31
2014,Enlisted,87002,2,1,1
2014,Enlisted,87123,59,15,44
2014,Enlisted,87144,51,15,36
2014,Enlisted,87305,5,3,2
2014,Enlisted,87401,32,5,27
2014,Enlisted,87508,23,5,18
2014,Enlisted,87532,11,2,9
2014,Enlisted,87557,1,0,1
2014,Enlisted,87701,5,1,4
2014,Enlisted,87740,2,0,2
2014,Enlisted,87747,3,2,1
2014,Enlisted,88007,86,26,60
2014,Enlisted,88026,6,3,3
2014,Enlisted,88101,24,2,22
2014,Enlisted,88203,29,5,24
2014,Enlisted,88240,1,1,0
2014,Enlisted,88310,4,1,3
2014,Enlisted,88401,2,1,1
2014,Enlisted,88415,2,0,2
2014,Enlisted,88435,1,0,1
2014,Enlisted,89002,21,3,18
2014,Enlisted,89032,8,4,4
2014,Enlisted,89115,134,18,116
2014,Enlisted,89139,53,18,35
2014,Enlisted,89165,101,17,84
2014,Enlisted,89301,8,3,5
2014,Enlisted,89406,11,4,7
2014,Enlisted,89445,5,2,3
2014,Enlisted,89447,21,4,17
2014,Enlisted,89506,102,22,80
2014,Enlisted,89509,3,1,2
2014,Enlisted,89701,15,10,5
2014,Enlisted,89801,5,2,3
2014,Enlisted,90025,15,7,8
2014,Enlisted,90201,85,27,58
2014,Enlisted,90249,4,2,2
2014,Enlisted,90266,4,0,4
2014,Enlisted,90302,65,22,43
2014,Enlisted,90501,34,10,24
2014,Enlisted,90640,13,3,10
2014,Enlisted,90720,135,60,75
2014,Enlisted,90731,32,13,19
2014,Enlisted,90813,8,4,4
2014,Enlisted,90822,39,13,26
2014,Enlisted,91205,33,18,15
2014,Enlisted,91406,37,5,32
2014,Enlisted,91505,28,6,22
2014,Enlisted,91702,73,25,48
2014,Enlisted,91764,43,17,26
2014,Enlisted,91766,9,3,6
2014,Enlisted,91950,23,12,11
2014,Enlisted,92020,26,18,8
2014,Enlisted,92025,19,8,11
2014,Enlisted,92111,56,27,29
2014,Enlisted,92220,19,10,9
2014,Enlisted,92227,1,0,1
2014,Enlisted,92243,38,9,29
2014,Enlisted,92307,4,3,1
2014,Enlisted,92311,8,3,5
2014,Enlisted,92324,14,6,8
2014,Enlisted,92410,20,14,6
2014,Enlisted,92501,24,12,12
2014,Enlisted,92518,54,23,31
2014,Enlisted,92707,19,8,11
2014,Enlisted,92833,26,16,10
2014,Enlisted,92866,29,11,18
2014,Enlisted,92879,19,15,4
2014,Enlisted,93003,2,0,2
2014,Enlisted,93030,5,2,3
2014,Enlisted,93103,7,2,5
2014,Enlisted,93257,9,4,5
2014,Enlisted,93291,24,13,11
2014,Enlisted,93307,55,18,37
2014,Enlisted,93405,20,10,10
2014,Enlisted,93422,3,0,3
2014,Enlisted,93451,24,11,13
2014,Enlisted,93454,11,3,8
2014,Enlisted,93536,24,5,19
2014,Enlisted,93550,12,2,10
2014,Enlisted,93638,7,1,6
2014,Enlisted,93702,14,1,13
2014,Enlisted,93727,70,24,46
2014,Enlisted,93955,8,5,3
2014,Enlisted,94035,7,2,5
2014,Enlisted,94043,16,6,10
2014,Enlisted,94066,9,8,1
2014,Enlisted,94132,10,5,5
2014,Enlisted,94401,26,8,18
2014,Enlisted,94510,7,2,5
2014,Enlisted,94519,3,2,1
2014,Enlisted,94533,7,2,5
2014,Enlisted,94565,17,4,13
2014,Enlisted,94568,37,21,16
2014,Enlisted,94590,28,15,13
2014,Enlisted,94596,10,1,9
2014,Enlisted,94804,21,4,17
2014,Enlisted,94903,7,4,3
2014,Enlisted,94952,13,7,6
2014,Enlisted,95020,3,1,2
2014,Enlisted,95110,12,1,11
2014,Enlisted,95206,81,20,61
2014,Enlisted,95240,15,4,11
2014,Enlisted,95341,49,6,43
2014,Enlisted,95351,29,16,13
2014,Enlisted,95361,16,9,7
2014,Enlisted,95380,14,1,13
2014,Enlisted,95401,7,3,4
2014,Enlisted,95453,5,1,4
2014,Enlisted,95503,8,2,6
2014,Enlisted,95603,27,14,13
2014,Enlisted,95655,7,2,5
2014,Enlisted,95667,6,3,3
2014,Enlisted,95678,11,2,9
2014,Enlisted,95815,2,2,0
2014,Enlisted,95819,3,0,3
2014,Enlisted,95826,16,7,9
2014,Enlisted,95828,66,34,32
2014,Enlisted,95832,18,6,12
2014,Enlisted,95926,13,4,9
2014,Enlisted,95965,34,5,29
2014,Enlisted,95991,10,4,6
2014,Enlisted,96001,17,4,13
2014,Enlisted,96067,4,2,2
2014,Enlisted,96080,7,3,4
2014,Enlisted,96130,3,2,1
2014,Enlisted,96707,135,53,82
2014,Enlisted,96716,11,5,6
2014,Enlisted,96720,16,2,14
2014,Enlisted,96732,8,1,7
2014,Enlisted,96748,1,0,1
2014,Enlisted,96750,1,0,1
2014,Enlisted,96753,2,0,2
2014,Enlisted,96782,36,12,24
2014,Enlisted,96786,61,20,41
2014,Enlisted,96789,12,3,9
2014,Enlisted,96795,1,1,0
2014,Enlisted,96816,4,3,1
2014,Enlisted,96820,9,1,8
2014,Enlisted,96857,23,7,16
2014,Enlisted,96913,76,17,59
2014,Enlisted,97015,99,32,67
2014,Enlisted,97030,4,3,1
2014,Enlisted,97031,7,1,6
2014,Enlisted,97051,3,0,3
2014,Enlisted,97058,10,2,8
2014,Enlisted,97071,20,4,16
2014,Enlisted,97116,26,7,19
2014,Enlisted,97124,22,10,12
2014,Enlisted,97128,3,2,1
2014,Enlisted,97146,8,3,5
2014,Enlisted,97211,33,12,21
2014,Enlisted,97217,9,0,9
2014,Enlisted,97218,13,8,5
2014,Enlisted,97302,14,8,6
2014,Enlisted,97303,27,5,22
2014,Enlisted,97304,1,0,1
2014,Enlisted,97309,34,17,17
2014,Enlisted,97321,12,2,10
2014,Enlisted,97330,25,8,17
2014,Enlisted,97338,22,0,22
2014,Enlisted,97355,19,6,13
2014,Enlisted,97365,6,0,6
2014,Enlisted,97401,21,6,15
2014,Enlisted,97420,28,14,14
2014,Enlisted,97470,28,12,16
2014,Enlisted,97477,68,15,53
2014,Enlisted,97501,37,12,25
2014,Enlisted,97520,15,8,7
2014,Enlisted,97526,9,1,8
2014,Enlisted,97601,4,2,2
2014,Enlisted,97603,2,2,0
2014,Enlisted,97702,22,8,14
2014,Enlisted,97720,3,1,2
2014,Enlisted,97754,3,1,2
2014,Enlisted,97756,11,4,7
2014,Enlisted,97801,40,20,20
2014,Enlisted,97814,6,2,4
2014,Enlisted,97838,9,3,6
2014,Enlisted,97850,15,5,10
2014,Enlisted,97862,12,0,12
2014,Enlisted,97914,12,4,8
2014,Enlisted,98032,44,24,20
2014,Enlisted,98052,49,30,19
2014,Enlisted,98108,29,12,17
2014,Enlisted,98119,75,46,29
2014,Enlisted,98221,23,11,12
2014,Enlisted,98271,38,11,27
2014,Enlisted,98290,21,6,15
2014,Enlisted,98312,22,10,12
2014,Enlisted,98321,20,20,0
2014,Enlisted,98366,15,9,6
2014,Enlisted,98372,16,8,8
2014,Enlisted,98430,56,40,16
2014,Enlisted,98433,90,37,53
2014,Enlisted,98501,22,9,13
2014,Enlisted,98531,28,12,16
2014,Enlisted,98563,23,4,19
2014,Enlisted,98632,17,7,10
2014,Enlisted,98682,25,8,17
2014,Enlisted,98801,10,6,4
2014,Enlisted,98823,14,4,10
2014,Enlisted,98837,23,8,15
2014,Enlisted,98901,35,14,21
2014,Enlisted,98903,22,11,11
2014,Enlisted,98930,13,2,11
2014,Enlisted,99011,48,16,32
2014,Enlisted,99217,28,14,14
2014,Enlisted,99219,10,1,9
2014,Enlisted,99224,13,4,9
2014,Enlisted,99301,7,2,5
2014,Enlisted,99362,21,7,14
2014,Enlisted,99505,142,66,76
2014,Enlisted,99559,4,2,2
2014,Enlisted,99611,3,1,2
2014,Enlisted,99615,1,0,1
2014,Enlisted,99687,50,19,31
2014,Enlisted,99701,20,11,9
2014,Enlisted,99723,1,1,0
2014,Enlisted,99752,13,5,8
2014,Enlisted,99762,3,3,0
2014,Enlisted,99821,13,4,9
2014,Enlisted,99835,2,2,0
2014,Enlisted,99929,1,0,1
2014,Officer,00605,1,1,0
2014,Officer,00612,2,2,0
2014,Officer,00681,3,3,0
2014,Officer,00683,1,1,0
2014,Officer,00693,2,2,0
2014,Officer,00714,1,1,0
2014,Officer,00725,1,1,0
2014,Officer,00732,1,1,0
2014,Officer,00736,3,3,0
2014,Officer,00737,2,2,0
2014,Officer,00751,3,3,0
2014,Officer,00792,2,2,0
2014,Officer,00795,6,6,0
2014,Officer,00820,6,6,0
2014,Officer,00901,4,4,0
2014,Officer,00918,1,1,0
2014,Officer,00934,1,1,0
2014,Officer,00951,2,2,0
2014,Officer,00960,1,1,0
2014,Officer,01013,3,3,0
2014,Officer,01030,2,2,0
2014,Officer,01082,2,2,0
2014,Officer,01109,3,3,0
2014,Officer,01301,1,1,0
2014,Officer,01434,6,6,0
2014,Officer,01588,2,2,0
2014,Officer,01605,6,6,0
2014,Officer,01702,3,3,0
2014,Officer,01731,13,13,0
2014,Officer,01844,4,4,0
2014,Officer,01867,5,5,0
2014,Officer,01923,3,3,0
2014,Officer,02043,1,1,0
2014,Officer,02138,1,1,0
2014,Officer,02169,2,2,0
2014,Officer,02176,3,3,0
2014,Officer,02301,1,1,0
2014,Officer,02346,4,4,0
2014,Officer,02420,3,3,0
2014,Officer,02542,5,5,0
2014,Officer,02769,1,1,0
2014,Officer,02780,1,1,0
2014,Officer,02809,2,0,2
2014,Officer,02818,5,4,1
2014,Officer,02842,3,3,0
2014,Officer,02852,5,4,1
2014,Officer,02886,4,4,0
2014,Officer,03055,1,1,0
2014,Officer,03101,2,2,0
2014,Officer,03235,1,1,0
2014,Officer,03244,1,1,0
2014,Officer,03264,1,1,0
2014,Officer,03301,3,3,0
2014,Officer,03766,1,1,0
2014,Officer,03878,1,1,0
2014,Officer,04092,1,1,0
2014,Officer,04240,1,1,0
2014,Officer,04268,2,1,1
2014,Officer,04330,3,2,1
2014,Officer,04333,2,1,1
2014,Officer,04401,6,5,1
2014,Officer,04736,2,2,0
2014,Officer,04901,1,1,0
2014,Officer,04976,1,1,0
2014,Officer,05001,2,2,0
2014,Officer,05033,6,6,0
2014,Officer,05158,1,1,0
2014,Officer,05201,4,4,0
2014,Officer,05404,4,4,0
2014,Officer,05446,6,6,0
2014,Officer,05450,1,1,0
2014,Officer,05465,15,15,0
2014,Officer,05478,8,8,0
2014,Officer,05488,1,1,0
2014,Officer,05495,4,4,0
2014,Officer,05663,6,6,0
2014,Officer,05676,1,1,0
2014,Officer,05701,2,2,0
2014,Officer,05851,1,1,0
2014,Officer,05855,4,4,0
2014,Officer,06082,1,1,0
2014,Officer,06096,3,3,0
2014,Officer,06105,3,3,0
2014,Officer,06110,1,1,0
2014,Officer,06320,1,1,0
2014,Officer,06357,5,4,1
2014,Officer,06360,1,0,1
2014,Officer,06457,4,4,0
2014,Officer,06489,1,1,0
2014,Officer,06512,4,4,0
2014,Officer,06614,2,2,0
2014,Officer,06810,4,4,0
2014,Officer,07052,4,4,0
2014,Officer,07090,1,1,0
2014,Officer,07095,1,1,0
2014,Officer,07107,1,1,0
2014,Officer,07306,3,3,0
2014,Officer,07457,1,1,0
2014,Officer,07666,6,6,0
2014,Officer,07728,2,2,0
2014,Officer,07801,2,2,0
2014,Officer,07865,1,1,0
2014,Officer,07960,2,2,0
2014,Officer,08060,1,1,0
2014,Officer,08087,1,1,0
2014,Officer,08096,4,4,0
2014,Officer,08098,2,2,0
2014,Officer,08360,2,2,0
2014,Officer,08628,1,1,0
2014,Officer,08640,2,1,1
2014,Officer,08733,2,2,0
2014,Officer,08750,1,1,0
2014,Officer,08753,3,3,0
2014,Officer,08873,7,7,0
2014,Officer,10010,7,5,2
2014,Officer,10037,9,8,1
2014,Officer,10314,2,1,1
2014,Officer,10468,2,1,1
2014,Officer,10567,8,7,1
2014,Officer,10701,1,1,0
2014,Officer,11252,4,4,0
2014,Officer,11357,1,1,0
2014,Officer,11433,5,2,3
2014,Officer,11735,3,3,0
2014,Officer,11779,3,3,0
2014,Officer,12110,6,5,1
2014,Officer,12180,6,4,2
2014,Officer,12189,1,1,0
2014,Officer,12302,3,3,0
2014,Officer,12401,3,3,0
2014,Officer,12451,1,1,0
2014,Officer,12553,1,1,0
2014,Officer,12804,5,3,2
2014,Officer,13021,1,1,0
2014,Officer,13211,8,8,0
2014,Officer,13501,4,2,2
2014,Officer,13602,1,0,1
2014,Officer,13905,1,1,0
2014,Officer,14204,6,5,1
2014,Officer,14213,5,4,1
2014,Officer,14304,4,4,0
2014,Officer,14456,1,1,0
2014,Officer,14624,8,5,3
2014,Officer,14760,1,0,1
2014,Officer,14845,1,1,0
2014,Officer,15010,2,2,0
2014,Officer,15206,3,3,0
2014,Officer,15301,5,5,0
2014,Officer,15370,2,2,0
2014,Officer,15425,2,2,0
2014,Officer,15537,1,1,0
2014,Officer,15601,2,2,0
2014,Officer,15666,5,5,0
2014,Officer,15701,3,3,0
2014,Officer,15902,2,2,0
2014,Officer,15904,5,4,1
2014,Officer,16148,1,1,0
2014,Officer,16226,2,2,0
2014,Officer,16403,9,9,0
2014,Officer,16635,1,1,0
2014,Officer,16738,1,1,0
2014,Officer,16803,1,0,1
2014,Officer,16830,1,1,0
2014,Officer,16901,1,1,0
2014,Officer,17003,22,19,3
2014,Officer,17013,4,4,0
2014,Officer,17022,5,4,1
2014,Officer,17042,3,3,0
2014,Officer,17044,3,3,0
2014,Officer,17103,23,22,1
2014,Officer,17331,1,1,0
2014,Officer,17404,1,1,0
2014,Officer,17701,1,1,0
2014,Officer,17837,1,1,0
2014,Officer,18040,3,3,0
2014,Officer,18102,2,1,1
2014,Officer,18201,1,1,0
2014,Officer,18235,1,1,0
2014,Officer,18252,1,1,0
2014,Officer,18431,2,2,0
2014,Officer,18509,8,7,1
2014,Officer,18634,6,6,0
2014,Officer,18643,1,1,0
2014,Officer,18651,4,3,1
2014,Officer,18704,1,1,0
2014,Officer,18834,1,1,0
2014,Officer,19044,5,5,0
2014,Officer,19104,7,7,0
2014,Officer,19141,1,1,0
2014,Officer,19154,7,7,0
2014,Officer,19460,1,1,0
2014,Officer,19462,4,3,1
2014,Officer,19530,1,1,0
2014,Officer,19605,2,2,0
2014,Officer,19706,1,1,0
2014,Officer,19720,3,3,0
2014,Officer,19804,1,1,0
2014,Officer,19808,2,2,0
2014,Officer,19939,2,2,0
2014,Officer,19973,1,1,0
2014,Officer,19977,8,8,0
2014,Officer,20003,25,22,3
2014,Officer,20112,5,5,0
2014,Officer,20373,5,4,1
2014,Officer,20623,3,3,0
2014,Officer,20646,2,2,0
2014,Officer,20653,3,3,0
2014,Officer,20708,11,11,0
2014,Officer,20770,2,2,0
2014,Officer,20783,5,5,0
2014,Officer,20882,2,2,0
2014,Officer,20904,4,3,1
2014,Officer,21010,11,8,3
2014,Officer,21057,1,1,0
2014,Officer,21061,3,3,0
2014,Officer,21078,2,2,0
2014,Officer,21136,10,8,2
2014,Officer,21201,6,6,0
2014,Officer,21204,9,9,0
2014,Officer,21208,6,6,0
2014,Officer,21216,3,3,0
2014,Officer,21228,3,2,1
2014,Officer,21236,2,2,0
2014,Officer,21401,5,4,1
2014,Officer,21601,1,1,0
2014,Officer,21701,2,2,0
2014,Officer,21719,2,2,0
2014,Officer,21740,1,1,0
2014,Officer,21921,2,2,0
2014,Officer,22032,2,2,0
2014,Officer,22060,4,3,1
2014,Officer,22401,5,5,0
2014,Officer,22427,3,3,0
2014,Officer,22601,3,3,0
2014,Officer,22664,1,0,1
2014,Officer,22731,2,2,0
2014,Officer,22801,1,0,1
2014,Officer,22902,1,1,0
2014,Officer,23150,7,5,2
2014,Officer,23237,2,1,1
2014,Officer,23434,3,2,1
2014,Officer,23451,3,3,0
2014,Officer,23502,3,3,0
2014,Officer,23666,5,5,0
2014,Officer,23701,2,2,0
2014,Officer,23805,1,1,0
2014,Officer,23824,6,3,3
2014,Officer,24073,1,1,0
2014,Officer,24112,2,1,1
2014,Officer,24151,1,1,0
2014,Officer,24251,1,0,1
2014,Officer,24401,1,1,0
2014,Officer,24422,1,1,0
2014,Officer,24502,6,5,1
2014,Officer,24523,1,0,1
2014,Officer,24609,1,0,1
2014,Officer,24701,2,2,0
2014,Officer,24957,2,2,0
2014,Officer,25168,1,1,0
2014,Officer,25262,1,1,0
2014,Officer,25311,10,10,0
2014,Officer,25401,2,2,0
2014,Officer,25530,4,4,0
2014,Officer,25550,1,1,0
2014,Officer,25661,1,1,0
2014,Officer,25704,1,1,0
2014,Officer,25846,3,3,0
2014,Officer,26003,2,2,0
2014,Officer,26101,4,4,0
2014,Officer,26187,2,2,0
2014,Officer,26241,2,2,0
2014,Officer,26301,2,2,0
2014,Officer,26452,1,1,0
2014,Officer,26537,7,7,0
2014,Officer,26554,4,4,0
2014,Officer,26651,5,5,0
2014,Officer,26726,1,1,0
2014,Officer,27028,3,3,0
2014,Officer,27103,2,2,0
2014,Officer,27217,2,2,0
2014,Officer,27260,1,1,0
2014,Officer,27293,1,1,0
2014,Officer,27344,1,1,0
2014,Officer,27401,3,2,1
2014,Officer,27504,2,2,0
2014,Officer,27530,4,4,0
2014,Officer,27549,1,0,1
2014,Officer,27560,7,7,0
2014,Officer,27577,1,1,0
2014,Officer,27581,1,1,0
2014,Officer,27607,9,8,1
2014,Officer,27704,6,6,0
2014,Officer,27830,1,1,0
2014,Officer,27870,3,3,0
2014,Officer,27892,1,1,0
2014,Officer,27932,1,1,0
2014,Officer,28001,2,2,0
2014,Officer,28012,3,3,0
2014,Officer,28054,1,1,0
2014,Officer,28147,2,2,0
2014,Officer,28208,4,4,0
2014,Officer,28306,1,1,0
2014,Officer,28328,1,1,0
2014,Officer,28334,2,2,0
2014,Officer,28337,1,1,0
2014,Officer,28376,4,3,1
2014,Officer,28377,1,1,0
2014,Officer,28384,1,1,0
2014,Officer,28388,1,1,0
2014,Officer,28401,1,0,1
2014,Officer,28472,1,1,0
2014,Officer,28504,1,1,0
2014,Officer,28540,1,1,0
2014,Officer,28560,2,2,0
2014,Officer,28590,1,1,0
2014,Officer,28645,3,3,0
2014,Officer,28655,1,1,0
2014,Officer,28726,3,2,1
2014,Officer,28734,1,1,0
2014,Officer,29020,2,2,0
2014,Officer,29044,14,14,0
2014,Officer,29102,2,2,0
2014,Officer,29108,1,0,1
2014,Officer,29115,1,1,0
2014,Officer,29151,1,1,0
2014,Officer,29170,1,1,0
2014,Officer,29172,2,2,0
2014,Officer,29201,6,6,0
2014,Officer,29303,4,4,0
2014,Officer,29325,1,1,0
2014,Officer,29341,3,3,0
2014,Officer,29360,2,2,0
2014,Officer,29379,2,2,0
2014,Officer,29385,1,1,0
2014,Officer,29403,4,4,0
2014,Officer,29418,6,6,0
2014,Officer,29440,1,1,0
2014,Officer,29483,2,2,0
2014,Officer,29488,2,2,0
2014,Officer,29510,1,1,0
2014,Officer,29512,2,2,0
2014,Officer,29520,1,1,0
2014,Officer,29526,1,1,0
2014,Officer,29532,1,1,0
2014,Officer,29536,3,3,0
2014,Officer,29550,1,1,0
2014,Officer,29556,1,1,0
2014,Officer,29574,4,4,0
2014,Officer,29577,1,1,0
2014,Officer,29605,2,2,0
2014,Officer,29620,2,2,0
2014,Officer,29625,13,13,0
2014,Officer,29631,4,4,0
2014,Officer,29641,1,1,0
2014,Officer,29644,1,1,0
2014,Officer,29653,1,1,0
2014,Officer,29697,1,1,0
2014,Officer,29706,2,2,0
2014,Officer,29715,1,1,0
2014,Officer,29732,4,4,0
2014,Officer,29812,1,1,0
2014,Officer,29824,7,7,0
2014,Officer,29829,1,1,0
2014,Officer,29944,1,1,0
2014,Officer,30014,1,1,0
2014,Officer,30032,2,2,0
2014,Officer,30040,7,5,2
2014,Officer,30045,1,1,0
2014,Officer,30060,13,12,1
2014,Officer,30069,5,3,2
2014,Officer,30114,1,1,0
2014,Officer,30125,3,0,3
2014,Officer,30134,2,0,2
2014,Officer,30144,3,2,1
2014,Officer,30224,4,2,2
2014,Officer,30233,2,2,0
2014,Officer,30294,3,3,0
2014,Officer,30297,5,3,2
2014,Officer,30336,4,4,0
2014,Officer,30401,2,2,0
2014,Officer,30427,2,1,1
2014,Officer,30439,2,2,0
2014,Officer,30461,3,3,0
2014,Officer,30501,1,1,0
2014,Officer,30635,2,1,1
2014,Officer,30655,5,5,0
2014,Officer,30680,7,6,1
2014,Officer,30701,6,6,0
2014,Officer,30824,2,1,1
2014,Officer,30830,1,1,0
2014,Officer,30904,6,6,0
2014,Officer,31015,1,1,0
2014,Officer,31029,1,1,0
2014,Officer,31040,1,1,0
2014,Officer,31211,11,11,0
2014,Officer,31329,1,1,0
2014,Officer,31406,5,5,0
2014,Officer,31409,1,1,0
2014,Officer,31520,3,2,1
2014,Officer,31533,1,0,1
2014,Officer,31701,4,3,1
2014,Officer,31719,1,0,1
2014,Officer,31794,1,1,0
2014,Officer,31901,7,7,0
2014,Officer,32084,3,3,0
2014,Officer,32086,1,1,0
2014,Officer,32091,5,5,0
2014,Officer,32221,3,3,0
2014,Officer,32311,4,4,0
2014,Officer,32406,5,4,1
2014,Officer,32428,1,1,0
2014,Officer,32447,1,1,0
2014,Officer,32514,1,1,0
2014,Officer,32536,1,1,0
2014,Officer,32806,2,2,0
2014,Officer,32924,1,1,0
2014,Officer,32935,1,1,0
2014,Officer,33020,1,1,0
2014,Officer,33039,1,1,0
2014,Officer,33092,1,1,0
2014,Officer,33127,7,7,0
2014,Officer,33315,2,2,0
2014,Officer,33405,1,1,0
2014,Officer,33406,1,1,0
2014,Officer,33523,1,1,0
2014,Officer,33563,1,1,0
2014,Officer,33606,1,1,0
2014,Officer,33711,2,2,0
2014,Officer,33762,1,1,0
2014,Officer,33782,5,5,0
2014,Officer,33873,1,1,0
2014,Officer,34142,1,1,0
2014,Officer,34237,1,1,0
2014,Officer,34429,1,1,0
2014,Officer,34474,3,3,0
2014,Officer,34748,1,1,0
2014,Officer,34947,1,1,0
2014,Officer,35040,1,1,0
2014,Officer,35042,2,2,0
2014,Officer,35055,1,1,0
2014,Officer,35072,1,1,0
2014,Officer,35121,1,1,0
2014,Officer,35124,1,1,0
2014,Officer,35161,1,1,0
2014,Officer,35209,2,2,0
2014,Officer,35217,7,7,0
2014,Officer,35405,2,2,0
2014,Officer,35565,2,2,0
2014,Officer,35592,1,1,0
2014,Officer,35594,1,1,0
2014,Officer,35601,3,3,0
2014,Officer,35613,1,1,0
2014,Officer,35630,2,2,0
2014,Officer,35768,1,1,0
2014,Officer,35803,6,6,0
2014,Officer,35805,5,5,0
2014,Officer,35904,1,1,0
2014,Officer,35967,2,2,0
2014,Officer,36009,1,1,0
2014,Officer,36043,1,1,0
2014,Officer,36081,2,2,0
2014,Officer,36083,1,1,0
2014,Officer,36109,3,3,0
2014,Officer,36121,3,3,0
2014,Officer,36205,2,2,0
2014,Officer,36265,4,4,0
2014,Officer,36301,1,1,0
2014,Officer,36322,3,3,0
2014,Officer,36330,1,1,0
2014,Officer,36331,1,1,0
2014,Officer,36421,1,1,0
2014,Officer,36442,2,2,0
2014,Officer,36532,1,1,0
2014,Officer,36605,4,4,0
2014,Officer,36608,3,3,0
2014,Officer,36701,1,1,0
2014,Officer,36726,1,1,0
2014,Officer,36801,4,4,0
2014,Officer,36904,1,1,0
2014,Officer,37015,1,1,0
2014,Officer,37033,1,0,1
2014,Officer,37042,1,1,0
2014,Officer,37066,3,2,1
2014,Officer,37083,1,1,0
2014,Officer,37167,12,12,0
2014,Officer,37204,13,8,5
2014,Officer,37404,9,6,3
2014,Officer,37644,1,1,0
2014,Officer,37645,2,2,0
2014,Officer,37683,1,0,1
2014,Officer,37743,2,2,0
2014,Officer,37771,2,1,1
2014,Officer,37777,2,2,0
2014,Officer,37841,1,0,1
2014,Officer,37854,1,1,0
2014,Officer,37857,1,1,0
2014,Officer,37860,1,1,0
2014,Officer,37874,2,1,1
2014,Officer,37919,2,2,0
2014,Officer,37939,3,2,1
2014,Officer,38012,1,1,0
2014,Officer,38053,2,2,0
2014,Officer,38118,1,0,1
2014,Officer,38225,1,1,0
2014,Officer,38261,1,1,0
2014,Officer,38301,1,1,0
2014,Officer,38302,2,1,1
2014,Officer,38320,1,1,0
2014,Officer,38340,1,0,1
2014,Officer,38375,2,2,0
2014,Officer,38462,1,0,1
2014,Officer,38464,1,1,0
2014,Officer,38506,2,2,0
2014,Officer,38556,1,1,0
2014,Officer,38572,1,1,0
2014,Officer,38606,2,2,0
2014,Officer,38614,2,2,0
2014,Officer,38655,2,2,0
2014,Officer,38663,1,1,0
2014,Officer,38668,2,2,0
2014,Officer,38701,1,1,0
2014,Officer,38703,1,1,0
2014,Officer,38732,1,1,0
2014,Officer,38801,1,1,0
2014,Officer,38803,1,1,0
2014,Officer,38829,1,1,0
2014,Officer,38835,1,1,0
2014,Officer,38901,2,2,0
2014,Officer,38915,1,0,1
2014,Officer,38926,3,3,0
2014,Officer,39043,2,2,0
2014,Officer,39046,1,1,0
2014,Officer,39120,1,1,0
2014,Officer,39168,1,1,0
2014,Officer,39183,1,1,0
2014,Officer,39202,1,1,0
2014,Officer,39204,4,4,0
2014,Officer,39209,2,1,1
2014,Officer,39216,9,9,0
2014,Officer,39296,9,9,0
2014,Officer,39307,1,1,0
2014,Officer,39345,1,1,0
2014,Officer,39350,1,1,0
2014,Officer,39403,1,1,0
2014,Officer,39407,3,2,1
2014,Officer,39440,5,2,3
2014,Officer,39452,1,0,1
2014,Officer,39501,3,3,0
2014,Officer,39507,1,1,0
2014,Officer,39556,1,1,0
2014,Officer,39567,1,1,0
2014,Officer,39601,1,1,0
2014,Officer,39648,3,2,1
2014,Officer,39654,3,3,0
2014,Officer,39730,1,1,0
2014,Officer,39760,1,1,0
2014,Officer,39819,1,1,0
2014,Officer,40209,1,1,0
2014,Officer,40330,1,1,0
2014,Officer,40351,1,0,1
2014,Officer,40475,1,1,0
2014,Officer,40510,3,3,0
2014,Officer,40601,5,4,1
2014,Officer,40741,2,2,0
2014,Officer,40831,1,1,0
2014,Officer,40906,2,2,0
2014,Officer,40965,1,1,0
2014,Officer,41005,3,3,0
2014,Officer,41008,1,0,1
2014,Officer,41101,8,7,1
2014,Officer,41653,1,1,0
2014,Officer,42071,1,1,0
2014,Officer,42101,2,2,0
2014,Officer,42141,1,1,0
2014,Officer,42301,3,2,1
2014,Officer,42330,1,1,0
2014,Officer,42345,2,2,0
2014,Officer,42633,1,0,1
2014,Officer,43040,1,0,1
2014,Officer,43055,1,1,0
2014,Officer,43102,3,1,2
2014,Officer,43213,10,9,1
2014,Officer,43217,11,8,3
2014,Officer,43228,3,3,0
2014,Officer,43235,7,5,2
2014,Officer,43302,2,2,0
2014,Officer,43402,2,2,0
2014,Officer,43452,1,1,0
2014,Officer,43465,6,5,1
2014,Officer,43614,1,0,1
2014,Officer,43756,3,2,1
2014,Officer,43812,1,1,0
2014,Officer,44055,1,1,0
2014,Officer,44128,2,1,1
2014,Officer,44142,1,1,0
2014,Officer,44224,5,5,0
2014,Officer,44256,3,3,0
2014,Officer,44444,2,1,1
2014,Officer,44601,1,1,0
2014,Officer,44720,6,4,2
2014,Officer,44857,1,1,0
2014,Officer,44870,2,2,0
2014,Officer,44883,2,1,1
2014,Officer,45015,6,6,0
2014,Officer,45036,2,0,2
2014,Officer,45215,4,4,0
2014,Officer,45331,2,2,0
2014,Officer,45346,1,1,0
2014,Officer,45356,3,2,1
2014,Officer,45385,1,0,1
2014,Officer,45430,2,2,0
2014,Officer,45502,3,3,0
2014,Officer,45505,5,4,1
2014,Officer,45601,1,1,0
2014,Officer,45804,2,1,1
2014,Officer,46012,2,2,0
2014,Officer,46052,1,1,0
2014,Officer,46060,2,1,1
2014,Officer,46122,5,5,0
2014,Officer,46131,7,5,2
2014,Officer,46135,1,0,1
2014,Officer,46140,1,1,0
2014,Officer,46151,1,1,0
2014,Officer,46176,7,6,1
2014,Officer,46208,1,1,0
2014,Officer,46216,15,14,1
2014,Officer,46241,18,13,5
2014,Officer,46249,2,2,0
2014,Officer,46350,1,0,1
2014,Officer,46383,1,1,0
2014,Officer,46402,4,4,0
2014,Officer,46406,2,2,0
2014,Officer,46613,7,7,0
2014,Officer,46714,1,1,0
2014,Officer,46750,1,1,0
2014,Officer,46809,3,3,0
2014,Officer,46825,5,4,1
2014,Officer,46901,1,1,0
2014,Officer,46953,2,2,0
2014,Officer,47150,5,4,1
2014,Officer,47203,3,2,1
2014,Officer,47250,3,2,1
2014,Officer,47274,5,5,0
2014,Officer,47303,1,1,0
2014,Officer,47348,2,1,1
2014,Officer,47374,1,1,0
2014,Officer,47394,4,2,2
2014,Officer,47401,3,2,1
2014,Officer,47421,2,2,0
2014,Officer,47591,1,1,0
2014,Officer,47715,3,3,0
2014,Officer,47804,2,1,1
2014,Officer,47834,2,2,0
2014,Officer,47872,2,2,0
2014,Officer,47905,4,2,2
2014,Officer,47933,2,2,0
2014,Officer,47978,1,0,1
2014,Officer,48060,1,1,0
2014,Officer,48180,4,4,0
2014,Officer,48197,1,1,0
2014,Officer,48208,5,5,0
2014,Officer,48234,9,7,2
2014,Officer,48341,1,1,0
2014,Officer,48601,5,5,0
2014,Officer,48706,2,2,0
2014,Officer,48817,1,1,0
2014,Officer,48837,5,5,0
2014,Officer,48838,1,1,0
2014,Officer,48906,13,12,1
2014,Officer,49009,4,4,0
2014,Officer,49012,4,4,0
2014,Officer,49047,2,2,0
2014,Officer,49201,3,3,0
2014,Officer,49202,1,1,0
2014,Officer,49221,1,1,0
2014,Officer,49224,1,1,0
2014,Officer,49509,7,7,0
2014,Officer,49601,2,2,0
2014,Officer,49721,1,1,0
2014,Officer,49739,7,7,0
2014,Officer,49783,2,2,0
2014,Officer,49802,1,1,0
2014,Officer,49849,1,1,0
2014,Officer,49908,1,1,0
2014,Officer,50025,1,1,0
2014,Officer,50036,1,1,0
2014,Officer,50131,26,25,1
2014,Officer,50158,1,1,0
2014,Officer,50501,1,1,0
2014,Officer,50511,1,1,0
2014,Officer,50703,5,4,1
2014,Officer,51031,2,2,0
2014,Officer,51111,1,1,0
2014,Officer,51334,1,1,0
2014,Officer,51442,2,2,0
2014,Officer,51503,4,4,0
2014,Officer,51601,1,1,0
2014,Officer,52002,2,2,0
2014,Officer,52246,5,5,0
2014,Officer,52353,3,3,0
2014,Officer,52404,2,2,0
2014,Officer,52501,2,2,0
2014,Officer,52556,1,1,0
2014,Officer,52632,1,1,0
2014,Officer,52638,1,1,0
2014,Officer,52761,2,2,0
2014,Officer,52806,1,1,0
2014,Officer,53073,2,2,0
2014,Officer,53089,1,1,0
2014,Officer,53094,1,1,0
2014,Officer,53144,1,1,0
2014,Officer,53154,1,1,0
2014,Officer,53186,1,1,0
2014,Officer,53190,1,1,0
2014,Officer,53212,2,1,1
2014,Officer,53403,5,5,0
2014,Officer,53704,8,8,0
2014,Officer,53708,2,2,0
2014,Officer,53818,1,1,0
2014,Officer,53901,1,1,0
2014,Officer,54022,3,3,0
2014,Officer,54143,1,1,0
2014,Officer,54241,2,2,0
2014,Officer,54303,1,1,0
2014,Officer,54401,1,1,0
2014,Officer,54409,2,2,0
2014,Officer,54449,2,1,1
2014,Officer,54451,1,1,0
2014,Officer,54481,1,1,0
2014,Officer,54487,1,0,1
2014,Officer,54495,1,1,0
2014,Officer,54615,1,1,0
2014,Officer,54618,4,3,1
2014,Officer,54650,1,1,0
2014,Officer,54656,1,1,0
2014,Officer,54665,2,2,0
2014,Officer,54703,1,1,0
2014,Officer,54729,4,4,0
2014,Officer,54751,1,0,1
2014,Officer,54843,1,0,1
2014,Officer,54880,1,1,0
2014,Officer,54914,2,1,1
2014,Officer,54929,1,1,0
2014,Officer,54971,1,1,0
2014,Officer,54981,1,1,0
2014,Officer,55016,17,14,3
2014,Officer,55021,1,1,0
2014,Officer,55068,8,7,1
2014,Officer,55082,1,1,0
2014,Officer,55101,10,8,2
2014,Officer,55106,1,1,0
2014,Officer,55107,4,3,1
2014,Officer,55112,4,4,0
2014,Officer,55113,3,3,0
2014,Officer,55303,11,8,3
2014,Officer,55350,2,2,0
2014,Officer,55362,1,1,0
2014,Officer,55431,2,2,0
2014,Officer,55443,2,2,0
2014,Officer,55720,2,1,1
2014,Officer,55744,1,0,1
2014,Officer,56001,3,3,0
2014,Officer,56031,2,1,1
2014,Officer,56073,1,1,0
2014,Officer,56082,1,1,0
2014,Officer,56143,2,0,2
2014,Officer,56156,1,1,0
2014,Officer,56164,2,2,0
2014,Officer,56208,2,2,0
2014,Officer,56256,1,1,0
2014,Officer,56258,1,1,0
2014,Officer,56265,1,1,0
2014,Officer,56303,1,1,0
2014,Officer,56345,4,4,0
2014,Officer,56347,1,1,0
2014,Officer,56378,3,3,0
2014,Officer,56401,1,1,0
2014,Officer,56560,3,3,0
2014,Officer,57006,1,1,0
2014,Officer,57042,1,1,0
2014,Officer,57104,8,8,0
2014,Officer,57201,2,2,0
2014,Officer,57252,1,1,0
2014,Officer,57301,1,1,0
2014,Officer,57350,4,3,1
2014,Officer,57380,1,1,0
2014,Officer,57501,3,3,0
2014,Officer,57702,1,0,1
2014,Officer,57703,1,1,0
2014,Officer,57717,1,1,0
2014,Officer,58072,5,5,0
2014,Officer,58102,11,11,0
2014,Officer,58201,3,3,0
2014,Officer,58301,1,1,0
2014,Officer,58324,1,1,0
2014,Officer,58402,1,1,0
2014,Officer,58433,1,1,0
2014,Officer,58506,7,7,0
2014,Officer,58702,4,4,0
2014,Officer,59047,1,1,0
2014,Officer,59102,2,2,0
2014,Officer,59230,3,3,0
2014,Officer,59405,2,2,0
2014,Officer,59501,1,1,0
2014,Officer,59602,4,4,0
2014,Officer,59636,1,1,0
2014,Officer,59701,1,1,0
2014,Officer,59711,1,1,0
2014,Officer,59714,6,6,0
2014,Officer,59725,1,1,0
2014,Officer,59808,4,4,0
2014,Officer,59901,1,1,0
2014,Officer,60037,1,1,0
2014,Officer,60120,2,2,0
2014,Officer,60435,2,2,0
2014,Officer,60472,2,1,1
2014,Officer,60505,4,3,1
2014,Officer,60546,10,10,0
2014,Officer,60615,8,6,2
2014,Officer,60616,7,7,0
2014,Officer,60638,3,3,0
2014,Officer,60651,3,3,0
2014,Officer,60901,4,4,0
2014,Officer,61021,3,3,0
2014,Officer,61071,1,1,0
2014,Officer,61115,4,4,0
2014,Officer,61264,6,6,0
2014,Officer,61341,1,1,0
2014,Officer,61401,3,2,1
2014,Officer,61443,2,2,0
2014,Officer,61455,1,1,0
2014,Officer,61607,5,5,0
2014,Officer,61701,4,4,0
2014,Officer,61801,2,2,0
2014,Officer,61938,3,3,0
2014,Officer,61944,1,1,0
2014,Officer,61951,1,1,0
2014,Officer,62056,2,2,0
2014,Officer,62269,3,3,0
2014,Officer,62286,1,1,0
2014,Officer,62305,1,1,0
2014,Officer,62401,1,1,0
2014,Officer,62439,2,2,0
2014,Officer,62521,3,3,0
2014,Officer,62702,16,14,2
2014,Officer,62864,1,1,0
2014,Officer,62959,3,3,0
2014,Officer,63020,1,0,1
2014,Officer,63109,1,1,0
2014,Officer,63125,5,3,2
2014,Officer,63640,2,2,0
2014,Officer,63703,6,5,1
2014,Officer,63857,1,1,0
2014,Officer,64052,1,1,0
2014,Officer,64085,2,1,1
2014,Officer,64129,7,6,1
2014,Officer,64402,1,1,0
2014,Officer,64468,2,0,2
2014,Officer,64506,2,2,0
2014,Officer,64683,1,1,0
2014,Officer,64701,1,0,1
2014,Officer,64735,1,1,0
2014,Officer,64759,2,1,1
2014,Officer,64804,5,5,0
2014,Officer,64836,2,1,1
2014,Officer,65101,18,11,7
2014,Officer,65109,3,1,2
2014,Officer,65233,3,3,0
2014,Officer,65251,1,1,0
2014,Officer,65270,1,0,1
2014,Officer,65301,3,3,0
2014,Officer,65305,3,3,0
2014,Officer,65340,2,2,0
2014,Officer,65401,1,1,0
2014,Officer,65473,4,3,1
2014,Officer,65605,1,1,0
2014,Officer,65708,3,3,0
2014,Officer,65723,1,1,0
2014,Officer,65802,2,1,1
2014,Officer,65803,5,3,2
2014,Officer,66044,2,1,1
2014,Officer,66061,2,0,2
2014,Officer,66067,1,1,0
2014,Officer,66071,1,0,1
2014,Officer,66102,5,3,2
2014,Officer,66219,5,4,1
2014,Officer,66220,1,1,0
2014,Officer,66434,1,1,0
2014,Officer,66436,1,1,0
2014,Officer,66503,1,1,0
2014,Officer,66611,4,3,1
2014,Officer,66619,8,7,1
2014,Officer,66749,3,3,0
2014,Officer,66762,1,1,0
2014,Officer,66801,2,2,0
2014,Officer,66967,2,2,0
2014,Officer,67217,3,3,0
2014,Officer,67219,2,2,0
2014,Officer,67337,1,1,0
2014,Officer,67401,4,3,1
2014,Officer,67432,1,1,0
2014,Officer,67601,1,1,0
2014,Officer,67654,1,1,0
2014,Officer,68025,2,1,1
2014,Officer,68041,1,1,0
2014,Officer,68106,4,4,0
2014,Officer,68142,1,0,1
2014,Officer,68310,1,1,0
2014,Officer,68410,1,1,0
2014,Officer,68503,3,2,1
2014,Officer,68508,1,1,0
2014,Officer,68524,10,9,1
2014,Officer,68602,2,2,0
2014,Officer,68701,1,0,1
2014,Officer,68803,4,3,1
2014,Officer,68822,2,2,0
2014,Officer,68901,3,3,0
2014,Officer,70084,3,2,1
2014,Officer,70117,7,7,0
2014,Officer,70364,5,4,1
2014,Officer,70401,10,10,0
2014,Officer,70427,3,2,1
2014,Officer,70433,1,1,0
2014,Officer,70460,1,1,0
2014,Officer,70508,2,1,1
2014,Officer,70510,3,3,0
2014,Officer,70517,2,2,0
2014,Officer,70544,2,2,0
2014,Officer,70582,1,1,0
2014,Officer,70601,3,3,0
2014,Officer,70721,3,3,0
2014,Officer,70760,2,2,0
2014,Officer,70820,5,5,0
2014,Officer,71019,3,3,0
2014,Officer,71055,3,3,0
2014,Officer,71101,2,1,1
2014,Officer,71111,3,2,1
2014,Officer,71270,6,6,0
2014,Officer,71295,1,1,0
2014,Officer,71303,2,2,0
2014,Officer,71322,1,1,0
2014,Officer,71351,1,1,0
2014,Officer,71360,11,10,1
2014,Officer,71415,1,1,0
2014,Officer,71459,1,0,1
2014,Officer,71602,2,1,1
2014,Officer,71671,3,2,1
2014,Officer,71701,1,1,0
2014,Officer,71753,1,0,1
2014,Officer,72007,1,1,0
2014,Officer,72015,2,2,0
2014,Officer,72021,1,0,1
2014,Officer,72023,1,1,0
2014,Officer,72104,1,1,0
2014,Officer,72110,1,1,0
2014,Officer,72114,5,3,2
2014,Officer,72150,2,2,0
2014,Officer,72160,2,2,0
2014,Officer,72199,13,11,2
2014,Officer,72205,4,4,0
2014,Officer,72335,1,1,0
2014,Officer,72432,3,2,1
2014,Officer,72450,1,1,0
2014,Officer,72501,1,1,0
2014,Officer,72543,1,1,0
2014,Officer,72601,3,2,1
2014,Officer,72650,1,1,0
2014,Officer,72653,1,1,0
2014,Officer,72701,1,1,0
2014,Officer,72712,4,3,1
2014,Officer,72744,1,0,1
2014,Officer,72830,1,1,0
2014,Officer,72855,1,1,0
2014,Officer,72923,1,1,0
2014,Officer,72949,1,1,0
2014,Officer,73034,2,0,2
2014,Officer,73064,6,6,0
2014,Officer,73069,4,3,1
2014,Officer,73111,3,3,0
2014,Officer,73141,4,4,0
2014,Officer,73503,6,6,0
2014,Officer,73521,1,1,0
2014,Officer,73705,2,2,0
2014,Officer,74012,3,3,0
2014,Officer,74014,6,6,0
2014,Officer,74017,1,0,1
2014,Officer,74075,6,6,0
2014,Officer,74107,6,5,1
2014,Officer,74116,1,1,0
2014,Officer,74301,3,3,0
2014,Officer,74403,2,2,0
2014,Officer,74447,1,1,0
2014,Officer,74501,5,2,3
2014,Officer,74701,2,2,0
2014,Officer,74820,3,3,0
2014,Officer,74848,1,1,0
2014,Officer,74953,1,1,0
2014,Officer,75020,1,1,0
2014,Officer,75051,18,18,0
2014,Officer,75077,6,6,0
2014,Officer,75110,1,1,0
2014,Officer,75159,1,1,0
2014,Officer,75160,1,1,0
2014,Officer,75165,2,2,0
2014,Officer,75402,2,2,0
2014,Officer,75672,1,1,0
2014,Officer,75709,1,1,0
2014,Officer,75803,1,1,0
2014,Officer,75901,1,1,0
2014,Officer,76105,3,3,0
2014,Officer,76108,3,3,0
2014,Officer,76115,8,8,0
2014,Officer,76302,2,2,0
2014,Officer,76401,3,3,0
2014,Officer,76502,7,7,0
2014,Officer,76528,1,1,0
2014,Officer,76542,4,4,0
2014,Officer,76707,9,9,0
2014,Officer,76801,7,7,0
2014,Officer,77034,8,8,0
2014,Officer,77067,5,5,0
2014,Officer,77082,22,22,0
2014,Officer,77437,1,1,0
2014,Officer,77515,4,4,0
2014,Officer,77568,2,2,0
2014,Officer,77802,3,3,0
2014,Officer,77904,1,1,0
2014,Officer,78041,1,1,0
2014,Officer,78130,2,2,0
2014,Officer,78218,12,12,0
2014,Officer,78219,10,10,0
2014,Officer,78257,20,20,0
2014,Officer,78416,2,2,0
2014,Officer,78520,1,1,0
2014,Officer,78596,7,7,0
2014,Officer,78602,4,4,0
2014,Officer,78617,4,4,0
2014,Officer,78624,2,2,0
2014,Officer,78665,9,9,0
2014,Officer,78666,4,4,0
2014,Officer,78703,49,42,7
2014,Officer,78731,4,4,0
2014,Officer,78746,7,7,0
2014,Officer,78861,1,1,0
2014,Officer,79107,2,2,0
2014,Officer,79403,2,2,0
2014,Officer,79924,1,1,0
2014,Officer,79936,7,7,0
2014,Officer,80011,11,11,0
2014,Officer,80012,2,2,0
2014,Officer,80112,5,3,2
2014,Officer,80137,3,3,0
2014,Officer,80216,1,1,0
2014,Officer,80304,1,1,0
2014,Officer,80550,1,1,0
2014,Officer,80621,1,1,0
2014,Officer,80907,1,1,0
2014,Officer,80913,5,5,0
2014,Officer,80916,5,5,0
2014,Officer,81004,1,1,0
2014,Officer,81303,1,1,0
2014,Officer,82009,11,11,0
2014,Officer,82072,5,5,0
2014,Officer,82214,2,2,0
2014,Officer,82240,1,1,0
2014,Officer,82431,1,1,0
2014,Officer,82435,1,1,0
2014,Officer,82520,1,1,0
2014,Officer,82633,2,2,0
2014,Officer,82716,1,1,0
2014,Officer,82801,4,4,0
2014,Officer,83263,2,2,0
2014,Officer,83318,1,1,0
2014,Officer,83402,2,2,0
2014,Officer,83440,1,1,0
2014,Officer,83501,1,1,0
2014,Officer,83605,3,3,0
2014,Officer,83705,6,4,2
2014,Officer,83805,1,1,0
2014,Officer,83854,1,1,0
2014,Officer,84003,7,7,0
2014,Officer,84020,15,15,0
2014,Officer,84043,2,2,0
2014,Officer,84058,6,6,0
2014,Officer,84065,17,15,2
2014,Officer,84074,2,2,0
2014,Officer,84078,1,1,0
2014,Officer,84084,6,6,0
2014,Officer,84116,2,1,1
2014,Officer,84321,1,1,0
2014,Officer,84323,1,1,0
2014,Officer,84405,4,3,1
2014,Officer,84501,1,1,0
2014,Officer,84511,1,1,0
2014,Officer,84660,2,2,0
2014,Officer,84663,4,3,1
2014,Officer,84701,1,1,0
2014,Officer,84713,1,1,0
2014,Officer,84720,3,3,0
2014,Officer,84790,5,5,0
2014,Officer,85008,27,23,4
2014,Officer,85122,2,2,0
2014,Officer,85132,7,7,0
2014,Officer,85201,4,4,0
2014,Officer,85281,2,2,0
2014,Officer,85396,1,1,0
2014,Officer,85607,1,1,0
2014,Officer,85653,9,9,0
2014,Officer,85706,5,5,0
2014,Officer,86015,3,3,0
2014,Officer,86301,2,2,0
2014,Officer,87123,1,1,0
2014,Officer,87144,6,6,0
2014,Officer,87401,2,2,0
2014,Officer,87508,3,3,0
2014,Officer,87557,1,1,0
2014,Officer,87740,1,1,0
2014,Officer,87747,2,2,0
2014,Officer,88007,7,7,0
2014,Officer,88101,1,1,0
2014,Officer,88203,2,2,0
2014,Officer,88310,3,3,0
2014,Officer,89115,8,7,1
2014,Officer,89139,1,1,0
2014,Officer,89165,3,3,0
2014,Officer,89406,2,2,0
2014,Officer,89447,2,2,0
2014,Officer,89506,4,4,0
2014,Officer,89509,5,5,0
2014,Officer,89701,3,3,0
2014,Officer,90025,2,2,0
2014,Officer,90201,5,5,0
2014,Officer,90266,4,4,0
2014,Officer,90302,5,5,0
2014,Officer,90640,2,2,0
2014,Officer,90720,17,17,0
2014,Officer,90731,1,1,0
2014,Officer,90813,4,4,0
2014,Officer,90822,5,5,0
2014,Officer,91505,1,1,0
2014,Officer,91702,4,3,1
2014,Officer,91764,2,2,0
2014,Officer,91766,2,2,0
2014,Officer,91950,2,2,0
2014,Officer,92025,3,3,0
2014,Officer,92111,4,4,0
2014,Officer,92220,1,1,0
2014,Officer,92311,1,1,0
2014,Officer,92324,1,1,0
2014,Officer,92410,4,4,0
2014,Officer,92518,6,6,0
2014,Officer,92707,1,1,0
2014,Officer,92866,1,1,0
2014,Officer,93003,7,7,0
2014,Officer,93291,2,2,0
2014,Officer,93307,2,2,0
2014,Officer,93422,1,1,0
2014,Officer,93451,1,1,0
2014,Officer,93536,1,1,0
2014,Officer,93702,1,1,0
2014,Officer,93727,7,7,0
2014,Officer,94043,2,2,0
2014,Officer,94132,1,1,0
2014,Officer,94401,1,1,0
2014,Officer,94519,1,1,0
2014,Officer,94533,1,1,0
2014,Officer,94565,1,1,0
2014,Officer,94596,2,2,0
2014,Officer,94804,9,9,0
2014,Officer,94903,1,1,0
2014,Officer,95023,1,1,0
2014,Officer,95206,2,2,0
2014,Officer,95240,2,2,0
2014,Officer,95351,2,2,0
2014,Officer,95361,1,1,0
2014,Officer,95503,1,1,0
2014,Officer,95603,1,1,0
2014,Officer,95826,7,7,0
2014,Officer,95828,9,9,0
2014,Officer,96001,2,2,0
2014,Officer,96707,16,15,1
2014,Officer,96716,1,1,0
2014,Officer,96720,3,2,1
2014,Officer,96782,8,8,0
2014,Officer,96786,5,4,1
2014,Officer,96789,2,2,0
2014,Officer,96795,1,1,0
2014,Officer,96816,6,5,1
2014,Officer,96820,2,2,0
2014,Officer,96913,14,13,1
2014,Officer,97015,4,4,0
2014,Officer,97031,1,1,0
2014,Officer,97071,2,2,0
2014,Officer,97116,4,2,2
2014,Officer,97128,2,2,0
2014,Officer,97146,1,1,0
2014,Officer,97211,8,6,2
2014,Officer,97217,1,1,0
2014,Officer,97303,2,2,0
2014,Officer,97309,3,2,1
2014,Officer,97355,1,1,0
2014,Officer,97420,2,2,0
2014,Officer,97470,2,2,0
2014,Officer,97477,3,2,1
2014,Officer,97501,2,1,1
2014,Officer,97520,3,3,0
2014,Officer,97601,1,0,1
2014,Officer,97756,1,0,1
2014,Officer,98032,4,3,1
2014,Officer,98052,1,0,1
2014,Officer,98108,4,4,0
2014,Officer,98119,10,10,0
2014,Officer,98221,1,1,0
2014,Officer,98271,2,2,0
2014,Officer,98290,1,1,0
2014,Officer,98312,1,1,0
2014,Officer,98366,5,5,0
2014,Officer,98372,1,1,0
2014,Officer,98430,11,10,1
2014,Officer,98433,5,5,0
2014,Officer,98531,1,1,0
2014,Officer,98632,1,1,0
2014,Officer,98823,1,1,0
2014,Officer,98837,1,1,0
2014,Officer,98901,2,1,1
2014,Officer,98903,4,4,0
2014,Officer,99217,3,3,0
2014,Officer,99224,2,2,0
2014,Officer,99301,1,1,0
2014,Officer,99362,2,2,0
2014,Officer,99505,10,8,2
2014,Officer,99701,4,2,2
2014,Officer,99731,1,1,0
2014,Officer,99821,1,1,0
2014,Officer,99901,1,1,0
2014,Warrant Officer,00681,1,1,0
2014,Warrant Officer,00795,2,2,0
2014,Warrant Officer,00820,2,2,0
2014,Warrant Officer,00901,5,5,0
2014,Warrant Officer,00951,1,1,0
2014,Warrant Officer,01085,2,2,0
2014,Warrant Officer,01434,1,1,0
2014,Warrant Officer,01605,1,1,0
2014,Warrant Officer,01731,3,3,0
2014,Warrant Officer,02043,1,1,0
2014,Warrant Officer,02122,1,1,0
2014,Warrant Officer,02169,1,1,0
2014,Warrant Officer,02301,1,1,0
2014,Warrant Officer,02542,4,4,0
2014,Warrant Officer,02842,2,2,0
2014,Warrant Officer,02852,5,5,0
2014,Warrant Officer,02920,1,1,0
2014,Warrant Officer,03101,1,1,0
2014,Warrant Officer,03301,2,2,0
2014,Warrant Officer,03801,1,1,0
2014,Warrant Officer,04333,1,1,0
2014,Warrant Officer,04401,5,5,0
2014,Warrant Officer,05403,2,2,0
2014,Warrant Officer,05446,2,2,0
2014,Warrant Officer,05465,1,1,0
2014,Warrant Officer,06082,1,1,0
2014,Warrant Officer,06096,4,4,0
2014,Warrant Officer,06105,1,1,0
2014,Warrant Officer,06614,1,1,0
2014,Warrant Officer,07666,2,2,0
2014,Warrant Officer,08628,2,2,0
2014,Warrant Officer,08640,2,2,0
2014,Warrant Officer,08733,6,6,0
2014,Warrant Officer,08873,1,1,0
2014,Warrant Officer,10037,1,1,0
2014,Warrant Officer,10314,2,2,0
2014,Warrant Officer,10567,1,1,0
2014,Warrant Officer,11779,4,4,0
2014,Warrant Officer,12110,4,4,0
2014,Warrant Officer,12180,2,2,0
2014,Warrant Officer,12302,2,2,0
2014,Warrant Officer,13211,2,2,0
2014,Warrant Officer,14624,2,2,0
2014,Warrant Officer,15216,1,1,0
2014,Warrant Officer,15301,2,2,0
2014,Warrant Officer,15902,4,4,0
2014,Warrant Officer,16648,1,1,0
2014,Warrant Officer,17003,18,18,0
2014,Warrant Officer,17013,2,2,0
2014,Warrant Officer,17022,1,1,0
2014,Warrant Officer,17042,1,1,0
2014,Warrant Officer,18102,1,1,0
2014,Warrant Officer,18509,2,2,0
2014,Warrant Officer,18704,1,1,0
2014,Warrant Officer,18960,2,2,0
2014,Warrant Officer,19044,1,1,0
2014,Warrant Officer,19720,2,2,0
2014,Warrant Officer,20003,3,3,0
2014,Warrant Officer,20708,2,2,0
2014,Warrant Officer,21010,5,5,0
2014,Warrant Officer,21078,1,1,0
2014,Warrant Officer,21136,1,1,0
2014,Warrant Officer,21204,1,1,0
2014,Warrant Officer,22032,3,3,0
2014,Warrant Officer,22060,1,1,0
2014,Warrant Officer,23150,7,7,0
2014,Warrant Officer,23237,1,1,0
2014,Warrant Officer,23451,2,2,0
2014,Warrant Officer,23701,1,1,0
2014,Warrant Officer,23805,1,1,0
2014,Warrant Officer,23824,1,1,0
2014,Warrant Officer,24401,1,1,0
2014,Warrant Officer,26003,2,2,0
2014,Warrant Officer,26187,5,5,0
2014,Warrant Officer,26301,1,1,0
2014,Warrant Officer,26537,1,1,0
2014,Warrant Officer,27030,1,1,0
2014,Warrant Officer,27504,1,1,0
2014,Warrant Officer,27549,2,2,0
2014,Warrant Officer,27560,5,5,0
2014,Warrant Officer,27607,1,1,0
2014,Warrant Officer,27828,1,1,0
2014,Warrant Officer,27932,1,1,0
2014,Warrant Officer,28043,1,1,0
2014,Warrant Officer,28054,1,1,0
2014,Warrant Officer,28147,2,2,0
2014,Warrant Officer,28208,2,2,0
2014,Warrant Officer,28328,1,1,0
2014,Warrant Officer,28376,1,1,0
2014,Warrant Officer,28504,1,1,0
2014,Warrant Officer,28580,1,1,0
2014,Warrant Officer,29044,8,8,0
2014,Warrant Officer,29115,1,1,0
2014,Warrant Officer,29303,2,2,0
2014,Warrant Officer,29488,1,1,0
2014,Warrant Officer,29605,2,2,0
2014,Warrant Officer,29625,2,2,0
2014,Warrant Officer,29631,1,1,0
2014,Warrant Officer,29633,1,1,0
2014,Warrant Officer,29944,1,1,0
2014,Warrant Officer,30040,1,1,0
2014,Warrant Officer,30060,6,6,0
2014,Warrant Officer,30294,1,1,0
2014,Warrant Officer,30680,4,4,0
2014,Warrant Officer,31211,2,2,0
2014,Warrant Officer,31409,2,2,0
2014,Warrant Officer,31901,1,1,0
2014,Warrant Officer,32086,2,2,0
2014,Warrant Officer,32221,3,3,0
2014,Warrant Officer,32311,3,3,0
2014,Warrant Officer,32351,1,1,0
2014,Warrant Officer,33092,1,1,0
2014,Warrant Officer,33523,1,1,0
2014,Warrant Officer,33606,1,1,0
2014,Warrant Officer,33782,5,5,0
2014,Warrant Officer,33873,1,1,0
2014,Warrant Officer,34474,1,1,0
2014,Warrant Officer,35217,2,2,0
2014,Warrant Officer,35594,1,1,0
2014,Warrant Officer,35601,2,2,0
2014,Warrant Officer,36043,1,1,0
2014,Warrant Officer,36109,3,3,0
2014,Warrant Officer,36322,1,1,0
2014,Warrant Officer,36608,3,3,0
2014,Warrant Officer,37033,1,1,0
2014,Warrant Officer,37090,1,1,0
2014,Warrant Officer,37167,5,5,0
2014,Warrant Officer,37204,2,2,0
2014,Warrant Officer,37303,1,1,0
2014,Warrant Officer,37777,6,6,0
2014,Warrant Officer,37919,2,2,0
2014,Warrant Officer,38024,1,1,0
2014,Warrant Officer,38663,1,1,0
2014,Warrant Officer,38671,1,1,0
2014,Warrant Officer,38801,3,3,0
2014,Warrant Officer,39046,1,1,0
2014,Warrant Officer,39168,1,1,0
2014,Warrant Officer,39204,1,1,0
2014,Warrant Officer,39209,3,3,0
2014,Warrant Officer,39296,1,1,0
2014,Warrant Officer,39307,2,2,0
2014,Warrant Officer,39328,2,2,0
2014,Warrant Officer,39345,1,1,0
2014,Warrant Officer,39350,1,1,0
2014,Warrant Officer,39407,3,3,0
2014,Warrant Officer,39501,1,1,0
2014,Warrant Officer,39505,1,1,0
2014,Warrant Officer,39654,1,1,0
2014,Warrant Officer,40475,2,2,0
2014,Warrant Officer,40510,2,2,0
2014,Warrant Officer,40601,2,2,0
2014,Warrant Officer,41031,1,1,0
2014,Warrant Officer,41164,1,1,0
2014,Warrant Officer,42101,2,2,0
2014,Warrant Officer,42141,1,1,0
2014,Warrant Officer,42420,1,1,0
2014,Warrant Officer,43055,2,2,0
2014,Warrant Officer,43213,5,5,0
2014,Warrant Officer,43217,3,3,0
2014,Warrant Officer,43235,1,1,0
2014,Warrant Officer,43756,2,2,0
2014,Warrant Officer,44720,3,3,0
2014,Warrant Officer,45215,2,2,0
2014,Warrant Officer,45601,2,2,0
2014,Warrant Officer,46012,1,1,0
2014,Warrant Officer,46131,1,1,0
2014,Warrant Officer,46176,7,7,0
2014,Warrant Officer,46216,1,1,0
2014,Warrant Officer,46241,3,3,0
2014,Warrant Officer,46360,1,1,0
2014,Warrant Officer,47374,1,1,0
2014,Warrant Officer,47421,1,1,0
2014,Warrant Officer,47804,1,1,0
2014,Warrant Officer,48180,1,1,0
2014,Warrant Officer,48208,1,1,0
2014,Warrant Officer,48837,3,3,0
2014,Warrant Officer,48906,3,3,0
2014,Warrant Officer,49202,1,1,0
2014,Warrant Officer,49739,1,1,0
2014,Warrant Officer,50036,2,2,0
2014,Warrant Officer,50126,1,1,0
2014,Warrant Officer,50131,6,6,0
2014,Warrant Officer,50703,2,2,0
2014,Warrant Officer,52404,1,1,0
2014,Warrant Officer,52556,1,1,0
2014,Warrant Officer,52577,2,2,0
2014,Warrant Officer,53089,1,1,0
2014,Warrant Officer,53095,7,7,0
2014,Warrant Officer,53144,2,2,0
2014,Warrant Officer,53212,2,2,0
2014,Warrant Officer,53704,3,3,0
2014,Warrant Officer,53708,1,1,0
2014,Warrant Officer,53901,1,1,0
2014,Warrant Officer,54495,2,2,0
2014,Warrant Officer,54618,4,4,0
2014,Warrant Officer,54656,1,1,0
2014,Warrant Officer,54703,1,1,0
2014,Warrant Officer,55021,1,1,0
2014,Warrant Officer,55068,2,2,0
2014,Warrant Officer,55101,3,3,0
2014,Warrant Officer,55107,5,5,0
2014,Warrant Officer,55113,1,1,0
2014,Warrant Officer,55431,2,2,0
2014,Warrant Officer,55912,1,1,0
2014,Warrant Officer,56073,1,1,0
2014,Warrant Officer,56303,2,2,0
2014,Warrant Officer,56345,2,2,0
2014,Warrant Officer,57006,1,1,0
2014,Warrant Officer,57104,1,1,0
2014,Warrant Officer,57350,1,1,0
2014,Warrant Officer,57702,3,3,0
2014,Warrant Officer,57703,1,1,0
2014,Warrant Officer,58075,1,1,0
2014,Warrant Officer,58102,1,1,0
2014,Warrant Officer,58506,3,3,0
2014,Warrant Officer,59602,3,3,0
2014,Warrant Officer,59604,1,1,0
2014,Warrant Officer,59701,2,2,0
2014,Warrant Officer,60638,2,2,0
2014,Warrant Officer,60651,1,1,0
2014,Warrant Officer,61607,1,1,0
2014,Warrant Officer,61734,1,1,0
2014,Warrant Officer,61801,6,6,0
2014,Warrant Officer,62521,2,2,0
2014,Warrant Officer,62702,5,5,0
2014,Warrant Officer,63125,3,3,0
2014,Warrant Officer,63841,1,1,0
2014,Warrant Officer,64067,1,1,0
2014,Warrant Officer,64506,1,1,0
2014,Warrant Officer,65101,2,2,0
2014,Warrant Officer,65305,4,4,0
2014,Warrant Officer,65473,2,2,0
2014,Warrant Officer,65605,1,1,0
2014,Warrant Officer,65802,1,1,0
2014,Warrant Officer,66027,1,1,0
2014,Warrant Officer,66619,2,2,0
2014,Warrant Officer,66749,1,1,0
2014,Warrant Officer,67010,1,1,0
2014,Warrant Officer,67219,2,2,0
2014,Warrant Officer,67501,1,1,0
2014,Warrant Officer,68508,1,1,0
2014,Warrant Officer,68524,4,4,0
2014,Warrant Officer,68801,1,1,0
2014,Warrant Officer,68803,1,1,0
2014,Warrant Officer,68901,1,1,0
2014,Warrant Officer,69101,1,1,0
2014,Warrant Officer,70117,1,1,0
2014,Warrant Officer,70401,2,2,0
2014,Warrant Officer,70427,1,1,0
2014,Warrant Officer,70508,2,2,0
2014,Warrant Officer,70721,1,1,0
2014,Warrant Officer,71360,6,6,0
2014,Warrant Officer,72199,7,7,0
2014,Warrant Officer,72301,1,1,0
2014,Warrant Officer,73051,3,3,0
2014,Warrant Officer,73069,3,3,0
2014,Warrant Officer,73111,3,3,0
2014,Warrant Officer,73503,1,1,0
2014,Warrant Officer,74116,1,1,0
2014,Warrant Officer,74501,1,1,0
2014,Warrant Officer,75077,1,1,0
2014,Warrant Officer,76502,2,2,0
2014,Warrant Officer,76542,1,1,0
2014,Warrant Officer,76801,1,1,0
2014,Warrant Officer,77034,4,4,0
2014,Warrant Officer,77082,2,2,0
2014,Warrant Officer,78130,1,1,0
2014,Warrant Officer,78155,1,1,0
2014,Warrant Officer,78218,3,3,0
2014,Warrant Officer,78219,4,4,0
2014,Warrant Officer,78257,2,2,0
2014,Warrant Officer,78617,5,5,0
2014,Warrant Officer,78665,1,1,0
2014,Warrant Officer,78703,9,9,0
2014,Warrant Officer,78719,1,1,0
2014,Warrant Officer,78731,4,4,0
2014,Warrant Officer,80011,4,4,0
2014,Warrant Officer,80112,2,2,0
2014,Warrant Officer,80216,1,1,0
2014,Warrant Officer,80916,1,1,0
2014,Warrant Officer,82009,7,7,0
2014,Warrant Officer,82072,1,1,0
2014,Warrant Officer,82240,1,1,0
2014,Warrant Officer,83202,1,1,0
2014,Warrant Officer,83501,1,1,0
2014,Warrant Officer,83676,1,1,0
2014,Warrant Officer,83705,8,8,0
2014,Warrant Officer,84020,5,5,0
2014,Warrant Officer,84043,1,1,0
2014,Warrant Officer,84058,2,2,0
2014,Warrant Officer,84065,6,6,0
2014,Warrant Officer,84084,13,13,0
2014,Warrant Officer,84321,2,2,0
2014,Warrant Officer,84404,1,1,0
2014,Warrant Officer,84405,1,1,0
2014,Warrant Officer,84501,1,1,0
2014,Warrant Officer,85008,8,8,0
2014,Warrant Officer,85212,1,1,0
2014,Warrant Officer,85653,8,8,0
2014,Warrant Officer,87144,1,1,0
2014,Warrant Officer,87305,1,1,0
2014,Warrant Officer,87508,3,3,0
2014,Warrant Officer,88007,2,2,0
2014,Warrant Officer,89032,1,1,0
2014,Warrant Officer,89115,1,1,0
2014,Warrant Officer,89139,2,2,0
2014,Warrant Officer,89506,7,7,0
2014,Warrant Officer,89701,1,1,0
2014,Warrant Officer,90720,6,6,0
2014,Warrant Officer,90822,1,1,0
2014,Warrant Officer,91205,1,1,0
2014,Warrant Officer,92111,2,2,0
2014,Warrant Officer,93955,1,1,0
2014,Warrant Officer,94533,1,1,0
2014,Warrant Officer,95206,3,3,0
2014,Warrant Officer,95655,1,1,0
2014,Warrant Officer,95819,1,1,0
2014,Warrant Officer,95826,1,1,0
2014,Warrant Officer,96707,2,2,0
2014,Warrant Officer,96782,1,1,0
2014,Warrant Officer,96786,2,2,0
2014,Warrant Officer,96816,2,2,0
2014,Warrant Officer,96857,1,1,0
2014,Warrant Officer,96913,2,2,0
2014,Warrant Officer,97015,1,1,0
2014,Warrant Officer,97146,2,2,0
2014,Warrant Officer,97302,8,8,0
2014,Warrant Officer,97303,1,1,0
2014,Warrant Officer,97309,3,3,0
2014,Warrant Officer,97702,1,1,0
2014,Warrant Officer,97801,2,2,0
2014,Warrant Officer,98108,1,1,0
2014,Warrant Officer,98321,2,2,0
2014,Warrant Officer,98430,1,1,0
2014,Warrant Officer,98433,1,1,0
2014,Warrant Officer,98901,1,1,0
2014,Warrant Officer,98903,1,1,0
2014,Warrant Officer,99011,1,1,0
2014,Warrant Officer,99505,5,5,0
2014,Warrant Officer,99701,1,1,0
2014,Warrant Officer,99731,1,1,0
2015,Enlisted,00602,10,4,6
2015,Enlisted,00605,7,0,7
2015,Enlisted,00612,16,4,12
2015,Enlisted,00623,12,1,11
2015,Enlisted,00624,9,1,8
2015,Enlisted,00641,19,3,16
2015,Enlisted,00681,24,4,20
2015,Enlisted,00683,16,1,15
2015,Enlisted,00693,16,2,14
2015,Enlisted,00705,14,3,11
2015,Enlisted,00714,17,0,17
2015,Enlisted,00725,6,0,6
2015,Enlisted,00732,10,1,9
2015,Enlisted,00733,3,1,2
2015,Enlisted,00735,14,2,12
2015,Enlisted,00736,12,2,10
2015,Enlisted,00737,15,2,13
2015,Enlisted,00751,47,10,37
2015,Enlisted,00769,13,1,12
2015,Enlisted,00777,13,1,12
2015,Enlisted,00785,11,1,10
2015,Enlisted,00792,2,0,2
2015,Enlisted,00795,195,11,184
2015,Enlisted,00802,16,2,14
2015,Enlisted,00820,6,1,5
2015,Enlisted,00850,37,3,34
2015,Enlisted,00901,34,10,24
2015,Enlisted,00902,3,0,3
2015,Enlisted,00918,4,1,3
2015,Enlisted,00934,29,4,25
2015,Enlisted,00951,5,1,4
2015,Enlisted,00963,31,5,26
2015,Enlisted,00986,7,1,6
2015,Enlisted,01013,15,7,8
2015,Enlisted,01030,32,3,29
2015,Enlisted,01062,6,0,6
2015,Enlisted,01082,13,1,12
2015,Enlisted,01085,15,2,13
2015,Enlisted,01109,20,4,16
2015,Enlisted,01201,5,1,4
2015,Enlisted,01301,21,5,16
2015,Enlisted,01434,53,13,40
2015,Enlisted,01440,10,1,9
2015,Enlisted,01453,9,1,8
2015,Enlisted,01588,12,2,10
2015,Enlisted,01605,50,11,39
2015,Enlisted,01702,4,0,4
2015,Enlisted,01731,7,4,3
2015,Enlisted,01760,16,3,13
2015,Enlisted,01844,22,2,20
2015,Enlisted,01867,49,1,48
2015,Enlisted,01923,3,1,2
2015,Enlisted,01950,16,1,15
2015,Enlisted,02043,38,3,35
2015,Enlisted,02122,22,1,21
2015,Enlisted,02138,28,7,21
2015,Enlisted,02169,11,1,10
2015,Enlisted,02176,40,8,32
2015,Enlisted,02184,25,3,22
2015,Enlisted,02301,7,1,6
2015,Enlisted,02324,5,0,5
2015,Enlisted,02346,22,1,21
2015,Enlisted,02420,8,1,7
2015,Enlisted,02465,2,2,0
2015,Enlisted,02532,28,3,25
2015,Enlisted,02542,70,17,53
2015,Enlisted,02724,6,3,3
2015,Enlisted,02769,17,2,15
2015,Enlisted,02780,24,5,19
2015,Enlisted,02809,2,0,2
2015,Enlisted,02818,92,16,76
2015,Enlisted,02842,5,5,0
2015,Enlisted,02852,25,4,21
2015,Enlisted,02885,13,0,13
2015,Enlisted,02886,10,4,6
2015,Enlisted,02896,2,0,2
2015,Enlisted,02904,24,2,22
2015,Enlisted,02920,4,3,1
2015,Enlisted,03055,41,11,30
2015,Enlisted,03060,10,2,8
2015,Enlisted,03101,45,8,37
2015,Enlisted,03235,6,0,6
2015,Enlisted,03244,13,2,11
2015,Enlisted,03301,31,7,24
2015,Enlisted,03570,11,2,9
2015,Enlisted,03766,52,3,49
2015,Enlisted,03801,5,1,4
2015,Enlisted,03815,1,0,1
2015,Enlisted,03878,24,8,16
2015,Enlisted,04011,9,1,8
2015,Enlisted,04073,4,0,4
2015,Enlisted,04092,12,3,9
2015,Enlisted,04103,22,7,15
2015,Enlisted,04240,13,1,12
2015,Enlisted,04268,12,1,11
2015,Enlisted,04330,6,3,3
2015,Enlisted,04333,4,3,1
2015,Enlisted,04345,8,2,6
2015,Enlisted,04401,45,12,33
2015,Enlisted,04412,28,8,20
2015,Enlisted,04619,3,1,2
2015,Enlisted,04730,4,0,4
2015,Enlisted,04736,2,1,1
2015,Enlisted,04901,11,1,10
2015,Enlisted,04915,5,1,4
2015,Enlisted,04976,12,1,11
2015,Enlisted,05001,17,4,13
2015,Enlisted,05033,7,1,6
2015,Enlisted,05158,15,5,10
2015,Enlisted,05201,6,2,4
2015,Enlisted,05403,16,4,12
2015,Enlisted,05404,3,0,3
2015,Enlisted,05446,16,7,9
2015,Enlisted,05465,58,18,40
2015,Enlisted,05478,9,1,8
2015,Enlisted,05488,11,2,9
2015,Enlisted,05491,6,0,6
2015,Enlisted,05495,12,2,10
2015,Enlisted,05602,5,3,2
2015,Enlisted,05661,8,0,8
2015,Enlisted,05663,30,5,25
2015,Enlisted,05676,11,3,8
2015,Enlisted,05701,5,3,2
2015,Enlisted,05851,18,5,13
2015,Enlisted,05855,5,1,4
2015,Enlisted,06051,27,10,17
2015,Enlisted,06066,6,0,6
2015,Enlisted,06082,25,8,17
2015,Enlisted,06096,40,7,33
2015,Enlisted,06105,2,2,0
2015,Enlisted,06110,26,4,22
2015,Enlisted,06320,60,4,56
2015,Enlisted,06333,3,0,3
2015,Enlisted,06340,26,5,21
2015,Enlisted,06357,19,3,16
2015,Enlisted,06360,16,1,15
2015,Enlisted,06457,76,11,65
2015,Enlisted,06489,20,1,19
2015,Enlisted,06498,24,4,20
2015,Enlisted,06512,26,6,20
2015,Enlisted,06614,17,1,16
2015,Enlisted,06702,3,0,3
2015,Enlisted,06810,42,15,27
2015,Enlisted,07052,120,14,106
2015,Enlisted,07090,19,4,15
2015,Enlisted,07095,30,8,22
2015,Enlisted,07107,26,0,26
2015,Enlisted,07306,55,10,45
2015,Enlisted,07457,30,3,27
2015,Enlisted,07666,50,6,44
2015,Enlisted,07728,30,9,21
2015,Enlisted,07801,9,1,8
2015,Enlisted,07840,5,1,4
2015,Enlisted,07865,55,11,44
2015,Enlisted,07960,68,12,56
2015,Enlisted,08002,3,3,0
2015,Enlisted,08016,29,4,25
2015,Enlisted,08060,23,4,19
2015,Enlisted,08087,5,2,3
2015,Enlisted,08096,36,8,28
2015,Enlisted,08098,13,5,8
2015,Enlisted,08210,23,2,21
2015,Enlisted,08360,31,3,28
2015,Enlisted,08401,10,4,6
2015,Enlisted,08533,3,0,3
2015,Enlisted,08628,26,4,22
2015,Enlisted,08640,17,9,8
2015,Enlisted,08648,7,2,5
2015,Enlisted,08733,32,5,27
2015,Enlisted,08750,44,8,36
2015,Enlisted,08753,22,2,20
2015,Enlisted,08759,3,0,3
2015,Enlisted,08822,25,3,22
2015,Enlisted,08873,45,8,37
2015,Enlisted,10010,108,21,87
2015,Enlisted,10037,7,2,5
2015,Enlisted,10314,56,5,51
2015,Enlisted,10468,14,3,11
2015,Enlisted,10566,23,5,18
2015,Enlisted,10567,65,23,42
2015,Enlisted,10701,30,7,23
2015,Enlisted,10962,20,8,12
2015,Enlisted,11225,1,1,0
2015,Enlisted,11252,104,15,89
2015,Enlisted,11357,31,2,29
2015,Enlisted,11433,85,13,72
2015,Enlisted,11735,79,13,66
2015,Enlisted,11779,28,4,24
2015,Enlisted,12078,23,2,21
2015,Enlisted,12110,55,13,42
2015,Enlisted,12180,32,7,25
2015,Enlisted,12189,11,8,3
2015,Enlisted,12302,57,13,44
2015,Enlisted,12401,18,2,16
2015,Enlisted,12451,17,6,11
2015,Enlisted,12553,21,5,16
2015,Enlisted,12804,24,5,19
2015,Enlisted,12962,10,3,7
2015,Enlisted,12983,7,3,4
2015,Enlisted,13021,16,1,15
2015,Enlisted,13211,36,13,23
2015,Enlisted,13501,66,20,46
2015,Enlisted,13602,31,11,20
2015,Enlisted,13669,7,3,4
2015,Enlisted,13856,6,1,5
2015,Enlisted,13905,19,4,15
2015,Enlisted,14048,11,0,11
2015,Enlisted,14094,11,1,10
2015,Enlisted,14204,67,6,61
2015,Enlisted,14213,47,6,41
2015,Enlisted,14304,27,8,19
2015,Enlisted,14454,24,6,18
2015,Enlisted,14456,24,2,22
2015,Enlisted,14624,100,27,73
2015,Enlisted,14701,17,2,15
2015,Enlisted,14760,5,3,2
2015,Enlisted,14843,9,1,8
2015,Enlisted,14845,16,4,12
2015,Enlisted,14850,12,3,9
2015,Enlisted,15010,31,5,26
2015,Enlisted,15216,40,5,35
2015,Enlisted,15301,40,8,32
2015,Enlisted,15370,19,2,17
2015,Enlisted,15425,24,5,19
2015,Enlisted,15537,5,0,5
2015,Enlisted,15541,17,1,16
2015,Enlisted,15601,14,3,11
2015,Enlisted,15666,27,5,22
2015,Enlisted,15701,10,3,7
2015,Enlisted,15767,13,3,10
2015,Enlisted,15779,4,1,3
2015,Enlisted,15902,50,6,44
2015,Enlisted,15904,89,7,82
2015,Enlisted,16001,34,8,26
2015,Enlisted,16101,19,6,13
2015,Enlisted,16127,3,0,3
2015,Enlisted,16148,13,1,12
2015,Enlisted,16226,12,2,10
2015,Enlisted,16301,10,2,8
2015,Enlisted,16403,59,9,50
2015,Enlisted,16635,18,3,15
2015,Enlisted,16652,6,1,5
2015,Enlisted,16735,2,0,2
2015,Enlisted,16738,16,2,14
2015,Enlisted,16803,24,7,17
2015,Enlisted,16830,33,4,29
2015,Enlisted,16901,6,0,6
2015,Enlisted,17003,283,35,248
2015,Enlisted,17013,24,3,21
2015,Enlisted,17022,28,4,24
2015,Enlisted,17033,23,3,20
2015,Enlisted,17042,44,3,41
2015,Enlisted,17044,21,6,15
2015,Enlisted,17098,8,3,5
2015,Enlisted,17103,56,15,41
2015,Enlisted,17201,13,1,12
2015,Enlisted,17222,6,0,6
2015,Enlisted,17325,3,1,2
2015,Enlisted,17331,9,1,8
2015,Enlisted,17404,7,0,7
2015,Enlisted,17701,29,4,25
2015,Enlisted,17745,45,4,41
2015,Enlisted,17821,47,8,39
2015,Enlisted,17837,10,4,6
2015,Enlisted,18040,28,10,18
2015,Enlisted,18102,20,2,18
2015,Enlisted,18201,20,5,15
2015,Enlisted,18235,20,2,18
2015,Enlisted,18252,8,0,8
2015,Enlisted,18301,9,2,7
2015,Enlisted,18407,12,3,9
2015,Enlisted,18431,17,2,15
2015,Enlisted,18466,5,0,5
2015,Enlisted,18509,49,7,42
2015,Enlisted,18634,23,4,19
2015,Enlisted,18643,8,0,8
2015,Enlisted,18651,24,2,22
2015,Enlisted,18704,108,10,98
2015,Enlisted,18834,18,0,18
2015,Enlisted,18960,21,2,19
2015,Enlisted,19044,36,15,21
2015,Enlisted,19090,1,1,0
2015,Enlisted,19103,7,2,5
2015,Enlisted,19104,17,1,16
2015,Enlisted,19153,6,1,5
2015,Enlisted,19154,204,34,170
2015,Enlisted,19320,34,3,31
2015,Enlisted,19460,25,6,19
2015,Enlisted,19462,36,5,31
2015,Enlisted,19475,19,0,19
2015,Enlisted,19526,12,1,11
2015,Enlisted,19530,24,2,22
2015,Enlisted,19605,24,0,24
2015,Enlisted,19701,1,0,1
2015,Enlisted,19706,32,5,27
2015,Enlisted,19711,10,1,9
2015,Enlisted,19720,14,4,10
2015,Enlisted,19804,26,5,21
2015,Enlisted,19808,8,1,7
2015,Enlisted,19930,1,1,0
2015,Enlisted,19939,21,2,19
2015,Enlisted,19947,27,0,27
2015,Enlisted,19973,28,2,26
2015,Enlisted,19977,10,1,9
2015,Enlisted,20003,113,33,80
2015,Enlisted,20112,43,11,32
2015,Enlisted,20175,12,4,8
2015,Enlisted,20186,13,1,12
2015,Enlisted,20373,49,7,42
2015,Enlisted,20623,10,1,9
2015,Enlisted,20646,5,2,3
2015,Enlisted,20653,9,1,8
2015,Enlisted,20708,90,27,63
2015,Enlisted,20770,14,6,8
2015,Enlisted,20882,13,4,9
2015,Enlisted,20904,31,12,19
2015,Enlisted,21010,57,18,39
2015,Enlisted,21012,1,1,0
2015,Enlisted,21043,12,2,10
2015,Enlisted,21057,12,3,9
2015,Enlisted,21061,25,12,13
2015,Enlisted,21078,16,5,11
2015,Enlisted,21136,23,8,15
2015,Enlisted,21201,4,4,0
2015,Enlisted,21204,53,22,31
2015,Enlisted,21208,39,7,32
2015,Enlisted,21216,27,7,20
2015,Enlisted,21228,18,4,14
2015,Enlisted,21236,24,9,15
2015,Enlisted,21401,8,6,2
2015,Enlisted,21502,9,3,6
2015,Enlisted,21601,2,0,2
2015,Enlisted,21701,17,8,9
2015,Enlisted,21719,29,8,21
2015,Enlisted,21740,10,4,6
2015,Enlisted,21801,15,1,14
2015,Enlisted,21921,14,6,8
2015,Enlisted,22032,28,22,6
2015,Enlisted,22060,36,9,27
2015,Enlisted,22401,67,13,54
2015,Enlisted,22427,18,4,14
2015,Enlisted,22601,36,10,26
2015,Enlisted,22664,6,1,5
2015,Enlisted,22731,11,3,8
2015,Enlisted,22801,25,2,23
2015,Enlisted,22902,20,10,10
2015,Enlisted,23069,3,1,2
2015,Enlisted,23139,17,2,15
2015,Enlisted,23150,68,21,47
2015,Enlisted,23181,10,2,8
2015,Enlisted,23237,13,1,12
2015,Enlisted,23434,15,1,14
2015,Enlisted,23451,69,20,49
2015,Enlisted,23502,51,14,37
2015,Enlisted,23666,27,6,21
2015,Enlisted,23701,31,6,25
2015,Enlisted,23805,20,4,16
2015,Enlisted,23824,47,19,28
2015,Enlisted,23847,11,1,10
2015,Enlisted,23851,7,2,5
2015,Enlisted,23901,12,2,10
2015,Enlisted,24073,17,3,14
2015,Enlisted,24112,9,2,7
2015,Enlisted,24151,20,2,18
2015,Enlisted,24210,6,2,4
2015,Enlisted,24251,25,2,23
2015,Enlisted,24301,14,2,12
2015,Enlisted,24401,13,1,12
2015,Enlisted,24422,14,1,13
2015,Enlisted,24450,11,1,10
2015,Enlisted,24502,48,13,35
2015,Enlisted,24523,11,4,7
2015,Enlisted,24531,7,1,6
2015,Enlisted,24541,10,2,8
2015,Enlisted,24592,10,0,10
2015,Enlisted,24609,20,3,17
2015,Enlisted,24701,32,11,21
2015,Enlisted,24801,5,1,4
2015,Enlisted,24957,9,2,7
2015,Enlisted,25064,3,0,3
2015,Enlisted,25168,68,13,55
2015,Enlisted,25177,3,3,0
2015,Enlisted,25262,4,0,4
2015,Enlisted,25309,2,0,2
2015,Enlisted,25311,5,4,1
2015,Enlisted,25401,21,2,19
2015,Enlisted,25530,41,19,22
2015,Enlisted,25550,8,3,5
2015,Enlisted,25601,8,3,5
2015,Enlisted,25661,24,2,22
2015,Enlisted,25704,12,1,11
2015,Enlisted,25846,53,7,46
2015,Enlisted,26003,11,3,8
2015,Enlisted,26041,30,5,25
2015,Enlisted,26101,14,0,14
2015,Enlisted,26187,17,6,11
2015,Enlisted,26201,21,5,16
2015,Enlisted,26241,13,0,13
2015,Enlisted,26250,4,1,3
2015,Enlisted,26301,17,2,15
2015,Enlisted,26426,15,1,14
2015,Enlisted,26452,5,0,5
2015,Enlisted,26505,12,5,7
2015,Enlisted,26537,41,23,18
2015,Enlisted,26554,16,3,13
2015,Enlisted,26624,13,5,8
2015,Enlisted,26651,10,0,10
2015,Enlisted,26726,8,0,8
2015,Enlisted,26836,10,0,10
2015,Enlisted,27028,19,4,15
2015,Enlisted,27030,9,0,9
2015,Enlisted,27103,67,15,52
2015,Enlisted,27204,8,3,5
2015,Enlisted,27217,13,6,7
2015,Enlisted,27260,13,4,9
2015,Enlisted,27264,1,0,1
2015,Enlisted,27292,15,1,14
2015,Enlisted,27320,14,3,11
2015,Enlisted,27344,15,2,13
2015,Enlisted,27360,12,5,7
2015,Enlisted,27401,28,11,17
2015,Enlisted,27504,41,12,29
2015,Enlisted,27509,32,2,30
2015,Enlisted,27515,4,2,2
2015,Enlisted,27530,27,6,21
2015,Enlisted,27549,10,2,8
2015,Enlisted,27560,83,30,53
2015,Enlisted,27573,30,5,25
2015,Enlisted,27577,21,11,10
2015,Enlisted,27581,6,2,4
2015,Enlisted,27596,2,2,0
2015,Enlisted,27607,14,12,2
2015,Enlisted,27704,22,8,14
2015,Enlisted,27803,10,4,6
2015,Enlisted,27828,4,1,3
2015,Enlisted,27830,1,0,1
2015,Enlisted,27856,10,5,5
2015,Enlisted,27870,4,3,1
2015,Enlisted,27874,4,0,4
2015,Enlisted,27886,5,2,3
2015,Enlisted,27889,13,7,6
2015,Enlisted,27892,4,1,3
2015,Enlisted,27909,4,0,4
2015,Enlisted,27932,3,1,2
2015,Enlisted,28001,15,14,1
2015,Enlisted,28012,12,4,8
2015,Enlisted,28027,39,5,34
2015,Enlisted,28043,12,1,11
2015,Enlisted,28054,27,6,21
2015,Enlisted,28086,18,2,16
2015,Enlisted,28092,5,1,4
2015,Enlisted,28110,25,1,24
2015,Enlisted,28115,2,1,1
2015,Enlisted,28147,12,3,9
2015,Enlisted,28170,15,2,13
2015,Enlisted,28208,47,17,30
2015,Enlisted,28306,43,23,20
2015,Enlisted,28310,17,10,7
2015,Enlisted,28328,12,6,6
2015,Enlisted,28334,17,7,10
2015,Enlisted,28337,8,0,8
2015,Enlisted,28345,14,5,9
2015,Enlisted,28352,34,4,30
2015,Enlisted,28359,20,12,8
2015,Enlisted,28365,7,1,6
2015,Enlisted,28371,18,2,16
2015,Enlisted,28376,29,13,16
2015,Enlisted,28377,34,9,25
2015,Enlisted,28379,26,1,25
2015,Enlisted,28382,4,3,1
2015,Enlisted,28384,15,3,12
2015,Enlisted,28387,5,2,3
2015,Enlisted,28388,10,0,10
2015,Enlisted,28401,12,4,8
2015,Enlisted,28405,21,12,9
2015,Enlisted,28439,8,0,8
2015,Enlisted,28470,6,2,4
2015,Enlisted,28472,15,5,10
2015,Enlisted,28504,17,5,12
2015,Enlisted,28518,7,2,5
2015,Enlisted,28540,11,5,6
2015,Enlisted,28560,10,3,7
2015,Enlisted,28577,2,2,0
2015,Enlisted,28580,6,2,4
2015,Enlisted,28590,31,8,23
2015,Enlisted,28601,15,4,11
2015,Enlisted,28607,20,2,18
2015,Enlisted,28621,6,1,5
2015,Enlisted,28645,8,1,7
2015,Enlisted,28655,11,2,9
2015,Enlisted,28658,8,0,8
2015,Enlisted,28659,15,2,13
2015,Enlisted,28677,1,1,0
2015,Enlisted,28681,12,3,9
2015,Enlisted,28721,26,1,25
2015,Enlisted,28726,26,4,22
2015,Enlisted,28734,15,2,13
2015,Enlisted,28752,11,2,9
2015,Enlisted,28779,10,2,8
2015,Enlisted,28806,23,9,14
2015,Enlisted,28906,4,0,4
2015,Enlisted,29006,3,1,2
2015,Enlisted,29020,19,4,15
2015,Enlisted,29044,107,22,85
2015,Enlisted,29102,2,0,2
2015,Enlisted,29108,23,3,20
2015,Enlisted,29115,6,1,5
2015,Enlisted,29138,34,4,30
2015,Enlisted,29151,8,2,6
2015,Enlisted,29161,30,2,28
2015,Enlisted,29170,43,4,39
2015,Enlisted,29201,7,7,0
2015,Enlisted,29303,11,3,8
2015,Enlisted,29325,6,1,5
2015,Enlisted,29341,24,7,17
2015,Enlisted,29360,31,5,26
2015,Enlisted,29379,34,4,30
2015,Enlisted,29385,16,2,14
2015,Enlisted,29403,25,8,17
2015,Enlisted,29418,30,5,25
2015,Enlisted,29440,4,0,4
2015,Enlisted,29461,36,9,27
2015,Enlisted,29465,28,0,28
2015,Enlisted,29483,63,10,53
2015,Enlisted,29488,13,5,8
2015,Enlisted,29506,13,4,9
2015,Enlisted,29510,6,0,6
2015,Enlisted,29512,30,5,25
2015,Enlisted,29526,16,4,12
2015,Enlisted,29532,10,3,7
2015,Enlisted,29536,11,0,11
2015,Enlisted,29544,3,1,2
2015,Enlisted,29550,11,0,11
2015,Enlisted,29556,26,5,21
2015,Enlisted,29571,19,5,14
2015,Enlisted,29574,34,8,26
2015,Enlisted,29577,11,0,11
2015,Enlisted,29605,36,5,31
2015,Enlisted,29620,21,1,20
2015,Enlisted,29625,49,11,38
2015,Enlisted,29631,22,5,17
2015,Enlisted,29641,4,0,4
2015,Enlisted,29644,36,8,28
2015,Enlisted,29646,18,2,16
2015,Enlisted,29651,34,12,22
2015,Enlisted,29653,40,4,36
2015,Enlisted,29706,2,1,1
2015,Enlisted,29715,13,2,11
2015,Enlisted,29720,18,2,16
2015,Enlisted,29732,21,1,20
2015,Enlisted,29810,8,3,5
2015,Enlisted,29812,7,1,6
2015,Enlisted,29824,30,7,23
2015,Enlisted,29829,30,7,23
2015,Enlisted,29835,15,1,14
2015,Enlisted,29906,24,6,18
2015,Enlisted,29944,6,1,5
2015,Enlisted,30014,24,3,21
2015,Enlisted,30032,19,5,14
2015,Enlisted,30040,73,22,51
2015,Enlisted,30045,15,5,10
2015,Enlisted,30046,11,5,6
2015,Enlisted,30060,98,21,77
2015,Enlisted,30069,113,30,83
2015,Enlisted,30114,24,8,16
2015,Enlisted,30125,17,1,16
2015,Enlisted,30134,26,3,23
2015,Enlisted,30144,62,21,41
2015,Enlisted,30161,22,6,16
2015,Enlisted,30162,11,1,10
2015,Enlisted,30224,20,4,16
2015,Enlisted,30233,19,4,15
2015,Enlisted,30240,17,7,10
2015,Enlisted,30241,19,2,17
2015,Enlisted,30263,32,8,24
2015,Enlisted,30294,34,10,24
2015,Enlisted,30297,38,15,23
2015,Enlisted,30336,42,13,29
2015,Enlisted,30401,11,2,9
2015,Enlisted,30427,15,7,8
2015,Enlisted,30439,38,6,32
2015,Enlisted,30461,25,7,18
2015,Enlisted,30501,18,2,16
2015,Enlisted,30577,4,2,2
2015,Enlisted,30597,1,0,1
2015,Enlisted,30635,16,5,11
2015,Enlisted,30643,18,2,16
2015,Enlisted,30655,22,2,20
2015,Enlisted,30673,14,5,9
2015,Enlisted,30680,66,18,48
2015,Enlisted,30701,48,10,38
2015,Enlisted,30720,18,2,16
2015,Enlisted,30824,6,0,6
2015,Enlisted,30830,6,0,6
2015,Enlisted,30904,54,11,43
2015,Enlisted,30905,53,11,42
2015,Enlisted,31015,18,4,14
2015,Enlisted,31021,5,2,3
2015,Enlisted,31029,35,8,27
2015,Enlisted,31040,24,1,23
2015,Enlisted,31061,18,2,16
2015,Enlisted,31211,74,17,57
2015,Enlisted,31313,10,1,9
2015,Enlisted,31314,56,21,35
2015,Enlisted,31329,7,4,3
2015,Enlisted,31406,54,16,38
2015,Enlisted,31409,22,8,14
2015,Enlisted,31416,17,4,13
2015,Enlisted,31520,3,2,1
2015,Enlisted,31533,15,1,14
2015,Enlisted,31601,12,6,6
2015,Enlisted,31701,17,0,17
2015,Enlisted,31719,1,0,1
2015,Enlisted,31792,33,4,29
2015,Enlisted,31794,5,1,4
2015,Enlisted,31901,36,10,26
2015,Enlisted,31905,10,4,6
2015,Enlisted,32055,12,5,7
2015,Enlisted,32064,17,4,13
2015,Enlisted,32084,20,2,18
2015,Enlisted,32085,1,1,0
2015,Enlisted,32086,5,5,0
2015,Enlisted,32091,133,49,84
2015,Enlisted,32114,19,4,15
2015,Enlisted,32164,6,1,5
2015,Enlisted,32177,8,0,8
2015,Enlisted,32221,168,54,114
2015,Enlisted,32311,40,14,26
2015,Enlisted,32351,22,1,21
2015,Enlisted,32406,16,8,8
2015,Enlisted,32425,14,2,12
2015,Enlisted,32428,13,3,10
2015,Enlisted,32447,18,6,12
2015,Enlisted,32514,33,14,19
2015,Enlisted,32536,11,2,9
2015,Enlisted,32609,21,5,16
2015,Enlisted,32724,7,2,5
2015,Enlisted,32727,11,5,6
2015,Enlisted,32771,23,5,18
2015,Enlisted,32806,52,28,24
2015,Enlisted,32827,13,0,13
2015,Enlisted,32924,35,14,21
2015,Enlisted,32935,36,8,28
2015,Enlisted,33020,28,7,21
2015,Enlisted,33024,3,1,2
2015,Enlisted,33025,45,10,35
2015,Enlisted,33039,2,1,1
2015,Enlisted,33092,5,2,3
2015,Enlisted,33127,72,23,49
2015,Enlisted,33315,45,6,39
2015,Enlisted,33405,25,7,18
2015,Enlisted,33406,32,6,26
2015,Enlisted,33523,19,6,13
2015,Enlisted,33563,3,0,3
2015,Enlisted,33567,1,0,1
2015,Enlisted,33606,20,5,15
2015,Enlisted,33621,2,2,0
2015,Enlisted,33711,14,5,9
2015,Enlisted,33782,94,27,67
2015,Enlisted,33811,22,7,15
2015,Enlisted,33825,2,0,2
2015,Enlisted,33830,15,6,9
2015,Enlisted,33844,12,2,10
2015,Enlisted,33859,8,1,7
2015,Enlisted,33873,5,4,1
2015,Enlisted,33880,17,4,13
2015,Enlisted,33916,8,0,8
2015,Enlisted,34142,32,7,25
2015,Enlisted,34208,11,1,10
2015,Enlisted,34221,4,0,4
2015,Enlisted,34237,18,3,15
2015,Enlisted,34266,6,1,5
2015,Enlisted,34429,34,4,30
2015,Enlisted,34474,27,20,7
2015,Enlisted,34604,6,3,3
2015,Enlisted,34748,13,11,2
2015,Enlisted,34947,20,0,20
2015,Enlisted,35010,20,3,17
2015,Enlisted,35016,3,1,2
2015,Enlisted,35040,13,0,13
2015,Enlisted,35042,17,4,13
2015,Enlisted,35055,21,3,18
2015,Enlisted,35072,11,1,10
2015,Enlisted,35121,26,6,20
2015,Enlisted,35124,24,5,19
2015,Enlisted,35146,7,0,7
2015,Enlisted,35150,3,0,3
2015,Enlisted,35161,45,14,31
2015,Enlisted,35178,6,4,2
2015,Enlisted,35209,28,5,23
2015,Enlisted,35217,44,6,38
2015,Enlisted,35259,8,0,8
2015,Enlisted,35405,19,8,11
2015,Enlisted,35442,8,1,7
2015,Enlisted,35476,13,0,13
2015,Enlisted,35501,15,3,12
2015,Enlisted,35555,18,2,16
2015,Enlisted,35565,26,4,22
2015,Enlisted,35592,3,1,2
2015,Enlisted,35594,10,0,10
2015,Enlisted,35601,26,6,20
2015,Enlisted,35613,22,1,21
2015,Enlisted,35630,29,6,23
2015,Enlisted,35660,19,4,15
2015,Enlisted,35710,11,5,6
2015,Enlisted,35768,19,1,18
2015,Enlisted,35803,22,4,18
2015,Enlisted,35805,39,8,31
2015,Enlisted,35904,14,7,7
2015,Enlisted,35950,3,1,2
2015,Enlisted,35967,9,4,5
2015,Enlisted,36009,2,0,2
2015,Enlisted,36010,17,3,14
2015,Enlisted,36016,9,1,8
2015,Enlisted,36032,6,0,6
2015,Enlisted,36043,24,5,19
2015,Enlisted,36067,24,2,22
2015,Enlisted,36072,5,2,3
2015,Enlisted,36078,29,2,27
2015,Enlisted,36081,12,5,7
2015,Enlisted,36083,4,2,2
2015,Enlisted,36109,35,7,28
2015,Enlisted,36117,1,1,0
2015,Enlisted,36121,6,3,3
2015,Enlisted,36203,16,2,14
2015,Enlisted,36205,16,6,10
2015,Enlisted,36250,3,0,3
2015,Enlisted,36251,9,4,5
2015,Enlisted,36265,27,5,22
2015,Enlisted,36301,20,4,16
2015,Enlisted,36302,3,1,2
2015,Enlisted,36322,23,5,18
2015,Enlisted,36323,4,1,3
2015,Enlisted,36330,15,2,13
2015,Enlisted,36331,8,1,7
2015,Enlisted,36340,13,2,11
2015,Enlisted,36344,4,0,4
2015,Enlisted,36421,13,0,13
2015,Enlisted,36426,9,0,9
2015,Enlisted,36442,7,0,7
2015,Enlisted,36460,13,1,12
2015,Enlisted,36502,12,1,11
2015,Enlisted,36532,12,5,7
2015,Enlisted,36535,5,3,2
2015,Enlisted,36545,8,3,5
2015,Enlisted,36605,56,9,47
2015,Enlisted,36608,10,1,9
2015,Enlisted,36701,2,0,2
2015,Enlisted,36726,9,1,8
2015,Enlisted,36732,10,0,10
2015,Enlisted,36748,3,0,3
2015,Enlisted,36756,4,1,3
2015,Enlisted,36801,20,1,19
2015,Enlisted,36832,19,4,15
2015,Enlisted,36854,20,6,14
2015,Enlisted,36867,8,1,7
2015,Enlisted,37015,6,2,4
2015,Enlisted,37033,14,4,10
2015,Enlisted,37042,13,12,1
2015,Enlisted,37056,20,8,12
2015,Enlisted,37066,13,3,10
2015,Enlisted,37083,12,2,10
2015,Enlisted,37090,29,13,16
2015,Enlisted,37091,6,2,4
2015,Enlisted,37097,9,6,3
2015,Enlisted,37110,31,7,24
2015,Enlisted,37129,33,9,24
2015,Enlisted,37160,6,4,2
2015,Enlisted,37167,97,27,70
2015,Enlisted,37172,16,8,8
2015,Enlisted,37178,2,2,0
2015,Enlisted,37185,5,3,2
2015,Enlisted,37204,88,35,53
2015,Enlisted,37217,11,2,9
2015,Enlisted,37303,8,4,4
2015,Enlisted,37321,3,2,1
2015,Enlisted,37323,13,4,9
2015,Enlisted,37327,12,3,9
2015,Enlisted,37334,3,0,3
2015,Enlisted,37356,10,5,5
2015,Enlisted,37388,33,13,20
2015,Enlisted,37398,6,4,2
2015,Enlisted,37404,37,9,28
2015,Enlisted,37615,20,10,10
2015,Enlisted,37620,6,0,6
2015,Enlisted,37644,12,1,11
2015,Enlisted,37645,14,6,8
2015,Enlisted,37650,7,2,5
2015,Enlisted,37683,7,1,6
2015,Enlisted,37717,7,2,5
2015,Enlisted,37743,14,6,8
2015,Enlisted,37757,6,3,3
2015,Enlisted,37760,8,2,6
2015,Enlisted,37771,21,6,15
2015,Enlisted,37777,6,2,4
2015,Enlisted,37801,7,1,6
2015,Enlisted,37821,18,7,11
2015,Enlisted,37825,9,3,6
2015,Enlisted,37841,3,1,2
2015,Enlisted,37854,8,2,6
2015,Enlisted,37857,1,1,0
2015,Enlisted,37860,11,4,7
2015,Enlisted,37863,8,3,5
2015,Enlisted,37874,12,2,10
2015,Enlisted,37919,33,11,22
2015,Enlisted,37939,24,11,13
2015,Enlisted,38001,14,5,9
2015,Enlisted,38008,8,0,8
2015,Enlisted,38012,18,7,11
2015,Enlisted,38019,3,2,1
2015,Enlisted,38024,6,2,4
2015,Enlisted,38053,31,10,21
2015,Enlisted,38063,9,2,7
2015,Enlisted,38079,5,1,4
2015,Enlisted,38118,29,7,22
2015,Enlisted,38201,3,3,0
2015,Enlisted,38225,5,3,2
2015,Enlisted,38242,8,4,4
2015,Enlisted,38261,12,4,8
2015,Enlisted,38301,13,2,11
2015,Enlisted,38302,16,2,14
2015,Enlisted,38320,6,4,2
2015,Enlisted,38340,15,2,13
2015,Enlisted,38343,12,3,9
2015,Enlisted,38344,12,4,8
2015,Enlisted,38351,12,3,9
2015,Enlisted,38358,5,2,3
2015,Enlisted,38363,6,1,5
2015,Enlisted,38372,3,1,2
2015,Enlisted,38375,4,4,0
2015,Enlisted,38382,18,2,16
2015,Enlisted,38401,11,5,6
2015,Enlisted,38462,7,4,3
2015,Enlisted,38464,12,2,10
2015,Enlisted,38478,3,1,2
2015,Enlisted,38485,15,9,6
2015,Enlisted,38506,27,11,16
2015,Enlisted,38556,21,5,16
2015,Enlisted,38563,5,3,2
2015,Enlisted,38570,6,0,6
2015,Enlisted,38572,7,1,6
2015,Enlisted,38583,10,0,10
2015,Enlisted,38606,24,2,22
2015,Enlisted,38614,14,0,14
2015,Enlisted,38632,16,2,14
2015,Enlisted,38635,10,3,7
2015,Enlisted,38655,5,0,5
2015,Enlisted,38663,7,0,7
2015,Enlisted,38668,27,3,24
2015,Enlisted,38671,36,4,32
2015,Enlisted,38701,24,0,24
2015,Enlisted,38732,10,2,8
2015,Enlisted,38737,14,0,14
2015,Enlisted,38751,10,2,8
2015,Enlisted,38801,40,2,38
2015,Enlisted,38803,16,2,14
2015,Enlisted,38821,2,0,2
2015,Enlisted,38829,14,2,12
2015,Enlisted,38834,8,0,8
2015,Enlisted,38835,9,1,8
2015,Enlisted,38843,5,1,4
2015,Enlisted,38851,19,0,19
2015,Enlisted,38852,5,0,5
2015,Enlisted,38858,9,1,8
2015,Enlisted,38860,8,0,8
2015,Enlisted,38863,17,2,15
2015,Enlisted,38901,9,4,5
2015,Enlisted,38902,16,0,16
2015,Enlisted,38915,17,3,14
2015,Enlisted,38916,12,1,11
2015,Enlisted,38921,9,1,8
2015,Enlisted,38926,1,0,1
2015,Enlisted,38935,12,3,9
2015,Enlisted,38965,13,0,13
2015,Enlisted,38967,9,0,9
2015,Enlisted,39043,31,7,24
2015,Enlisted,39046,15,2,13
2015,Enlisted,39051,15,2,13
2015,Enlisted,39059,12,4,8
2015,Enlisted,39060,34,5,29
2015,Enlisted,39074,9,4,5
2015,Enlisted,39090,4,0,4
2015,Enlisted,39111,13,3,10
2015,Enlisted,39114,20,1,19
2015,Enlisted,39117,11,1,10
2015,Enlisted,39120,5,0,5
2015,Enlisted,39159,9,1,8
2015,Enlisted,39168,13,0,13
2015,Enlisted,39183,29,4,25
2015,Enlisted,39194,4,1,3
2015,Enlisted,39202,2,2,0
2015,Enlisted,39204,41,9,32
2015,Enlisted,39209,20,1,19
2015,Enlisted,39216,22,7,15
2015,Enlisted,39296,17,4,13
2015,Enlisted,39307,11,3,8
2015,Enlisted,39328,8,1,7
2015,Enlisted,39339,5,1,4
2015,Enlisted,39345,27,3,24
2015,Enlisted,39350,17,0,17
2015,Enlisted,39355,12,3,9
2015,Enlisted,39367,13,0,13
2015,Enlisted,39403,4,0,4
2015,Enlisted,39407,66,5,61
2015,Enlisted,39422,5,0,5
2015,Enlisted,39429,11,2,9
2015,Enlisted,39440,8,3,5
2015,Enlisted,39452,12,1,11
2015,Enlisted,39455,3,0,3
2015,Enlisted,39466,10,1,9
2015,Enlisted,39470,30,7,23
2015,Enlisted,39475,8,0,8
2015,Enlisted,39476,9,0,9
2015,Enlisted,39501,15,2,13
2015,Enlisted,39505,19,9,10
2015,Enlisted,39507,29,2,27
2015,Enlisted,39532,28,5,23
2015,Enlisted,39556,9,3,6
2015,Enlisted,39567,10,1,9
2015,Enlisted,39577,3,0,3
2015,Enlisted,39601,24,2,22
2015,Enlisted,39638,4,0,4
2015,Enlisted,39648,22,3,19
2015,Enlisted,39654,9,0,9
2015,Enlisted,39667,10,1,9
2015,Enlisted,39704,3,0,3
2015,Enlisted,39730,12,0,12
2015,Enlisted,39735,5,0,5
2015,Enlisted,39744,12,2,10
2015,Enlisted,39760,15,0,15
2015,Enlisted,39773,11,0,11
2015,Enlisted,40004,3,0,3
2015,Enlisted,40065,8,0,8
2015,Enlisted,40069,9,3,6
2015,Enlisted,40205,4,4,0
2015,Enlisted,40209,19,1,18
2015,Enlisted,40213,8,4,4
2015,Enlisted,40218,20,4,16
2015,Enlisted,40311,4,0,4
2015,Enlisted,40330,5,1,4
2015,Enlisted,40351,12,0,12
2015,Enlisted,40422,7,0,7
2015,Enlisted,40472,18,3,15
2015,Enlisted,40475,61,14,47
2015,Enlisted,40510,32,3,29
2015,Enlisted,40601,56,7,49
2015,Enlisted,40741,24,3,21
2015,Enlisted,40769,11,2,9
2015,Enlisted,40831,11,0,11
2015,Enlisted,40906,10,1,9
2015,Enlisted,40965,19,1,18
2015,Enlisted,41005,89,6,83
2015,Enlisted,41008,2,0,2
2015,Enlisted,41031,8,0,8
2015,Enlisted,41056,8,1,7
2015,Enlisted,41094,16,1,15
2015,Enlisted,41101,12,1,11
2015,Enlisted,41164,19,2,17
2015,Enlisted,41339,8,0,8
2015,Enlisted,41653,17,2,15
2015,Enlisted,41701,7,2,5
2015,Enlisted,42025,15,5,10
2015,Enlisted,42064,2,0,2
2015,Enlisted,42071,35,1,34
2015,Enlisted,42086,21,3,18
2015,Enlisted,42101,17,4,13
2015,Enlisted,42141,21,1,20
2015,Enlisted,42167,13,1,12
2015,Enlisted,42240,1,1,0
2015,Enlisted,42276,3,2,1
2015,Enlisted,42301,15,3,12
2015,Enlisted,42330,19,3,16
2015,Enlisted,42345,11,4,7
2015,Enlisted,42420,4,0,4
2015,Enlisted,42431,5,2,3
2015,Enlisted,42501,16,1,15
2015,Enlisted,42633,9,0,9
2015,Enlisted,42701,32,1,31
2015,Enlisted,42718,9,2,7
2015,Enlisted,42754,8,2,6
2015,Enlisted,43015,27,3,24
2015,Enlisted,43040,49,4,45
2015,Enlisted,43055,42,5,37
2015,Enlisted,43102,17,3,14
2015,Enlisted,43213,133,13,120
2015,Enlisted,43217,63,15,48
2015,Enlisted,43228,15,3,12
2015,Enlisted,43235,1,1,0
2015,Enlisted,43302,19,1,18
2015,Enlisted,43402,34,4,30
2015,Enlisted,43452,1,1,0
2015,Enlisted,43465,134,16,118
2015,Enlisted,43614,44,4,40
2015,Enlisted,43756,50,2,48
2015,Enlisted,43812,30,2,28
2015,Enlisted,44023,37,2,35
2015,Enlisted,44055,15,4,11
2015,Enlisted,44128,75,14,61
2015,Enlisted,44142,21,1,20
2015,Enlisted,44224,83,12,71
2015,Enlisted,44256,62,4,58
2015,Enlisted,44313,12,0,12
2015,Enlisted,44444,60,6,54
2015,Enlisted,44515,65,4,61
2015,Enlisted,44601,9,2,7
2015,Enlisted,44622,13,0,13
2015,Enlisted,44691,14,0,14
2015,Enlisted,44720,112,13,99
2015,Enlisted,44857,18,1,17
2015,Enlisted,44870,28,7,21
2015,Enlisted,44883,35,6,29
2015,Enlisted,44903,40,4,36
2015,Enlisted,45015,40,4,36
2015,Enlisted,45036,13,1,12
2015,Enlisted,45044,18,1,17
2015,Enlisted,45215,52,1,51
2015,Enlisted,45331,13,3,10
2015,Enlisted,45346,49,1,48
2015,Enlisted,45356,25,1,24
2015,Enlisted,45385,3,0,3
2015,Enlisted,45430,43,1,42
2015,Enlisted,45502,19,1,18
2015,Enlisted,45505,32,2,30
2015,Enlisted,45601,39,1,38
2015,Enlisted,45662,22,2,20
2015,Enlisted,45804,43,0,43
2015,Enlisted,45885,18,4,14
2015,Enlisted,46012,17,3,14
2015,Enlisted,46036,5,1,4
2015,Enlisted,46041,8,2,6
2015,Enlisted,46052,15,3,12
2015,Enlisted,46122,18,2,16
2015,Enlisted,46124,27,7,20
2015,Enlisted,46131,142,18,124
2015,Enlisted,46135,6,1,5
2015,Enlisted,46140,4,1,3
2015,Enlisted,46151,32,9,23
2015,Enlisted,46176,54,12,42
2015,Enlisted,46208,10,4,6
2015,Enlisted,46216,57,10,47
2015,Enlisted,46241,143,28,115
2015,Enlisted,46323,12,1,11
2015,Enlisted,46350,26,1,25
2015,Enlisted,46383,22,6,16
2015,Enlisted,46402,28,2,26
2015,Enlisted,46406,23,5,18
2015,Enlisted,46517,12,1,11
2015,Enlisted,46563,19,2,17
2015,Enlisted,46580,13,3,10
2015,Enlisted,46613,30,4,26
2015,Enlisted,46703,13,5,8
2015,Enlisted,46714,9,3,6
2015,Enlisted,46750,11,0,11
2015,Enlisted,46809,1,1,0
2015,Enlisted,46825,42,7,35
2015,Enlisted,46901,3,0,3
2015,Enlisted,46947,22,0,22
2015,Enlisted,46953,17,4,13
2015,Enlisted,46970,1,1,0
2015,Enlisted,47150,39,4,35
2015,Enlisted,47167,10,1,9
2015,Enlisted,47170,5,0,5
2015,Enlisted,47203,10,2,8
2015,Enlisted,47250,20,5,15
2015,Enlisted,47265,8,1,7
2015,Enlisted,47274,29,6,23
2015,Enlisted,47303,6,1,5
2015,Enlisted,47331,6,2,4
2015,Enlisted,47348,17,2,15
2015,Enlisted,47374,6,1,5
2015,Enlisted,47394,31,2,29
2015,Enlisted,47401,35,4,31
2015,Enlisted,47421,9,2,7
2015,Enlisted,47441,24,6,18
2015,Enlisted,47501,24,7,17
2015,Enlisted,47546,49,9,40
2015,Enlisted,47591,6,1,5
2015,Enlisted,47715,94,8,86
2015,Enlisted,47804,19,3,16
2015,Enlisted,47834,10,0,10
2015,Enlisted,47872,11,1,10
2015,Enlisted,47905,64,9,55
2015,Enlisted,47933,12,4,8
2015,Enlisted,47960,4,1,3
2015,Enlisted,47977,10,2,8
2015,Enlisted,47978,7,0,7
2015,Enlisted,48060,6,2,4
2015,Enlisted,48180,46,12,34
2015,Enlisted,48197,91,11,80
2015,Enlisted,48208,26,5,21
2015,Enlisted,48234,39,10,29
2015,Enlisted,48341,33,7,26
2015,Enlisted,48446,9,0,9
2015,Enlisted,48601,54,13,41
2015,Enlisted,48640,7,1,6
2015,Enlisted,48642,2,0,2
2015,Enlisted,48706,13,0,13
2015,Enlisted,48801,9,1,8
2015,Enlisted,48817,44,2,42
2015,Enlisted,48837,68,10,58
2015,Enlisted,48838,14,1,13
2015,Enlisted,48843,25,9,16
2015,Enlisted,48906,18,8,10
2015,Enlisted,48912,13,5,8
2015,Enlisted,49009,27,8,19
2015,Enlisted,49012,37,5,32
2015,Enlisted,49047,23,6,17
2015,Enlisted,49091,2,1,1
2015,Enlisted,49201,5,2,3
2015,Enlisted,49202,10,3,7
2015,Enlisted,49221,1,1,0
2015,Enlisted,49224,10,2,8
2015,Enlisted,49306,5,1,4
2015,Enlisted,49307,13,1,12
2015,Enlisted,49437,12,2,10
2015,Enlisted,49509,136,34,102
2015,Enlisted,49601,19,3,16
2015,Enlisted,49660,17,6,11
2015,Enlisted,49707,7,2,5
2015,Enlisted,49721,20,1,19
2015,Enlisted,49739,79,19,60
2015,Enlisted,49783,21,1,20
2015,Enlisted,49802,1,0,1
2015,Enlisted,49837,15,3,12
2015,Enlisted,49849,13,1,12
2015,Enlisted,49908,3,0,3
2015,Enlisted,49913,4,0,4
2015,Enlisted,49935,4,2,2
2015,Enlisted,50025,5,1,4
2015,Enlisted,50036,36,1,35
2015,Enlisted,50126,19,3,16
2015,Enlisted,50131,213,34,179
2015,Enlisted,50138,9,0,9
2015,Enlisted,50158,13,0,13
2015,Enlisted,50220,9,0,9
2015,Enlisted,50321,1,1,0
2015,Enlisted,50401,12,2,10
2015,Enlisted,50501,21,0,21
2015,Enlisted,50511,27,2,25
2015,Enlisted,50588,13,2,11
2015,Enlisted,50616,9,3,6
2015,Enlisted,50662,17,3,14
2015,Enlisted,50703,45,7,38
2015,Enlisted,50841,20,2,18
2015,Enlisted,51031,15,0,15
2015,Enlisted,51111,38,5,33
2015,Enlisted,51201,13,0,13
2015,Enlisted,51301,3,0,3
2015,Enlisted,51334,4,2,2
2015,Enlisted,51401,9,0,9
2015,Enlisted,51442,12,2,10
2015,Enlisted,51503,26,7,19
2015,Enlisted,51566,5,1,4
2015,Enlisted,51601,15,2,13
2015,Enlisted,52002,21,4,17
2015,Enlisted,52246,50,2,48
2015,Enlisted,52353,12,1,11
2015,Enlisted,52404,50,3,47
2015,Enlisted,52501,18,3,15
2015,Enlisted,52556,24,3,21
2015,Enlisted,52577,9,1,8
2015,Enlisted,52632,6,3,3
2015,Enlisted,52638,15,3,12
2015,Enlisted,52641,7,1,6
2015,Enlisted,52732,11,1,10
2015,Enlisted,52761,7,1,6
2015,Enlisted,52806,32,6,26
2015,Enlisted,53027,2,0,2
2015,Enlisted,53066,31,4,27
2015,Enlisted,53073,5,0,5
2015,Enlisted,53089,31,3,28
2015,Enlisted,53094,17,4,13
2015,Enlisted,53095,13,2,11
2015,Enlisted,53105,8,0,8
2015,Enlisted,53121,4,0,4
2015,Enlisted,53144,6,3,3
2015,Enlisted,53154,8,1,7
2015,Enlisted,53186,8,0,8
2015,Enlisted,53190,13,0,13
2015,Enlisted,53212,58,10,48
2015,Enlisted,53403,17,2,15
2015,Enlisted,53511,21,3,18
2015,Enlisted,53538,23,2,21
2015,Enlisted,53581,3,2,1
2015,Enlisted,53704,82,18,64
2015,Enlisted,53818,6,2,4
2015,Enlisted,53821,6,0,6
2015,Enlisted,53901,11,0,11
2015,Enlisted,53913,3,0,3
2015,Enlisted,53948,14,1,13
2015,Enlisted,53959,17,2,15
2015,Enlisted,53963,10,6,4
2015,Enlisted,54017,20,3,17
2015,Enlisted,54022,16,2,14
2015,Enlisted,54143,16,4,12
2015,Enlisted,54241,6,1,5
2015,Enlisted,54303,18,6,12
2015,Enlisted,54401,7,1,6
2015,Enlisted,54405,7,2,5
2015,Enlisted,54409,10,0,10
2015,Enlisted,54449,17,2,15
2015,Enlisted,54451,25,2,23
2015,Enlisted,54452,2,0,2
2015,Enlisted,54455,18,2,16
2015,Enlisted,54456,3,0,3
2015,Enlisted,54481,12,1,11
2015,Enlisted,54487,12,2,10
2015,Enlisted,54495,13,0,13
2015,Enlisted,54501,13,1,12
2015,Enlisted,54612,9,0,9
2015,Enlisted,54615,18,1,17
2015,Enlisted,54618,15,5,10
2015,Enlisted,54650,16,3,13
2015,Enlisted,54656,4,0,4
2015,Enlisted,54660,11,1,10
2015,Enlisted,54665,14,1,13
2015,Enlisted,54703,21,1,20
2015,Enlisted,54729,9,1,8
2015,Enlisted,54751,25,4,21
2015,Enlisted,54801,3,0,3
2015,Enlisted,54806,15,1,14
2015,Enlisted,54843,17,2,15
2015,Enlisted,54868,13,0,13
2015,Enlisted,54880,3,0,3
2015,Enlisted,54902,26,1,25
2015,Enlisted,54914,22,6,16
2015,Enlisted,54923,7,1,6
2015,Enlisted,54929,10,0,10
2015,Enlisted,54935,23,10,13
2015,Enlisted,54971,13,2,11
2015,Enlisted,54981,7,0,7
2015,Enlisted,55008,41,4,37
2015,Enlisted,55016,32,4,28
2015,Enlisted,55021,18,4,14
2015,Enlisted,55033,15,3,12
2015,Enlisted,55057,12,1,11
2015,Enlisted,55060,9,3,6
2015,Enlisted,55063,23,4,19
2015,Enlisted,55066,7,1,6
2015,Enlisted,55068,47,13,34
2015,Enlisted,55077,39,5,34
2015,Enlisted,55082,26,3,23
2015,Enlisted,55101,1,1,0
2015,Enlisted,55106,27,5,22
2015,Enlisted,55107,58,11,47
2015,Enlisted,55112,102,9,93
2015,Enlisted,55113,26,8,18
2015,Enlisted,55118,47,4,43
2015,Enlisted,55303,25,3,22
2015,Enlisted,55350,5,1,4
2015,Enlisted,55355,9,0,9
2015,Enlisted,55362,21,0,21
2015,Enlisted,55413,3,0,3
2015,Enlisted,55431,65,4,61
2015,Enlisted,55443,21,2,19
2015,Enlisted,55719,6,0,6
2015,Enlisted,55720,7,0,7
2015,Enlisted,55744,11,0,11
2015,Enlisted,55746,11,1,10
2015,Enlisted,55811,63,3,60
2015,Enlisted,55904,44,4,40
2015,Enlisted,55912,28,4,24
2015,Enlisted,55987,30,1,29
2015,Enlisted,56001,30,5,25
2015,Enlisted,56007,20,3,17
2015,Enlisted,56021,2,0,2
2015,Enlisted,56031,27,1,26
2015,Enlisted,56073,22,2,20
2015,Enlisted,56081,14,0,14
2015,Enlisted,56082,15,0,15
2015,Enlisted,56143,29,3,26
2015,Enlisted,56156,15,3,12
2015,Enlisted,56164,20,1,19
2015,Enlisted,56201,11,2,9
2015,Enlisted,56208,15,2,13
2015,Enlisted,56256,27,3,24
2015,Enlisted,56258,22,1,21
2015,Enlisted,56265,16,0,16
2015,Enlisted,56267,20,1,19
2015,Enlisted,56277,15,3,12
2015,Enlisted,56278,21,0,21
2015,Enlisted,56283,5,1,4
2015,Enlisted,56303,60,13,47
2015,Enlisted,56308,21,5,16
2015,Enlisted,56345,141,10,131
2015,Enlisted,56347,7,0,7
2015,Enlisted,56378,15,3,12
2015,Enlisted,56401,30,4,26
2015,Enlisted,56482,16,2,14
2015,Enlisted,56501,12,1,11
2015,Enlisted,56537,19,2,17
2015,Enlisted,56560,39,3,36
2015,Enlisted,56601,10,3,7
2015,Enlisted,56701,10,0,10
2015,Enlisted,56716,10,0,10
2015,Enlisted,57006,9,1,8
2015,Enlisted,57028,7,1,6
2015,Enlisted,57042,17,1,16
2015,Enlisted,57069,12,1,11
2015,Enlisted,57078,6,1,5
2015,Enlisted,57104,34,2,32
2015,Enlisted,57201,23,1,22
2015,Enlisted,57231,6,1,5
2015,Enlisted,57252,5,0,5
2015,Enlisted,57301,5,0,5
2015,Enlisted,57325,5,1,4
2015,Enlisted,57350,8,2,6
2015,Enlisted,57366,5,0,5
2015,Enlisted,57380,16,2,14
2015,Enlisted,57401,16,2,14
2015,Enlisted,57501,9,0,9
2015,Enlisted,57601,5,0,5
2015,Enlisted,57702,20,11,9
2015,Enlisted,57703,14,1,13
2015,Enlisted,57717,12,1,11
2015,Enlisted,57741,1,1,0
2015,Enlisted,57783,9,1,8
2015,Enlisted,57785,8,3,5
2015,Enlisted,58054,3,0,3
2015,Enlisted,58072,11,3,8
2015,Enlisted,58075,6,0,6
2015,Enlisted,58102,69,21,48
2015,Enlisted,58201,29,11,18
2015,Enlisted,58237,3,1,2
2015,Enlisted,58257,8,1,7
2015,Enlisted,58301,14,4,10
2015,Enlisted,58318,1,1,0
2015,Enlisted,58324,1,0,1
2015,Enlisted,58368,1,1,0
2015,Enlisted,58402,18,3,15
2015,Enlisted,58421,7,1,6
2015,Enlisted,58433,8,0,8
2015,Enlisted,58474,4,0,4
2015,Enlisted,58495,3,1,2
2015,Enlisted,58506,55,16,39
2015,Enlisted,58601,12,5,7
2015,Enlisted,58646,1,0,1
2015,Enlisted,58702,19,6,13
2015,Enlisted,58802,7,2,5
2015,Enlisted,59036,4,0,4
2015,Enlisted,59047,4,0,4
2015,Enlisted,59102,56,6,50
2015,Enlisted,59218,5,2,3
2015,Enlisted,59230,7,0,7
2015,Enlisted,59270,4,1,3
2015,Enlisted,59301,1,0,1
2015,Enlisted,59405,10,2,8
2015,Enlisted,59457,10,0,10
2015,Enlisted,59501,4,0,4
2015,Enlisted,59538,7,1,6
2015,Enlisted,59602,60,9,51
2015,Enlisted,59636,30,10,20
2015,Enlisted,59701,9,0,9
2015,Enlisted,59711,12,1,11
2015,Enlisted,59714,43,13,30
2015,Enlisted,59725,8,3,5
2015,Enlisted,59808,61,6,55
2015,Enlisted,59840,5,0,5
2015,Enlisted,59901,19,2,17
2015,Enlisted,59923,1,0,1
2015,Enlisted,60037,43,3,40
2015,Enlisted,60098,7,4,3
2015,Enlisted,60120,24,10,14
2015,Enlisted,60178,17,1,16
2015,Enlisted,60435,18,0,18
2015,Enlisted,60472,87,8,79
2015,Enlisted,60505,20,5,15
2015,Enlisted,60546,136,20,116
2015,Enlisted,60615,84,13,71
2015,Enlisted,60616,10,5,5
2015,Enlisted,60638,24,4,20
2015,Enlisted,60651,43,7,36
2015,Enlisted,60901,20,4,16
2015,Enlisted,61021,11,2,9
2015,Enlisted,61032,28,1,27
2015,Enlisted,61071,39,2,37
2015,Enlisted,61115,29,2,27
2015,Enlisted,61264,34,6,28
2015,Enlisted,61341,43,3,40
2015,Enlisted,61364,6,0,6
2015,Enlisted,61401,33,3,30
2015,Enlisted,61434,9,1,8
2015,Enlisted,61443,19,5,14
2015,Enlisted,61455,17,3,14
2015,Enlisted,61607,78,5,73
2015,Enlisted,61701,20,2,18
2015,Enlisted,61734,1,0,1
2015,Enlisted,61761,26,5,21
2015,Enlisted,61764,9,1,8
2015,Enlisted,61801,9,4,5
2015,Enlisted,61820,9,2,7
2015,Enlisted,61834,6,1,5
2015,Enlisted,61938,7,2,5
2015,Enlisted,61944,21,2,19
2015,Enlisted,61951,12,1,11
2015,Enlisted,62056,42,11,31
2015,Enlisted,62205,18,4,14
2015,Enlisted,62269,25,3,22
2015,Enlisted,62286,44,5,39
2015,Enlisted,62301,10,0,10
2015,Enlisted,62401,40,8,32
2015,Enlisted,62439,29,6,23
2015,Enlisted,62521,55,8,47
2015,Enlisted,62618,6,1,5
2015,Enlisted,62702,90,17,73
2015,Enlisted,62864,36,9,27
2015,Enlisted,62896,20,4,16
2015,Enlisted,62959,41,9,32
2015,Enlisted,62966,17,2,15
2015,Enlisted,63020,15,2,13
2015,Enlisted,63028,12,2,10
2015,Enlisted,63044,64,3,61
2015,Enlisted,63077,24,5,19
2015,Enlisted,63109,56,15,41
2015,Enlisted,63125,69,9,60
2015,Enlisted,63383,24,4,20
2015,Enlisted,63401,18,3,15
2015,Enlisted,63501,12,1,11
2015,Enlisted,63552,25,4,21
2015,Enlisted,63640,3,1,2
2015,Enlisted,63645,4,1,3
2015,Enlisted,63703,28,4,24
2015,Enlisted,63755,14,1,13
2015,Enlisted,63775,15,1,14
2015,Enlisted,63801,13,1,12
2015,Enlisted,63841,9,3,6
2015,Enlisted,63857,17,1,16
2015,Enlisted,63873,8,2,6
2015,Enlisted,63901,11,2,9
2015,Enlisted,63935,13,1,12
2015,Enlisted,64052,10,3,7
2015,Enlisted,64067,30,8,22
2015,Enlisted,64085,15,2,13
2015,Enlisted,64093,8,1,7
2015,Enlisted,64129,89,12,77
2015,Enlisted,64402,9,0,9
2015,Enlisted,64468,5,1,4
2015,Enlisted,64506,15,3,12
2015,Enlisted,64601,12,0,12
2015,Enlisted,64683,30,4,26
2015,Enlisted,64701,29,1,28
2015,Enlisted,64735,10,1,9
2015,Enlisted,64759,3,0,3
2015,Enlisted,64772,12,4,8
2015,Enlisted,64804,18,6,12
2015,Enlisted,64831,20,3,17
2015,Enlisted,64836,13,0,13
2015,Enlisted,64850,1,0,1
2015,Enlisted,65101,25,7,18
2015,Enlisted,65109,41,7,34
2015,Enlisted,65202,14,5,9
2015,Enlisted,65233,26,5,21
2015,Enlisted,65251,5,0,5
2015,Enlisted,65265,9,1,8
2015,Enlisted,65270,11,1,10
2015,Enlisted,65301,12,3,9
2015,Enlisted,65305,49,6,43
2015,Enlisted,65340,13,0,13
2015,Enlisted,65401,21,1,20
2015,Enlisted,65473,21,6,15
2015,Enlisted,65536,16,0,16
2015,Enlisted,65605,25,4,21
2015,Enlisted,65708,11,4,7
2015,Enlisted,65723,7,0,7
2015,Enlisted,65775,9,0,9
2015,Enlisted,65802,80,16,64
2015,Enlisted,65803,32,11,21
2015,Enlisted,66027,10,6,4
2015,Enlisted,66044,21,9,12
2015,Enlisted,66061,27,9,18
2015,Enlisted,66067,6,1,5
2015,Enlisted,66071,4,0,4
2015,Enlisted,66102,23,11,12
2015,Enlisted,66219,15,5,10
2015,Enlisted,66434,6,0,6
2015,Enlisted,66436,2,0,2
2015,Enlisted,66441,9,3,6
2015,Enlisted,66502,37,28,9
2015,Enlisted,66503,4,1,3
2015,Enlisted,66508,5,1,4
2015,Enlisted,66611,8,5,3
2015,Enlisted,66619,54,19,35
2015,Enlisted,66749,12,2,10
2015,Enlisted,66762,13,0,13
2015,Enlisted,66801,5,1,4
2015,Enlisted,66901,3,1,2
2015,Enlisted,67010,14,1,13
2015,Enlisted,67114,8,3,5
2015,Enlisted,67124,5,1,4
2015,Enlisted,67217,40,11,29
2015,Enlisted,67219,29,5,24
2015,Enlisted,67337,9,0,9
2015,Enlisted,67401,18,5,13
2015,Enlisted,67410,13,5,8
2015,Enlisted,67432,5,1,4
2015,Enlisted,67501,14,3,11
2015,Enlisted,67530,5,2,3
2015,Enlisted,67601,4,0,4
2015,Enlisted,67654,3,1,2
2015,Enlisted,67701,3,1,2
2015,Enlisted,67801,1,0,1
2015,Enlisted,67901,2,0,2
2015,Enlisted,68041,10,3,7
2015,Enlisted,68066,17,5,12
2015,Enlisted,68073,14,3,11
2015,Enlisted,68106,14,4,10
2015,Enlisted,68142,38,4,34
2015,Enlisted,68310,17,4,13
2015,Enlisted,68410,2,0,2
2015,Enlisted,68467,2,0,2
2015,Enlisted,68508,29,9,20
2015,Enlisted,68524,62,17,45
2015,Enlisted,68602,7,2,5
2015,Enlisted,68701,16,3,13
2015,Enlisted,68763,4,1,3
2015,Enlisted,68787,5,0,5
2015,Enlisted,68801,11,0,11
2015,Enlisted,68822,3,0,3
2015,Enlisted,68847,12,1,11
2015,Enlisted,68901,16,3,13
2015,Enlisted,69001,1,0,1
2015,Enlisted,69101,7,1,6
2015,Enlisted,69162,2,1,1
2015,Enlisted,69337,4,2,2
2015,Enlisted,69361,3,1,2
2015,Enlisted,70072,16,1,15
2015,Enlisted,70084,14,2,12
2015,Enlisted,70117,86,13,73
2015,Enlisted,70364,21,4,17
2015,Enlisted,70390,10,1,9
2015,Enlisted,70401,52,12,40
2015,Enlisted,70403,16,2,14
2015,Enlisted,70427,9,2,7
2015,Enlisted,70433,28,1,27
2015,Enlisted,70438,15,0,15
2015,Enlisted,70460,20,1,19
2015,Enlisted,70508,48,9,39
2015,Enlisted,70510,38,6,32
2015,Enlisted,70517,13,1,12
2015,Enlisted,70526,9,1,8
2015,Enlisted,70544,23,1,22
2015,Enlisted,70563,14,1,13
2015,Enlisted,70570,8,0,8
2015,Enlisted,70582,14,2,12
2015,Enlisted,70586,3,0,3
2015,Enlisted,70601,30,8,22
2015,Enlisted,70605,7,1,6
2015,Enlisted,70633,13,1,12
2015,Enlisted,70634,5,2,3
2015,Enlisted,70714,10,3,7
2015,Enlisted,70721,82,13,69
2015,Enlisted,70737,26,4,22
2015,Enlisted,70760,9,1,8
2015,Enlisted,70764,65,8,57
2015,Enlisted,70807,4,2,2
2015,Enlisted,70820,61,8,53
2015,Enlisted,71019,14,5,9
2015,Enlisted,71023,24,2,22
2015,Enlisted,71055,30,4,26
2015,Enlisted,71101,45,6,39
2015,Enlisted,71111,12,4,8
2015,Enlisted,71203,25,2,23
2015,Enlisted,71220,9,1,8
2015,Enlisted,71232,6,2,4
2015,Enlisted,71241,4,1,3
2015,Enlisted,71251,2,0,2
2015,Enlisted,71263,2,0,2
2015,Enlisted,71270,35,6,29
2015,Enlisted,71292,14,1,13
2015,Enlisted,71295,5,0,5
2015,Enlisted,71303,24,2,22
2015,Enlisted,71322,8,2,6
2015,Enlisted,71342,17,0,17
2015,Enlisted,71351,10,1,9
2015,Enlisted,71360,102,16,86
2015,Enlisted,71373,1,0,1
2015,Enlisted,71415,4,0,4
2015,Enlisted,71417,14,2,12
2015,Enlisted,71457,10,1,9
2015,Enlisted,71459,11,3,8
2015,Enlisted,71602,15,0,15
2015,Enlisted,71635,3,0,3
2015,Enlisted,71655,15,0,15
2015,Enlisted,71671,8,2,6
2015,Enlisted,71701,7,1,6
2015,Enlisted,71730,9,2,7
2015,Enlisted,71753,10,3,7
2015,Enlisted,71801,10,1,9
2015,Enlisted,71823,10,0,10
2015,Enlisted,71854,14,1,13
2015,Enlisted,71857,11,0,11
2015,Enlisted,71913,13,0,13
2015,Enlisted,71923,3,0,3
2015,Enlisted,71953,18,4,14
2015,Enlisted,72007,9,0,9
2015,Enlisted,72012,14,1,13
2015,Enlisted,72015,25,0,25
2015,Enlisted,72021,1,0,1
2015,Enlisted,72023,19,2,17
2015,Enlisted,72034,18,2,16
2015,Enlisted,72064,6,0,6
2015,Enlisted,72086,13,4,9
2015,Enlisted,72104,33,4,29
2015,Enlisted,72110,6,2,4
2015,Enlisted,72114,37,4,33
2015,Enlisted,72143,25,3,22
2015,Enlisted,72150,17,2,15
2015,Enlisted,72160,7,1,6
2015,Enlisted,72199,138,21,117
2015,Enlisted,72205,8,4,4
2015,Enlisted,72301,8,1,7
2015,Enlisted,72315,5,0,5
2015,Enlisted,72335,4,0,4
2015,Enlisted,72396,5,3,2
2015,Enlisted,72401,32,0,32
2015,Enlisted,72432,20,3,17
2015,Enlisted,72450,19,2,17
2015,Enlisted,72461,4,0,4
2015,Enlisted,72476,10,1,9
2015,Enlisted,72501,16,0,16
2015,Enlisted,72543,10,0,10
2015,Enlisted,72601,9,0,9
2015,Enlisted,72616,4,0,4
2015,Enlisted,72650,9,0,9
2015,Enlisted,72653,15,2,13
2015,Enlisted,72701,20,4,16
2015,Enlisted,72712,46,9,37
2015,Enlisted,72744,2,1,1
2015,Enlisted,72756,19,4,15
2015,Enlisted,72761,6,1,5
2015,Enlisted,72802,14,1,13
2015,Enlisted,72830,15,3,12
2015,Enlisted,72834,8,1,7
2015,Enlisted,72855,14,2,12
2015,Enlisted,72905,7,3,4
2015,Enlisted,72923,36,6,30
2015,Enlisted,72927,4,0,4
2015,Enlisted,73034,76,12,64
2015,Enlisted,73036,33,6,27
2015,Enlisted,73051,44,14,30
2015,Enlisted,73064,71,15,56
2015,Enlisted,73069,154,51,103
2015,Enlisted,73111,19,7,12
2015,Enlisted,73141,3,0,3
2015,Enlisted,73179,4,2,2
2015,Enlisted,73401,24,6,18
2015,Enlisted,73503,43,12,31
2015,Enlisted,73521,9,4,5
2015,Enlisted,73705,31,3,28
2015,Enlisted,74003,11,4,7
2015,Enlisted,74012,27,9,18
2015,Enlisted,74014,92,21,71
2015,Enlisted,74017,7,0,7
2015,Enlisted,74075,36,4,32
2015,Enlisted,74107,47,12,35
2015,Enlisted,74116,24,8,16
2015,Enlisted,74301,26,4,22
2015,Enlisted,74403,36,9,27
2015,Enlisted,74423,5,3,2
2015,Enlisted,74447,10,7,3
2015,Enlisted,74501,37,8,29
2015,Enlisted,74601,15,3,12
2015,Enlisted,74701,24,6,18
2015,Enlisted,74804,12,1,11
2015,Enlisted,74820,19,5,14
2015,Enlisted,74834,17,4,13
2015,Enlisted,74848,11,4,7
2015,Enlisted,74953,17,0,17
2015,Enlisted,75020,5,2,3
2015,Enlisted,75051,158,50,108
2015,Enlisted,75077,44,7,37
2015,Enlisted,75098,8,4,4
2015,Enlisted,75110,6,1,5
2015,Enlisted,75159,65,24,41
2015,Enlisted,75160,39,7,32
2015,Enlisted,75165,2,2,0
2015,Enlisted,75220,3,3,0
2015,Enlisted,75237,35,10,25
2015,Enlisted,75402,12,4,8
2015,Enlisted,75570,15,2,13
2015,Enlisted,75662,38,11,27
2015,Enlisted,75672,12,5,7
2015,Enlisted,75709,21,8,13
2015,Enlisted,75803,17,6,11
2015,Enlisted,75901,8,2,6
2015,Enlisted,76011,3,3,0
2015,Enlisted,76086,20,8,12
2015,Enlisted,76105,75,30,45
2015,Enlisted,76108,48,18,30
2015,Enlisted,76115,18,10,8
2015,Enlisted,76207,18,8,10
2015,Enlisted,76234,12,2,10
2015,Enlisted,76302,30,12,18
2015,Enlisted,76401,12,5,7
2015,Enlisted,76502,58,39,19
2015,Enlisted,76528,24,15,9
2015,Enlisted,76542,53,38,15
2015,Enlisted,76574,5,4,1
2015,Enlisted,76705,2,0,2
2015,Enlisted,76707,62,42,20
2015,Enlisted,76801,10,4,6
2015,Enlisted,76905,15,5,10
2015,Enlisted,77034,108,36,72
2015,Enlisted,77067,62,27,35
2015,Enlisted,77082,182,55,127
2015,Enlisted,77340,47,12,35
2015,Enlisted,77437,12,6,6
2015,Enlisted,77471,8,2,6
2015,Enlisted,77503,2,2,0
2015,Enlisted,77515,25,4,21
2015,Enlisted,77568,14,5,9
2015,Enlisted,77802,37,11,26
2015,Enlisted,77833,20,3,17
2015,Enlisted,77904,8,2,6
2015,Enlisted,78041,22,4,18
2015,Enlisted,78130,22,14,8
2015,Enlisted,78155,2,1,1
2015,Enlisted,78218,31,16,15
2015,Enlisted,78219,99,37,62
2015,Enlisted,78257,158,96,62
2015,Enlisted,78363,8,4,4
2015,Enlisted,78416,4,3,1
2015,Enlisted,78520,15,3,12
2015,Enlisted,78596,80,27,53
2015,Enlisted,78602,13,7,6
2015,Enlisted,78617,107,26,81
2015,Enlisted,78624,18,12,6
2015,Enlisted,78665,33,21,12
2015,Enlisted,78666,81,37,44
2015,Enlisted,78703,185,76,109
2015,Enlisted,78731,21,17,4
2015,Enlisted,78746,5,5,0
2015,Enlisted,78861,7,6,1
2015,Enlisted,79107,16,4,12
2015,Enlisted,79403,29,11,18
2015,Enlisted,79607,12,5,7
2015,Enlisted,79706,25,11,14
2015,Enlisted,79924,25,9,16
2015,Enlisted,79936,133,46,87
2015,Enlisted,80011,94,34,60
2015,Enlisted,80012,21,8,13
2015,Enlisted,80112,4,4,0
2015,Enlisted,80137,55,23,32
2015,Enlisted,80216,50,18,32
2015,Enlisted,80501,15,4,11
2015,Enlisted,80504,19,6,13
2015,Enlisted,80521,14,6,8
2015,Enlisted,80550,15,11,4
2015,Enlisted,80621,19,12,7
2015,Enlisted,80907,17,9,8
2015,Enlisted,80913,44,28,16
2015,Enlisted,80916,21,10,11
2015,Enlisted,80920,36,16,20
2015,Enlisted,81004,11,8,3
2015,Enlisted,81050,2,1,1
2015,Enlisted,81101,11,2,9
2015,Enlisted,81212,4,1,3
2015,Enlisted,81303,7,0,7
2015,Enlisted,81401,24,10,14
2015,Enlisted,81501,25,11,14
2015,Enlisted,82009,30,11,19
2015,Enlisted,82072,19,1,18
2015,Enlisted,82201,4,1,3
2015,Enlisted,82214,12,7,5
2015,Enlisted,82240,4,3,1
2015,Enlisted,82401,4,0,4
2015,Enlisted,82431,10,1,9
2015,Enlisted,82435,4,1,3
2015,Enlisted,82520,11,2,9
2015,Enlisted,82604,8,3,5
2015,Enlisted,82633,6,1,5
2015,Enlisted,82716,33,29,4
2015,Enlisted,82801,13,4,9
2015,Enlisted,82901,5,0,5
2015,Enlisted,82931,7,2,5
2015,Enlisted,83110,8,0,8
2015,Enlisted,83202,15,9,6
2015,Enlisted,83221,2,0,2
2015,Enlisted,83263,1,1,0
2015,Enlisted,83301,12,5,7
2015,Enlisted,83318,9,4,5
2015,Enlisted,83330,14,4,10
2015,Enlisted,83333,3,1,2
2015,Enlisted,83338,3,0,3
2015,Enlisted,83402,9,1,8
2015,Enlisted,83440,4,0,4
2015,Enlisted,83442,2,0,2
2015,Enlisted,83445,8,1,7
2015,Enlisted,83501,19,2,17
2015,Enlisted,83530,1,0,1
2015,Enlisted,83544,2,0,2
2015,Enlisted,83605,10,3,7
2015,Enlisted,83617,9,4,5
2015,Enlisted,83647,12,5,7
2015,Enlisted,83661,2,1,1
2015,Enlisted,83676,6,3,3
2015,Enlisted,83687,13,6,7
2015,Enlisted,83705,152,54,98
2015,Enlisted,83805,3,0,3
2015,Enlisted,83843,11,2,9
2015,Enlisted,83854,18,4,14
2015,Enlisted,84003,25,5,20
2015,Enlisted,84020,50,16,34
2015,Enlisted,84043,25,4,21
2015,Enlisted,84058,25,7,18
2015,Enlisted,84065,124,31,93
2015,Enlisted,84074,15,2,13
2015,Enlisted,84078,8,0,8
2015,Enlisted,84084,108,18,90
2015,Enlisted,84116,21,6,15
2015,Enlisted,84302,7,1,6
2015,Enlisted,84321,12,2,10
2015,Enlisted,84323,5,2,3
2015,Enlisted,84404,6,3,3
2015,Enlisted,84405,38,12,26
2015,Enlisted,84501,18,3,15
2015,Enlisted,84511,3,0,3
2015,Enlisted,84631,5,0,5
2015,Enlisted,84642,13,1,12
2015,Enlisted,84647,3,1,2
2015,Enlisted,84660,38,5,33
2015,Enlisted,84663,7,2,5
2015,Enlisted,84701,12,3,9
2015,Enlisted,84713,4,0,4
2015,Enlisted,84720,15,5,10
2015,Enlisted,84790,23,5,18
2015,Enlisted,85008,206,72,134
2015,Enlisted,85015,1,0,1
2015,Enlisted,85020,26,7,19
2015,Enlisted,85122,43,8,35
2015,Enlisted,85128,5,1,4
2015,Enlisted,85132,62,17,45
2015,Enlisted,85201,10,2,8
2015,Enlisted,85281,23,10,13
2015,Enlisted,85286,22,10,12
2015,Enlisted,85301,8,5,3
2015,Enlisted,85312,17,5,12
2015,Enlisted,85364,4,1,3
2015,Enlisted,85365,7,2,5
2015,Enlisted,85396,25,8,17
2015,Enlisted,85546,10,4,6
2015,Enlisted,85607,3,2,1
2015,Enlisted,85653,67,22,45
2015,Enlisted,85706,68,12,56
2015,Enlisted,85713,53,16,37
2015,Enlisted,85901,4,2,2
2015,Enlisted,86015,87,15,72
2015,Enlisted,86301,36,16,20
2015,Enlisted,87002,2,1,1
2015,Enlisted,87123,66,14,52
2015,Enlisted,87144,100,15,85
2015,Enlisted,87305,1,0,1
2015,Enlisted,87401,30,8,22
2015,Enlisted,87508,16,7,9
2015,Enlisted,87532,4,0,4
2015,Enlisted,87557,4,2,2
2015,Enlisted,87701,5,1,4
2015,Enlisted,87747,6,1,5
2015,Enlisted,88007,97,37,60
2015,Enlisted,88026,3,0,3
2015,Enlisted,88101,14,6,8
2015,Enlisted,88203,12,4,8
2015,Enlisted,88220,3,2,1
2015,Enlisted,88240,4,1,3
2015,Enlisted,88310,13,4,9
2015,Enlisted,88401,3,0,3
2015,Enlisted,88415,2,0,2
2015,Enlisted,88435,1,0,1
2015,Enlisted,89002,41,9,32
2015,Enlisted,89032,8,3,5
2015,Enlisted,89115,108,15,93
2015,Enlisted,89139,32,11,21
2015,Enlisted,89165,71,13,58
2015,Enlisted,89406,14,3,11
2015,Enlisted,89445,1,0,1
2015,Enlisted,89447,19,3,16
2015,Enlisted,89506,101,22,79
2015,Enlisted,89509,4,0,4
2015,Enlisted,89701,15,3,12
2015,Enlisted,89801,13,2,11
2015,Enlisted,90025,5,3,2
2015,Enlisted,90201,96,39,57
2015,Enlisted,90266,6,3,3
2015,Enlisted,90302,37,17,20
2015,Enlisted,90501,26,4,22
2015,Enlisted,90640,27,10,17
2015,Enlisted,90720,207,94,113
2015,Enlisted,90731,15,7,8
2015,Enlisted,90813,12,8,4
2015,Enlisted,90822,52,18,34
2015,Enlisted,91205,47,15,32
2015,Enlisted,91406,20,7,13
2015,Enlisted,91505,34,12,22
2015,Enlisted,91702,76,26,50
2015,Enlisted,91764,50,13,37
2015,Enlisted,91766,26,10,16
2015,Enlisted,91950,27,8,19
2015,Enlisted,92020,19,11,8
2015,Enlisted,92025,16,5,11
2015,Enlisted,92111,56,26,30
2015,Enlisted,92220,11,8,3
2015,Enlisted,92227,2,0,2
2015,Enlisted,92243,9,2,7
2015,Enlisted,92307,5,2,3
2015,Enlisted,92311,18,5,13
2015,Enlisted,92324,14,8,6
2015,Enlisted,92410,18,9,9
2015,Enlisted,92501,20,8,12
2015,Enlisted,92518,55,22,33
2015,Enlisted,92707,11,4,7
2015,Enlisted,92833,27,15,12
2015,Enlisted,92866,35,12,23
2015,Enlisted,92879,8,5,3
2015,Enlisted,93003,10,5,5
2015,Enlisted,93030,5,3,2
2015,Enlisted,93103,5,3,2
2015,Enlisted,93257,8,4,4
2015,Enlisted,93291,22,11,11
2015,Enlisted,93307,48,15,33
2015,Enlisted,93405,16,6,10
2015,Enlisted,93422,2,1,1
2015,Enlisted,93451,20,12,8
2015,Enlisted,93454,5,0,5
2015,Enlisted,93536,10,3,7
2015,Enlisted,93550,6,3,3
2015,Enlisted,93638,6,4,2
2015,Enlisted,93702,16,4,12
2015,Enlisted,93727,65,23,42
2015,Enlisted,93955,8,2,6
2015,Enlisted,94035,12,3,9
2015,Enlisted,94043,15,6,9
2015,Enlisted,94066,3,1,2
2015,Enlisted,94132,5,5,0
2015,Enlisted,94401,18,7,11
2015,Enlisted,94510,7,2,5
2015,Enlisted,94519,7,2,5
2015,Enlisted,94533,14,8,6
2015,Enlisted,94565,30,6,24
2015,Enlisted,94568,31,18,13
2015,Enlisted,94590,11,3,8
2015,Enlisted,94596,7,3,4
2015,Enlisted,94804,30,15,15
2015,Enlisted,94903,9,6,3
2015,Enlisted,94952,12,7,5
2015,Enlisted,95020,7,4,3
2015,Enlisted,95065,1,0,1
2015,Enlisted,95110,14,5,9
2015,Enlisted,95206,69,23,46
2015,Enlisted,95240,7,1,6
2015,Enlisted,95341,20,5,15
2015,Enlisted,95351,36,19,17
2015,Enlisted,95361,14,8,6
2015,Enlisted,95380,8,2,6
2015,Enlisted,95401,20,16,4
2015,Enlisted,95453,4,1,3
2015,Enlisted,95503,6,3,3
2015,Enlisted,95603,34,18,16
2015,Enlisted,95655,15,8,7
2015,Enlisted,95667,1,1,0
2015,Enlisted,95678,14,8,6
2015,Enlisted,95815,1,1,0
2015,Enlisted,95826,32,10,22
2015,Enlisted,95828,74,28,46
2015,Enlisted,95832,15,6,9
2015,Enlisted,95926,13,3,10
2015,Enlisted,95965,15,3,12
2015,Enlisted,95991,1,1,0
2015,Enlisted,96001,9,5,4
2015,Enlisted,96067,3,1,2
2015,Enlisted,96080,5,2,3
2015,Enlisted,96130,3,1,2
2015,Enlisted,96707,117,61,56
2015,Enlisted,96716,6,2,4
2015,Enlisted,96720,28,6,22
2015,Enlisted,96732,14,5,9
2015,Enlisted,96748,2,0,2
2015,Enlisted,96750,1,0,1
2015,Enlisted,96782,37,14,23
2015,Enlisted,96786,61,19,42
2015,Enlisted,96789,43,8,35
2015,Enlisted,96816,4,3,1
2015,Enlisted,96820,15,2,13
2015,Enlisted,96857,29,10,19
2015,Enlisted,96913,97,12,85
2015,Enlisted,97015,86,19,67
2015,Enlisted,97030,11,2,9
2015,Enlisted,97031,4,0,4
2015,Enlisted,97051,3,1,2
2015,Enlisted,97058,5,2,3
2015,Enlisted,97071,16,6,10
2015,Enlisted,97116,15,4,11
2015,Enlisted,97124,9,3,6
2015,Enlisted,97128,8,4,4
2015,Enlisted,97146,9,5,4
2015,Enlisted,97211,38,8,30
2015,Enlisted,97217,4,0,4
2015,Enlisted,97218,6,4,2
2015,Enlisted,97302,26,6,20
2015,Enlisted,97303,23,7,16
2015,Enlisted,97304,7,6,1
2015,Enlisted,97309,29,10,19
2015,Enlisted,97321,6,0,6
2015,Enlisted,97330,11,2,9
2015,Enlisted,97338,12,2,10
2015,Enlisted,97355,17,4,13
2015,Enlisted,97365,2,1,1
2015,Enlisted,97401,9,4,5
2015,Enlisted,97420,15,5,10
2015,Enlisted,97470,5,1,4
2015,Enlisted,97477,48,15,33
2015,Enlisted,97501,39,16,23
2015,Enlisted,97520,16,4,12
2015,Enlisted,97526,7,1,6
2015,Enlisted,97603,5,2,3
2015,Enlisted,97702,21,11,10
2015,Enlisted,97756,4,1,3
2015,Enlisted,97801,24,5,19
2015,Enlisted,97814,7,0,7
2015,Enlisted,97838,11,5,6
2015,Enlisted,97850,25,3,22
2015,Enlisted,97862,6,3,3
2015,Enlisted,97914,6,0,6
2015,Enlisted,98032,63,27,36
2015,Enlisted,98052,47,32,15
2015,Enlisted,98108,36,22,14
2015,Enlisted,98119,93,48,45
2015,Enlisted,98221,15,5,10
2015,Enlisted,98271,26,9,17
2015,Enlisted,98290,16,7,9
2015,Enlisted,98312,28,13,15
2015,Enlisted,98321,7,7,0
2015,Enlisted,98366,15,5,10
2015,Enlisted,98372,22,13,9
2015,Enlisted,98430,45,38,7
2015,Enlisted,98433,79,51,28
2015,Enlisted,98501,32,12,20
2015,Enlisted,98531,27,19,8
2015,Enlisted,98563,6,4,2
2015,Enlisted,98632,16,9,7
2015,Enlisted,98682,21,6,15
2015,Enlisted,98801,5,3,2
2015,Enlisted,98823,7,0,7
2015,Enlisted,98837,32,10,22
2015,Enlisted,98901,38,15,23
2015,Enlisted,98903,17,3,14
2015,Enlisted,98930,9,2,7
2015,Enlisted,99011,30,6,24
2015,Enlisted,99217,27,6,21
2015,Enlisted,99219,2,1,1
2015,Enlisted,99224,11,6,5
2015,Enlisted,99301,5,1,4
2015,Enlisted,99362,10,2,8
2015,Enlisted,99505,96,39,57
2015,Enlisted,99559,6,0,6
2015,Enlisted,99604,1,0,1
2015,Enlisted,99611,3,0,3
2015,Enlisted,99614,1,0,1
2015,Enlisted,99654,3,0,3
2015,Enlisted,99655,2,0,2
2015,Enlisted,99687,15,6,9
2015,Enlisted,99701,16,10,6
2015,Enlisted,99723,1,0,1
2015,Enlisted,99731,2,2,0
2015,Enlisted,99752,13,3,10
2015,Enlisted,99821,1,1,0
2015,Officer,00624,1,1,0
2015,Officer,00681,1,1,0
2015,Officer,00693,1,1,0
2015,Officer,00705,1,1,0
2015,Officer,00725,2,2,0
2015,Officer,00735,1,1,0
2015,Officer,00769,1,1,0
2015,Officer,00795,7,7,0
2015,Officer,00802,1,1,0
2015,Officer,00850,4,3,1
2015,Officer,00901,4,4,0
2015,Officer,00963,1,1,0
2015,Officer,01082,1,1,0
2015,Officer,01085,1,1,0
2015,Officer,01109,1,1,0
2015,Officer,01434,2,2,0
2015,Officer,01440,1,1,0
2015,Officer,01453,1,1,0
2015,Officer,01605,10,10,0
2015,Officer,01702,1,1,0
2015,Officer,01731,8,8,0
2015,Officer,01760,7,7,0
2015,Officer,01844,4,4,0
2015,Officer,01867,4,4,0
2015,Officer,01923,1,1,0
2015,Officer,02043,2,2,0
2015,Officer,02122,3,3,0
2015,Officer,02138,1,1,0
2015,Officer,02176,6,6,0
2015,Officer,02301,5,5,0
2015,Officer,02481,1,1,0
2015,Officer,02542,6,6,0
2015,Officer,02724,3,3,0
2015,Officer,02769,1,1,0
2015,Officer,02780,1,1,0
2015,Officer,02809,1,1,0
2015,Officer,02816,1,1,0
2015,Officer,02818,6,5,1
2015,Officer,02842,3,3,0
2015,Officer,02852,3,3,0
2015,Officer,02885,2,2,0
2015,Officer,02886,1,1,0
2015,Officer,02904,2,0,2
2015,Officer,02920,4,4,0
2015,Officer,03101,4,3,1
2015,Officer,03301,6,4,2
2015,Officer,03570,1,1,0
2015,Officer,04240,1,1,0
2015,Officer,04268,1,1,0
2015,Officer,04333,5,4,1
2015,Officer,04345,3,2,1
2015,Officer,04401,5,5,0
2015,Officer,04412,2,2,0
2015,Officer,04901,2,2,0
2015,Officer,04915,1,0,1
2015,Officer,05001,1,1,0
2015,Officer,05033,2,2,0
2015,Officer,05158,2,2,0
2015,Officer,05201,2,2,0
2015,Officer,05403,1,1,0
2015,Officer,05404,1,1,0
2015,Officer,05446,5,5,0
2015,Officer,05465,9,9,0
2015,Officer,05478,2,2,0
2015,Officer,05491,1,1,0
2015,Officer,05495,2,2,0
2015,Officer,05602,1,1,0
2015,Officer,05661,2,2,0
2015,Officer,05663,1,1,0
2015,Officer,05851,1,1,0
2015,Officer,06051,1,0,1
2015,Officer,06082,3,2,1
2015,Officer,06096,8,8,0
2015,Officer,06110,1,1,0
2015,Officer,06320,1,1,0
2015,Officer,06340,2,2,0
2015,Officer,06357,2,1,1
2015,Officer,06360,1,1,0
2015,Officer,06457,8,8,0
2015,Officer,06489,1,1,0
2015,Officer,06512,4,4,0
2015,Officer,06614,2,2,0
2015,Officer,06702,1,1,0
2015,Officer,06810,4,2,2
2015,Officer,07052,8,8,0
2015,Officer,07090,3,3,0
2015,Officer,07095,3,3,0
2015,Officer,07107,1,1,0
2015,Officer,07306,2,2,0
2015,Officer,07666,5,5,0
2015,Officer,07728,2,2,0
2015,Officer,07801,1,1,0
2015,Officer,07840,1,1,0
2015,Officer,07865,5,5,0
2015,Officer,07960,5,5,0
2015,Officer,08016,1,1,0
2015,Officer,08060,1,1,0
2015,Officer,08210,1,1,0
2015,Officer,08640,7,4,3
2015,Officer,08648,1,1,0
2015,Officer,08733,1,1,0
2015,Officer,08753,2,2,0
2015,Officer,08759,2,2,0
2015,Officer,08873,3,3,0
2015,Officer,10010,9,6,3
2015,Officer,10021,2,2,0
2015,Officer,10037,2,2,0
2015,Officer,10314,5,3,2
2015,Officer,10468,1,0,1
2015,Officer,10566,4,4,0
2015,Officer,10567,8,8,0
2015,Officer,10701,5,5,0
2015,Officer,11252,5,4,1
2015,Officer,11357,3,1,2
2015,Officer,11433,3,3,0
2015,Officer,11735,4,3,1
2015,Officer,11779,3,3,0
2015,Officer,12110,5,4,1
2015,Officer,12180,8,6,2
2015,Officer,12189,2,1,1
2015,Officer,12302,5,4,1
2015,Officer,12401,3,3,0
2015,Officer,12553,2,2,0
2015,Officer,12804,1,1,0
2015,Officer,13211,5,5,0
2015,Officer,13501,1,1,0
2015,Officer,13602,4,4,0
2015,Officer,13856,1,0,1
2015,Officer,13905,3,2,1
2015,Officer,14094,2,2,0
2015,Officer,14204,3,2,1
2015,Officer,14213,5,5,0
2015,Officer,14304,2,2,0
2015,Officer,14454,1,1,0
2015,Officer,14456,3,2,1
2015,Officer,14624,3,2,1
2015,Officer,14701,1,0,1
2015,Officer,14843,1,1,0
2015,Officer,14845,1,1,0
2015,Officer,15010,2,2,0
2015,Officer,15216,4,4,0
2015,Officer,15301,3,3,0
2015,Officer,15370,1,1,0
2015,Officer,15425,1,1,0
2015,Officer,15537,1,1,0
2015,Officer,15601,1,1,0
2015,Officer,15666,5,5,0
2015,Officer,15701,1,1,0
2015,Officer,15767,1,1,0
2015,Officer,15902,5,5,0
2015,Officer,15904,4,4,0
2015,Officer,16127,1,1,0
2015,Officer,16148,3,3,0
2015,Officer,16301,1,1,0
2015,Officer,16403,1,1,0
2015,Officer,16635,1,1,0
2015,Officer,16652,1,1,0
2015,Officer,16803,2,2,0
2015,Officer,16830,2,2,0
2015,Officer,17003,24,21,3
2015,Officer,17013,1,1,0
2015,Officer,17022,1,1,0
2015,Officer,17042,1,1,0
2015,Officer,17044,1,1,0
2015,Officer,17103,20,18,2
2015,Officer,17201,1,1,0
2015,Officer,17222,3,3,0
2015,Officer,17701,2,2,0
2015,Officer,17745,3,3,0
2015,Officer,18040,4,4,0
2015,Officer,18102,4,4,0
2015,Officer,18201,1,1,0
2015,Officer,18252,1,1,0
2015,Officer,18301,1,1,0
2015,Officer,18509,8,8,0
2015,Officer,18634,2,2,0
2015,Officer,18651,3,3,0
2015,Officer,18704,6,6,0
2015,Officer,18960,4,4,0
2015,Officer,19044,3,3,0
2015,Officer,19104,5,5,0
2015,Officer,19154,7,7,0
2015,Officer,19320,1,1,0
2015,Officer,19462,2,1,1
2015,Officer,19475,1,1,0
2015,Officer,19526,1,1,0
2015,Officer,19530,1,1,0
2015,Officer,19605,2,1,1
2015,Officer,19711,1,1,0
2015,Officer,19720,1,1,0
2015,Officer,19804,3,2,1
2015,Officer,19939,2,2,0
2015,Officer,19947,1,1,0
2015,Officer,19977,2,2,0
2015,Officer,20003,24,21,3
2015,Officer,20112,6,6,0
2015,Officer,20175,4,2,2
2015,Officer,20373,3,2,1
2015,Officer,20653,1,1,0
2015,Officer,20708,9,9,0
2015,Officer,20755,1,1,0
2015,Officer,20882,2,1,1
2015,Officer,20904,2,2,0
2015,Officer,21010,6,4,2
2015,Officer,21043,2,2,0
2015,Officer,21057,1,1,0
2015,Officer,21061,1,1,0
2015,Officer,21078,1,1,0
2015,Officer,21136,2,1,1
2015,Officer,21201,5,5,0
2015,Officer,21204,7,7,0
2015,Officer,21208,5,5,0
2015,Officer,21216,1,1,0
2015,Officer,21228,1,1,0
2015,Officer,21236,1,1,0
2015,Officer,21601,1,1,0
2015,Officer,21701,1,1,0
2015,Officer,21801,1,1,0
2015,Officer,22032,4,4,0
2015,Officer,22060,10,10,0
2015,Officer,22401,11,9,2
2015,Officer,22427,3,3,0
2015,Officer,22601,4,4,0
2015,Officer,22902,4,4,0
2015,Officer,23069,1,1,0
2015,Officer,23139,3,3,0
2015,Officer,23150,15,12,3
2015,Officer,23181,1,1,0
2015,Officer,23237,2,1,1
2015,Officer,23417,1,1,0
2015,Officer,23434,3,1,2
2015,Officer,23451,8,5,3
2015,Officer,23502,1,1,0
2015,Officer,23666,3,3,0
2015,Officer,23701,3,3,0
2015,Officer,23805,1,0,1
2015,Officer,23824,2,2,0
2015,Officer,23847,1,1,0
2015,Officer,24073,1,1,0
2015,Officer,24151,3,3,0
2015,Officer,24251,1,1,0
2015,Officer,24301,1,1,0
2015,Officer,24401,5,5,0
2015,Officer,24450,1,0,1
2015,Officer,24502,9,7,2
2015,Officer,24609,2,2,0
2015,Officer,24701,3,3,0
2015,Officer,24957,1,1,0
2015,Officer,25064,1,1,0
2015,Officer,25168,11,11,0
2015,Officer,25177,1,1,0
2015,Officer,25309,4,4,0
2015,Officer,25311,2,2,0
2015,Officer,25530,3,3,0
2015,Officer,25661,2,2,0
2015,Officer,25704,1,1,0
2015,Officer,25846,3,3,0
2015,Officer,26041,2,2,0
2015,Officer,26101,2,2,0
2015,Officer,26301,1,1,0
2015,Officer,26537,5,5,0
2015,Officer,26554,3,3,0
2015,Officer,26624,2,2,0
2015,Officer,27103,5,5,0
2015,Officer,27204,2,2,0
2015,Officer,27217,1,1,0
2015,Officer,27260,1,1,0
2015,Officer,27320,1,1,0
2015,Officer,27344,1,1,0
2015,Officer,27360,1,1,0
2015,Officer,27401,6,6,0
2015,Officer,27504,1,1,0
2015,Officer,27509,1,1,0
2015,Officer,27530,1,1,0
2015,Officer,27549,1,1,0
2015,Officer,27560,4,4,0
2015,Officer,27573,5,5,0
2015,Officer,27577,1,1,0
2015,Officer,27581,7,6,1
2015,Officer,27607,16,14,2
2015,Officer,27704,3,3,0
2015,Officer,27828,1,1,0
2015,Officer,27834,1,1,0
2015,Officer,27870,1,1,0
2015,Officer,28001,1,1,0
2015,Officer,28012,4,4,0
2015,Officer,28027,1,1,0
2015,Officer,28054,3,3,0
2015,Officer,28086,2,2,0
2015,Officer,28170,2,2,0
2015,Officer,28208,5,5,0
2015,Officer,28306,2,2,0
2015,Officer,28310,3,3,0
2015,Officer,28328,2,2,0
2015,Officer,28345,2,2,0
2015,Officer,28352,1,1,0
2015,Officer,28376,6,6,0
2015,Officer,28388,1,1,0
2015,Officer,28405,1,1,0
2015,Officer,28504,1,1,0
2015,Officer,28580,2,2,0
2015,Officer,28590,2,2,0
2015,Officer,28601,1,1,0
2015,Officer,28607,1,1,0
2015,Officer,28645,2,2,0
2015,Officer,28659,1,1,0
2015,Officer,28726,1,1,0
2015,Officer,28779,1,1,0
2015,Officer,28806,1,1,0
2015,Officer,28906,1,1,0
2015,Officer,29020,1,1,0
2015,Officer,29044,23,23,0
2015,Officer,29102,1,1,0
2015,Officer,29115,1,1,0
2015,Officer,29138,1,1,0
2015,Officer,29170,2,2,0
2015,Officer,29201,11,10,1
2015,Officer,29303,2,2,0
2015,Officer,29341,1,1,0
2015,Officer,29360,1,1,0
2015,Officer,29379,1,1,0
2015,Officer,29385,1,1,0
2015,Officer,29403,1,1,0
2015,Officer,29418,2,2,0
2015,Officer,29440,1,1,0
2015,Officer,29461,1,1,0
2015,Officer,29465,2,2,0
2015,Officer,29483,1,1,0
2015,Officer,29488,2,2,0
2015,Officer,29510,1,1,0
2015,Officer,29532,3,3,0
2015,Officer,29544,1,1,0
2015,Officer,29556,1,1,0
2015,Officer,29574,2,2,0
2015,Officer,29605,3,3,0
2015,Officer,29625,3,3,0
2015,Officer,29631,3,3,0
2015,Officer,29641,1,1,0
2015,Officer,29644,4,4,0
2015,Officer,29651,1,1,0
2015,Officer,29653,4,4,0
2015,Officer,29706,1,1,0
2015,Officer,29732,1,1,0
2015,Officer,29810,1,1,0
2015,Officer,29812,1,1,0
2015,Officer,29824,2,2,0
2015,Officer,29944,1,1,0
2015,Officer,30032,2,2,0
2015,Officer,30040,2,2,0
2015,Officer,30046,1,1,0
2015,Officer,30060,17,11,6
2015,Officer,30069,4,4,0
2015,Officer,30125,1,1,0
2015,Officer,30134,1,1,0
2015,Officer,30144,1,1,0
2015,Officer,30162,1,1,0
2015,Officer,30241,1,1,0
2015,Officer,30263,1,1,0
2015,Officer,30294,6,6,0
2015,Officer,30297,3,3,0
2015,Officer,30336,5,4,1
2015,Officer,30401,1,1,0
2015,Officer,30461,2,2,0
2015,Officer,30501,1,1,0
2015,Officer,30577,1,0,1
2015,Officer,30635,3,3,0
2015,Officer,30655,2,1,1
2015,Officer,30680,8,8,0
2015,Officer,30701,2,1,1
2015,Officer,30830,1,1,0
2015,Officer,30904,5,5,0
2015,Officer,30905,2,2,0
2015,Officer,31015,1,0,1
2015,Officer,31021,1,1,0
2015,Officer,31029,7,7,0
2015,Officer,31061,3,3,0
2015,Officer,31211,6,5,1
2015,Officer,31313,1,1,0
2015,Officer,31314,2,2,0
2015,Officer,31329,1,1,0
2015,Officer,31406,6,5,1
2015,Officer,31520,1,1,0
2015,Officer,31533,1,1,0
2015,Officer,31701,1,1,0
2015,Officer,31901,2,2,0
2015,Officer,31905,1,1,0
2015,Officer,32064,1,1,0
2015,Officer,32084,1,1,0
2015,Officer,32086,4,4,0
2015,Officer,32091,7,7,0
2015,Officer,32177,1,1,0
2015,Officer,32221,5,5,0
2015,Officer,32311,3,3,0
2015,Officer,32351,1,1,0
2015,Officer,32406,1,1,0
2015,Officer,32425,1,1,0
2015,Officer,32447,1,1,0
2015,Officer,32514,2,2,0
2015,Officer,32609,1,1,0
2015,Officer,32724,2,2,0
2015,Officer,32727,1,1,0
2015,Officer,32771,1,1,0
2015,Officer,32806,3,3,0
2015,Officer,32827,1,1,0
2015,Officer,32924,1,1,0
2015,Officer,32935,1,1,0
2015,Officer,33025,3,3,0
2015,Officer,33127,6,6,0
2015,Officer,33315,1,1,0
2015,Officer,33406,2,2,0
2015,Officer,33523,1,1,0
2015,Officer,33563,2,2,0
2015,Officer,33567,1,1,0
2015,Officer,33711,5,5,0
2015,Officer,33762,2,2,0
2015,Officer,33782,7,7,0
2015,Officer,33916,2,2,0
2015,Officer,34142,1,1,0
2015,Officer,34208,2,2,0
2015,Officer,34221,1,1,0
2015,Officer,34237,1,1,0
2015,Officer,34604,1,1,0
2015,Officer,35010,1,1,0
2015,Officer,35040,1,1,0
2015,Officer,35072,2,2,0
2015,Officer,35121,1,1,0
2015,Officer,35124,1,1,0
2015,Officer,35150,2,2,0
2015,Officer,35161,5,5,0
2015,Officer,35209,4,4,0
2015,Officer,35217,5,5,0
2015,Officer,35405,2,2,0
2015,Officer,35555,1,1,0
2015,Officer,35565,4,4,0
2015,Officer,35613,1,1,0
2015,Officer,35630,2,2,0
2015,Officer,35660,1,1,0
2015,Officer,35803,2,2,0
2015,Officer,35805,3,3,0
2015,Officer,35904,4,4,0
2015,Officer,36043,3,3,0
2015,Officer,36067,1,1,0
2015,Officer,36078,1,1,0
2015,Officer,36109,4,4,0
2015,Officer,36203,4,4,0
2015,Officer,36205,7,7,0
2015,Officer,36251,2,2,0
2015,Officer,36265,4,4,0
2015,Officer,36301,3,3,0
2015,Officer,36322,1,1,0
2015,Officer,36330,3,3,0
2015,Officer,36340,1,1,0
2015,Officer,36344,2,2,0
2015,Officer,36442,2,2,0
2015,Officer,36502,1,1,0
2015,Officer,36532,1,1,0
2015,Officer,36605,2,2,0
2015,Officer,36608,3,3,0
2015,Officer,36801,2,2,0
2015,Officer,36854,2,2,0
2015,Officer,37015,2,2,0
2015,Officer,37056,3,2,1
2015,Officer,37083,1,1,0
2015,Officer,37090,3,3,0
2015,Officer,37091,1,1,0
2015,Officer,37097,1,1,0
2015,Officer,37160,1,1,0
2015,Officer,37167,11,11,0
2015,Officer,37172,1,1,0
2015,Officer,37185,1,1,0
2015,Officer,37204,21,12,9
2015,Officer,37327,1,1,0
2015,Officer,37388,2,2,0
2015,Officer,37398,1,1,0
2015,Officer,37404,4,3,1
2015,Officer,37615,3,3,0
2015,Officer,37644,1,1,0
2015,Officer,37645,1,1,0
2015,Officer,37743,1,1,0
2015,Officer,37760,1,1,0
2015,Officer,37771,1,1,0
2015,Officer,37777,1,1,0
2015,Officer,37821,3,3,0
2015,Officer,37854,1,1,0
2015,Officer,37874,1,0,1
2015,Officer,37919,8,8,0
2015,Officer,37939,2,2,0
2015,Officer,38001,1,1,0
2015,Officer,38053,1,1,0
2015,Officer,38118,5,4,1
2015,Officer,38261,1,1,0
2015,Officer,38302,4,4,0
2015,Officer,38340,2,1,1
2015,Officer,38343,1,1,0
2015,Officer,38358,5,4,1
2015,Officer,38401,1,1,0
2015,Officer,38464,1,1,0
2015,Officer,38478,1,1,0
2015,Officer,38485,2,2,0
2015,Officer,38506,5,4,1
2015,Officer,38556,1,1,0
2015,Officer,38570,2,1,1
2015,Officer,38635,1,1,0
2015,Officer,38655,1,1,0
2015,Officer,38663,1,1,0
2015,Officer,38668,2,2,0
2015,Officer,38671,1,1,0
2015,Officer,38751,2,2,0
2015,Officer,38801,3,3,0
2015,Officer,38803,6,6,0
2015,Officer,38821,5,4,1
2015,Officer,38829,2,1,1
2015,Officer,38843,1,1,0
2015,Officer,38851,1,1,0
2015,Officer,38863,2,2,0
2015,Officer,38901,2,2,0
2015,Officer,38915,2,2,0
2015,Officer,38916,1,1,0
2015,Officer,38926,1,1,0
2015,Officer,38935,1,1,0
2015,Officer,38965,1,1,0
2015,Officer,39043,2,2,0
2015,Officer,39059,3,2,1
2015,Officer,39060,4,4,0
2015,Officer,39168,1,1,0
2015,Officer,39183,2,2,0
2015,Officer,39204,3,3,0
2015,Officer,39209,4,4,0
2015,Officer,39216,4,4,0
2015,Officer,39296,9,9,0
2015,Officer,39307,1,1,0
2015,Officer,39345,3,3,0
2015,Officer,39367,1,1,0
2015,Officer,39403,2,2,0
2015,Officer,39407,4,4,0
2015,Officer,39429,1,1,0
2015,Officer,39470,1,1,0
2015,Officer,39505,1,1,0
2015,Officer,39507,6,4,2
2015,Officer,39532,1,1,0
2015,Officer,39567,1,1,0
2015,Officer,39648,1,1,0
2015,Officer,39654,1,1,0
2015,Officer,39704,1,1,0
2015,Officer,39730,1,1,0
2015,Officer,39773,2,2,0
2015,Officer,40069,1,1,0
2015,Officer,40108,2,2,0
2015,Officer,40209,2,2,0
2015,Officer,40213,1,1,0
2015,Officer,40218,3,3,0
2015,Officer,40311,1,1,0
2015,Officer,40422,2,2,0
2015,Officer,40475,5,5,0
2015,Officer,40510,2,2,0
2015,Officer,40516,1,0,1
2015,Officer,40601,7,7,0
2015,Officer,40741,1,1,0
2015,Officer,40831,1,0,1
2015,Officer,40906,1,1,0
2015,Officer,40965,1,1,0
2015,Officer,41005,5,5,0
2015,Officer,41008,3,2,1
2015,Officer,41056,2,2,0
2015,Officer,41094,3,3,0
2015,Officer,41101,3,3,0
2015,Officer,41164,2,1,1
2015,Officer,42025,1,0,1
2015,Officer,42071,1,1,0
2015,Officer,42086,3,3,0
2015,Officer,42101,4,4,0
2015,Officer,42167,1,1,0
2015,Officer,42240,1,1,0
2015,Officer,42301,2,2,0
2015,Officer,42345,1,1,0
2015,Officer,42431,1,1,0
2015,Officer,42718,1,1,0
2015,Officer,42754,1,1,0
2015,Officer,43055,2,2,0
2015,Officer,43102,1,0,1
2015,Officer,43213,8,5,3
2015,Officer,43217,8,7,1
2015,Officer,43235,10,7,3
2015,Officer,43402,2,1,1
2015,Officer,43465,10,9,1
2015,Officer,43614,1,1,0
2015,Officer,43756,1,1,0
2015,Officer,44023,2,1,1
2015,Officer,44055,1,1,0
2015,Officer,44128,2,2,0
2015,Officer,44142,1,0,1
2015,Officer,44224,5,5,0
2015,Officer,44256,2,2,0
2015,Officer,44313,3,3,0
2015,Officer,44444,2,2,0
2015,Officer,44515,1,1,0
2015,Officer,44720,1,0,1
2015,Officer,44870,1,1,0
2015,Officer,44883,1,1,0
2015,Officer,44903,1,1,0
2015,Officer,45015,4,3,1
2015,Officer,45036,1,1,0
2015,Officer,45044,1,0,1
2015,Officer,45215,4,4,0
2015,Officer,45331,1,1,0
2015,Officer,45346,1,0,1
2015,Officer,45356,1,1,0
2015,Officer,45430,4,3,1
2015,Officer,45502,2,2,0
2015,Officer,45662,1,1,0
2015,Officer,45804,1,1,0
2015,Officer,46012,3,2,1
2015,Officer,46036,2,2,0
2015,Officer,46052,1,1,0
2015,Officer,46122,1,1,0
2015,Officer,46124,2,2,0
2015,Officer,46131,10,7,3
2015,Officer,46135,2,2,0
2015,Officer,46151,1,1,0
2015,Officer,46176,5,3,2
2015,Officer,46208,2,2,0
2015,Officer,46216,7,7,0
2015,Officer,46241,18,15,3
2015,Officer,46323,2,2,0
2015,Officer,46350,2,2,0
2015,Officer,46383,2,1,1
2015,Officer,46402,2,2,0
2015,Officer,46613,1,0,1
2015,Officer,46714,1,1,0
2015,Officer,46750,1,1,0
2015,Officer,46825,5,5,0
2015,Officer,46901,1,1,0
2015,Officer,46953,1,1,0
2015,Officer,46970,3,3,0
2015,Officer,47150,1,0,1
2015,Officer,47170,1,0,1
2015,Officer,47274,2,2,0
2015,Officer,47303,9,9,0
2015,Officer,47348,1,1,0
2015,Officer,47394,3,3,0
2015,Officer,47401,3,3,0
2015,Officer,47421,2,2,0
2015,Officer,47501,1,1,0
2015,Officer,47546,7,6,1
2015,Officer,47715,6,4,2
2015,Officer,47834,1,1,0
2015,Officer,47905,7,7,0
2015,Officer,47933,2,2,0
2015,Officer,47960,1,0,1
2015,Officer,47978,1,1,0
2015,Officer,48060,1,1,0
2015,Officer,48180,12,11,1
2015,Officer,48197,3,3,0
2015,Officer,48234,9,8,1
2015,Officer,48446,1,0,1
2015,Officer,48601,3,3,0
2015,Officer,48837,4,4,0
2015,Officer,48838,2,2,0
2015,Officer,48906,8,5,3
2015,Officer,48912,5,4,1
2015,Officer,49009,5,5,0
2015,Officer,49047,1,1,0
2015,Officer,49202,1,1,0
2015,Officer,49224,1,1,0
2015,Officer,49437,1,1,0
2015,Officer,49509,5,5,0
2015,Officer,49601,1,1,0
2015,Officer,49739,5,5,0
2015,Officer,49837,1,1,0
2015,Officer,49849,2,2,0
2015,Officer,49935,1,1,0
2015,Officer,50036,9,8,1
2015,Officer,50126,1,1,0
2015,Officer,50131,15,15,0
2015,Officer,50511,1,1,0
2015,Officer,50703,3,3,0
2015,Officer,50841,1,1,0
2015,Officer,51111,2,2,0
2015,Officer,51301,1,1,0
2015,Officer,51334,1,1,0
2015,Officer,51442,1,1,0
2015,Officer,52002,2,2,0
2015,Officer,52246,4,3,1
2015,Officer,52404,4,2,2
2015,Officer,52501,1,1,0
2015,Officer,52556,3,3,0
2015,Officer,52632,1,1,0
2015,Officer,52641,1,1,0
2015,Officer,52806,1,1,0
2015,Officer,53089,1,1,0
2015,Officer,53094,1,1,0
2015,Officer,53095,1,1,0
2015,Officer,53105,1,0,1
2015,Officer,53121,1,1,0
2015,Officer,53144,1,0,1
2015,Officer,53186,1,1,0
2015,Officer,53212,5,5,0
2015,Officer,53403,1,1,0
2015,Officer,53511,2,2,0
2015,Officer,53538,1,1,0
2015,Officer,53704,7,5,2
2015,Officer,53818,1,1,0
2015,Officer,54241,1,1,0
2015,Officer,54401,1,1,0
2015,Officer,54449,2,2,0
2015,Officer,54455,1,1,0
2015,Officer,54456,2,2,0
2015,Officer,54481,1,1,0
2015,Officer,54495,2,2,0
2015,Officer,54612,1,1,0
2015,Officer,54618,10,10,0
2015,Officer,54650,1,0,1
2015,Officer,54703,2,2,0
2015,Officer,54729,1,1,0
2015,Officer,54806,1,0,1
2015,Officer,54843,1,1,0
2015,Officer,54914,1,1,0
2015,Officer,55008,1,1,0
2015,Officer,55016,6,5,1
2015,Officer,55057,1,1,0
2015,Officer,55060,1,1,0
2015,Officer,55063,1,1,0
2015,Officer,55068,5,5,0
2015,Officer,55077,2,2,0
2015,Officer,55101,6,6,0
2015,Officer,55106,1,1,0
2015,Officer,55107,5,4,1
2015,Officer,55111,1,1,0
2015,Officer,55112,4,3,1
2015,Officer,55118,1,1,0
2015,Officer,55355,1,1,0
2015,Officer,55431,4,4,0
2015,Officer,55746,1,1,0
2015,Officer,55811,1,1,0
2015,Officer,55904,1,1,0
2015,Officer,56031,1,1,0
2015,Officer,56256,1,1,0
2015,Officer,56303,4,3,1
2015,Officer,56345,2,1,1
2015,Officer,56378,1,1,0
2015,Officer,56560,4,3,1
2015,Officer,56601,1,1,0
2015,Officer,56701,1,0,1
2015,Officer,57006,1,1,0
2015,Officer,57042,2,2,0
2015,Officer,57069,3,3,0
2015,Officer,57078,1,1,0
2015,Officer,57104,6,4,2
2015,Officer,57201,2,2,0
2015,Officer,57301,1,1,0
2015,Officer,57366,1,1,0
2015,Officer,57401,2,2,0
2015,Officer,57702,4,4,0
2015,Officer,57717,1,1,0
2015,Officer,58072,1,1,0
2015,Officer,58102,5,5,0
2015,Officer,58201,2,2,0
2015,Officer,58301,2,2,0
2015,Officer,58433,1,1,0
2015,Officer,58506,9,7,2
2015,Officer,59047,1,1,0
2015,Officer,59102,5,5,0
2015,Officer,59405,1,1,0
2015,Officer,59602,9,9,0
2015,Officer,59636,11,9,2
2015,Officer,59701,5,5,0
2015,Officer,59714,2,2,0
2015,Officer,59725,1,1,0
2015,Officer,59808,2,2,0
2015,Officer,59901,2,2,0
2015,Officer,60472,7,7,0
2015,Officer,60546,8,8,0
2015,Officer,60615,5,5,0
2015,Officer,60651,3,3,0
2015,Officer,61032,1,1,0
2015,Officer,61115,5,5,0
2015,Officer,61264,4,4,0
2015,Officer,61341,3,3,0
2015,Officer,61401,3,3,0
2015,Officer,61443,3,3,0
2015,Officer,61455,3,3,0
2015,Officer,61607,8,8,0
2015,Officer,61734,1,1,0
2015,Officer,61761,1,1,0
2015,Officer,61764,1,1,0
2015,Officer,61801,8,8,0
2015,Officer,61820,1,1,0
2015,Officer,61834,2,2,0
2015,Officer,62205,2,2,0
2015,Officer,62301,1,1,0
2015,Officer,62521,1,1,0
2015,Officer,62618,1,1,0
2015,Officer,62702,14,14,0
2015,Officer,62864,4,4,0
2015,Officer,62896,1,1,0
2015,Officer,62959,2,2,0
2015,Officer,62966,1,1,0
2015,Officer,63028,1,1,0
2015,Officer,63044,3,2,1
2015,Officer,63109,1,1,0
2015,Officer,63125,5,5,0
2015,Officer,63383,1,0,1
2015,Officer,63501,1,1,0
2015,Officer,63552,2,2,0
2015,Officer,63703,5,5,0
2015,Officer,63755,1,1,0
2015,Officer,63841,1,0,1
2015,Officer,63857,1,1,0
2015,Officer,63935,1,1,0
2015,Officer,64052,1,1,0
2015,Officer,64085,2,1,1
2015,Officer,64093,1,1,0
2015,Officer,64129,10,6,4
2015,Officer,64468,1,0,1
2015,Officer,64506,1,1,0
2015,Officer,64601,1,1,0
2015,Officer,64701,2,1,1
2015,Officer,64735,3,3,0
2015,Officer,64759,9,9,0
2015,Officer,64772,1,0,1
2015,Officer,64804,2,2,0
2015,Officer,64850,2,2,0
2015,Officer,65101,5,5,0
2015,Officer,65109,2,2,0
2015,Officer,65202,2,2,0
2015,Officer,65233,1,1,0
2015,Officer,65301,2,1,1
2015,Officer,65305,6,5,1
2015,Officer,65340,1,1,0
2015,Officer,65473,2,2,0
2015,Officer,65536,3,3,0
2015,Officer,65802,3,2,1
2015,Officer,65803,2,1,1
2015,Officer,66027,5,5,0
2015,Officer,66044,2,2,0
2015,Officer,66061,4,4,0
2015,Officer,66071,1,1,0
2015,Officer,66102,9,7,2
2015,Officer,66219,6,4,2
2015,Officer,66434,3,3,0
2015,Officer,66441,1,1,0
2015,Officer,66502,2,2,0
2015,Officer,66503,1,1,0
2015,Officer,66611,5,4,1
2015,Officer,66619,5,4,1
2015,Officer,66762,1,1,0
2015,Officer,66967,1,1,0
2015,Officer,67010,3,3,0
2015,Officer,67114,1,1,0
2015,Officer,67219,3,3,0
2015,Officer,67337,1,1,0
2015,Officer,67401,1,1,0
2015,Officer,67501,1,1,0
2015,Officer,67801,2,2,0
2015,Officer,68073,2,1,1
2015,Officer,68106,1,1,0
2015,Officer,68142,3,2,1
2015,Officer,68310,2,2,0
2015,Officer,68410,3,3,0
2015,Officer,68508,4,4,0
2015,Officer,68524,8,7,1
2015,Officer,68801,1,0,1
2015,Officer,68901,1,1,0
2015,Officer,69101,1,1,0
2015,Officer,69337,1,1,0
2015,Officer,70117,9,8,1
2015,Officer,70364,2,2,0
2015,Officer,70390,2,2,0
2015,Officer,70401,4,4,0
2015,Officer,70427,1,1,0
2015,Officer,70438,1,1,0
2015,Officer,70508,1,1,0
2015,Officer,70510,1,1,0
2015,Officer,70563,3,3,0
2015,Officer,70582,2,2,0
2015,Officer,70714,1,1,0
2015,Officer,70721,7,5,2
2015,Officer,70760,1,1,0
2015,Officer,70764,2,2,0
2015,Officer,70820,5,5,0
2015,Officer,71019,2,2,0
2015,Officer,71055,1,1,0
2015,Officer,71101,4,4,0
2015,Officer,71270,1,1,0
2015,Officer,71360,12,9,3
2015,Officer,71457,3,3,0
2015,Officer,71459,1,1,0
2015,Officer,71602,1,1,0
2015,Officer,71913,1,1,0
2015,Officer,71923,2,2,0
2015,Officer,71953,2,2,0
2015,Officer,72012,3,2,1
2015,Officer,72023,1,1,0
2015,Officer,72064,1,1,0
2015,Officer,72086,4,3,1
2015,Officer,72104,1,0,1
2015,Officer,72110,1,1,0
2015,Officer,72114,1,1,0
2015,Officer,72150,2,2,0
2015,Officer,72199,16,12,4
2015,Officer,72390,1,1,0
2015,Officer,72401,5,4,1
2015,Officer,72450,1,1,0
2015,Officer,72461,1,1,0
2015,Officer,72476,1,1,0
2015,Officer,72501,2,2,0
2015,Officer,72601,1,1,0
2015,Officer,72701,2,2,0
2015,Officer,72712,2,2,0
2015,Officer,72756,3,2,1
2015,Officer,72761,2,2,0
2015,Officer,72830,1,1,0
2015,Officer,72834,1,1,0
2015,Officer,73034,2,2,0
2015,Officer,73036,2,2,0
2015,Officer,73051,2,2,0
2015,Officer,73064,3,2,1
2015,Officer,73069,7,6,1
2015,Officer,73111,3,3,0
2015,Officer,73141,1,1,0
2015,Officer,73503,3,3,0
2015,Officer,73521,1,1,0
2015,Officer,74003,1,1,0
2015,Officer,74012,1,1,0
2015,Officer,74014,6,5,1
2015,Officer,74017,3,3,0
2015,Officer,74075,5,4,1
2015,Officer,74107,5,5,0
2015,Officer,74116,1,1,0
2015,Officer,74301,2,2,0
2015,Officer,74403,4,3,1
2015,Officer,74447,2,1,1
2015,Officer,74501,3,3,0
2015,Officer,74601,2,2,0
2015,Officer,74804,2,2,0
2015,Officer,74820,1,1,0
2015,Officer,74834,1,1,0
2015,Officer,74953,1,1,0
2015,Officer,75020,1,1,0
2015,Officer,75051,17,17,0
2015,Officer,75077,1,1,0
2015,Officer,75098,2,2,0
2015,Officer,75110,2,2,0
2015,Officer,75159,1,1,0
2015,Officer,75160,1,1,0
2015,Officer,75165,1,1,0
2015,Officer,75237,4,4,0
2015,Officer,75662,2,2,0
2015,Officer,75709,2,2,0
2015,Officer,75803,2,2,0
2015,Officer,75901,1,1,0
2015,Officer,76086,2,2,0
2015,Officer,76105,4,4,0
2015,Officer,76108,2,2,0
2015,Officer,76115,1,1,0
2015,Officer,76234,3,3,0
2015,Officer,76302,5,5,0
2015,Officer,76401,1,1,0
2015,Officer,76502,4,4,0
2015,Officer,76528,1,1,0
2015,Officer,76542,2,2,0
2015,Officer,76574,1,1,0
2015,Officer,76707,3,3,0
2015,Officer,76801,3,3,0
2015,Officer,76905,1,1,0
2015,Officer,77034,8,8,0
2015,Officer,77067,7,6,1
2015,Officer,77082,9,9,0
2015,Officer,77515,1,1,0
2015,Officer,77568,2,2,0
2015,Officer,77802,3,3,0
2015,Officer,77904,1,1,0
2015,Officer,78041,4,4,0
2015,Officer,78130,5,5,0
2015,Officer,78155,1,1,0
2015,Officer,78218,6,6,0
2015,Officer,78219,6,6,0
2015,Officer,78257,16,16,0
2015,Officer,78363,1,1,0
2015,Officer,78416,1,1,0
2015,Officer,78520,2,2,0
2015,Officer,78596,5,5,0
2015,Officer,78617,6,6,0
2015,Officer,78665,4,4,0
2015,Officer,78666,5,5,0
2015,Officer,78703,44,40,4
2015,Officer,78731,14,14,0
2015,Officer,78746,6,6,0
2015,Officer,78861,1,1,0
2015,Officer,79403,3,3,0
2015,Officer,79924,1,1,0
2015,Officer,79936,9,9,0
2015,Officer,80011,16,16,0
2015,Officer,80012,1,1,0
2015,Officer,80112,4,4,0
2015,Officer,80137,4,4,0
2015,Officer,80216,3,3,0
2015,Officer,80501,1,1,0
2015,Officer,80504,3,3,0
2015,Officer,80521,3,3,0
2015,Officer,80550,1,1,0
2015,Officer,80907,4,4,0
2015,Officer,80913,2,2,0
2015,Officer,80916,4,4,0
2015,Officer,80920,7,6,1
2015,Officer,81050,1,1,0
2015,Officer,81401,1,1,0
2015,Officer,82009,3,3,0
2015,Officer,82072,3,2,1
2015,Officer,82214,2,2,0
2015,Officer,82520,1,1,0
2015,Officer,82716,5,4,1
2015,Officer,82801,1,1,0
2015,Officer,83301,1,1,0
2015,Officer,83318,1,1,0
2015,Officer,83501,1,1,0
2015,Officer,83544,1,1,0
2015,Officer,83617,1,1,0
2015,Officer,83647,1,1,0
2015,Officer,83687,1,1,0
2015,Officer,83705,14,12,2
2015,Officer,83843,1,1,0
2015,Officer,83854,1,1,0
2015,Officer,84020,16,12,4
2015,Officer,84043,3,3,0
2015,Officer,84065,30,26,4
2015,Officer,84074,2,2,0
2015,Officer,84084,14,13,1
2015,Officer,84116,3,3,0
2015,Officer,84321,1,1,0
2015,Officer,84323,1,1,0
2015,Officer,84404,1,1,0
2015,Officer,84405,4,3,1
2015,Officer,84631,1,1,0
2015,Officer,84642,2,2,0
2015,Officer,84660,3,3,0
2015,Officer,84663,2,2,0
2015,Officer,84720,3,3,0
2015,Officer,84790,2,2,0
2015,Officer,85008,30,26,4
2015,Officer,85020,2,2,0
2015,Officer,85122,4,4,0
2015,Officer,85132,4,4,0
2015,Officer,85201,2,2,0
2015,Officer,85281,3,2,1
2015,Officer,85286,1,1,0
2015,Officer,85301,1,1,0
2015,Officer,85653,7,7,0
2015,Officer,85706,4,4,0
2015,Officer,85713,1,1,0
2015,Officer,86015,5,5,0
2015,Officer,86301,2,2,0
2015,Officer,87002,4,4,0
2015,Officer,87123,10,7,3
2015,Officer,87144,4,4,0
2015,Officer,87401,4,4,0
2015,Officer,87508,5,5,0
2015,Officer,87532,1,1,0
2015,Officer,87747,2,2,0
2015,Officer,88007,5,4,1
2015,Officer,88101,1,1,0
2015,Officer,88310,1,1,0
2015,Officer,89032,1,1,0
2015,Officer,89115,4,4,0
2015,Officer,89139,3,3,0
2015,Officer,89165,2,2,0
2015,Officer,89447,1,1,0
2015,Officer,89506,11,11,0
2015,Officer,89509,3,3,0
2015,Officer,89701,1,1,0
2015,Officer,90201,2,2,0
2015,Officer,90266,1,1,0
2015,Officer,90302,1,1,0
2015,Officer,90640,2,2,0
2015,Officer,90720,25,25,0
2015,Officer,90813,1,1,0
2015,Officer,90822,7,7,0
2015,Officer,91406,2,2,0
2015,Officer,91702,5,5,0
2015,Officer,91764,1,1,0
2015,Officer,91766,3,3,0
2015,Officer,91950,1,1,0
2015,Officer,92020,2,2,0
2015,Officer,92111,5,5,0
2015,Officer,92324,2,2,0
2015,Officer,92501,1,1,0
2015,Officer,92518,5,5,0
2015,Officer,92707,1,1,0
2015,Officer,92833,1,1,0
2015,Officer,92866,1,1,0
2015,Officer,92879,1,1,0
2015,Officer,93003,4,4,0
2015,Officer,93103,1,1,0
2015,Officer,93257,1,1,0
2015,Officer,93291,1,1,0
2015,Officer,93307,1,1,0
2015,Officer,93451,4,4,0
2015,Officer,93550,2,2,0
2015,Officer,93638,1,1,0
2015,Officer,93702,1,1,0
2015,Officer,93727,2,2,0
2015,Officer,94066,1,1,0
2015,Officer,94401,2,2,0
2015,Officer,94510,1,1,0
2015,Officer,94533,2,2,0
2015,Officer,94545,1,1,0
2015,Officer,94565,2,2,0
2015,Officer,94590,2,2,0
2015,Officer,94804,2,2,0
2015,Officer,95206,2,2,0
2015,Officer,95240,1,1,0
2015,Officer,95351,1,1,0
2015,Officer,95401,4,4,0
2015,Officer,95678,1,1,0
2015,Officer,95826,3,3,0
2015,Officer,95828,13,13,0
2015,Officer,96080,1,1,0
2015,Officer,96707,15,13,2
2015,Officer,96720,3,3,0
2015,Officer,96732,2,2,0
2015,Officer,96782,3,3,0
2015,Officer,96786,4,4,0
2015,Officer,96789,1,1,0
2015,Officer,96816,5,3,2
2015,Officer,96857,1,1,0
2015,Officer,96913,6,6,0
2015,Officer,97015,8,8,0
2015,Officer,97058,1,1,0
2015,Officer,97128,1,1,0
2015,Officer,97211,7,4,3
2015,Officer,97217,1,1,0
2015,Officer,97218,4,4,0
2015,Officer,97301,1,1,0
2015,Officer,97302,5,4,1
2015,Officer,97304,1,1,0
2015,Officer,97309,10,5,5
2015,Officer,97330,1,1,0
2015,Officer,97338,1,1,0
2015,Officer,97470,2,2,0
2015,Officer,97477,3,3,0
2015,Officer,97501,3,1,2
2015,Officer,97520,1,1,0
2015,Officer,97702,1,1,0
2015,Officer,97756,1,1,0
2015,Officer,97838,2,2,0
2015,Officer,97850,1,1,0
2015,Officer,97914,1,0,1
2015,Officer,98032,3,3,0
2015,Officer,98052,1,1,0
2015,Officer,98108,2,2,0
2015,Officer,98119,12,12,0
2015,Officer,98221,2,2,0
2015,Officer,98271,4,4,0
2015,Officer,98312,5,5,0
2015,Officer,98321,4,4,0
2015,Officer,98366,2,2,0
2015,Officer,98430,20,20,0
2015,Officer,98433,4,4,0
2015,Officer,98501,2,2,0
2015,Officer,98682,1,1,0
2015,Officer,98901,1,1,0
2015,Officer,98903,2,2,0
2015,Officer,98930,1,1,0
2015,Officer,99011,6,6,0
2015,Officer,99217,2,2,0
2015,Officer,99219,2,2,0
2015,Officer,99301,2,2,0
2015,Officer,99362,1,1,0
2015,Officer,99502,1,1,0
2015,Officer,99505,21,19,2
2015,Officer,99701,5,4,1
2015,Officer,99731,1,1,0
2015,Officer,99752,1,1,0
2015,Officer,99821,1,1,0
2015,Warrant Officer,00850,1,1,0
2015,Warrant Officer,00901,1,1,0
2015,Warrant Officer,01013,1,1,0
2015,Warrant Officer,01731,3,3,0
2015,Warrant Officer,01760,1,1,0
2015,Warrant Officer,02420,1,1,0
2015,Warrant Officer,02542,6,6,0
2015,Warrant Officer,02852,2,2,0
2015,Warrant Officer,03301,1,1,0
2015,Warrant Officer,04333,1,1,0
2015,Warrant Officer,04401,7,7,0
2015,Warrant Officer,05403,1,1,0
2015,Warrant Officer,05661,1,1,0
2015,Warrant Officer,06096,3,3,0
2015,Warrant Officer,06105,1,1,0
2015,Warrant Officer,06340,2,2,0
2015,Warrant Officer,07090,1,1,0
2015,Warrant Officer,07666,1,1,0
2015,Warrant Officer,08533,1,1,0
2015,Warrant Officer,08628,1,1,0
2015,Warrant Officer,08640,2,2,0
2015,Warrant Officer,08648,5,5,0
2015,Warrant Officer,08733,4,4,0
2015,Warrant Officer,08759,1,1,0
2015,Warrant Officer,10314,2,2,0
2015,Warrant Officer,10567,1,1,0
2015,Warrant Officer,11433,2,2,0
2015,Warrant Officer,11779,2,2,0
2015,Warrant Officer,12110,1,1,0
2015,Warrant Officer,12180,1,1,0
2015,Warrant Officer,12302,2,2,0
2015,Warrant Officer,13211,2,2,0
2015,Warrant Officer,14213,1,1,0
2015,Warrant Officer,14624,3,3,0
2015,Warrant Officer,15216,1,1,0
2015,Warrant Officer,15902,4,4,0
2015,Warrant Officer,15904,2,2,0
2015,Warrant Officer,16101,1,1,0
2015,Warrant Officer,17003,12,12,0
2015,Warrant Officer,17103,1,1,0
2015,Warrant Officer,17821,1,1,0
2015,Warrant Officer,19044,4,4,0
2015,Warrant Officer,19154,1,1,0
2015,Warrant Officer,19460,1,1,0
2015,Warrant Officer,19720,3,3,0
2015,Warrant Officer,20003,4,4,0
2015,Warrant Officer,20653,1,1,0
2015,Warrant Officer,20708,1,1,0
2015,Warrant Officer,21010,5,5,0
2015,Warrant Officer,21057,2,2,0
2015,Warrant Officer,21136,1,1,0
2015,Warrant Officer,21201,1,1,0
2015,Warrant Officer,22032,1,1,0
2015,Warrant Officer,22060,2,2,0
2015,Warrant Officer,23150,6,5,1
2015,Warrant Officer,23237,1,1,0
2015,Warrant Officer,23824,2,2,0
2015,Warrant Officer,24401,2,2,0
2015,Warrant Officer,24502,1,1,0
2015,Warrant Officer,25064,1,1,0
2015,Warrant Officer,25311,3,3,0
2015,Warrant Officer,25704,1,1,0
2015,Warrant Officer,26003,4,4,0
2015,Warrant Officer,26187,1,1,0
2015,Warrant Officer,26537,1,1,0
2015,Warrant Officer,26554,1,1,0
2015,Warrant Officer,27401,1,1,0
2015,Warrant Officer,27560,3,3,0
2015,Warrant Officer,27607,2,2,0
2015,Warrant Officer,28001,4,4,0
2015,Warrant Officer,28012,1,1,0
2015,Warrant Officer,28054,1,1,0
2015,Warrant Officer,28147,1,1,0
2015,Warrant Officer,28208,1,1,0
2015,Warrant Officer,28310,1,1,0
2015,Warrant Officer,28328,2,2,0
2015,Warrant Officer,28560,1,1,0
2015,Warrant Officer,28645,1,1,0
2015,Warrant Officer,29044,9,9,0
2015,Warrant Officer,29115,1,1,0
2015,Warrant Officer,29506,1,1,0
2015,Warrant Officer,29512,1,1,0
2015,Warrant Officer,30040,2,2,0
2015,Warrant Officer,30060,4,4,0
2015,Warrant Officer,30294,1,1,0
2015,Warrant Officer,30297,1,1,0
2015,Warrant Officer,30680,2,2,0
2015,Warrant Officer,30904,1,1,0
2015,Warrant Officer,31040,1,1,0
2015,Warrant Officer,31211,2,2,0
2015,Warrant Officer,31314,3,3,0
2015,Warrant Officer,31406,1,1,0
2015,Warrant Officer,31409,1,1,0
2015,Warrant Officer,31794,1,1,0
2015,Warrant Officer,31905,1,1,0
2015,Warrant Officer,32091,1,1,0
2015,Warrant Officer,32114,2,2,0
2015,Warrant Officer,32221,4,4,0
2015,Warrant Officer,32447,1,1,0
2015,Warrant Officer,32827,1,1,0
2015,Warrant Officer,33782,1,1,0
2015,Warrant Officer,33873,1,1,0
2015,Warrant Officer,34474,3,3,0
2015,Warrant Officer,34604,2,2,0
2015,Warrant Officer,35209,1,1,0
2015,Warrant Officer,35405,1,1,0
2015,Warrant Officer,35565,1,1,0
2015,Warrant Officer,35594,1,1,0
2015,Warrant Officer,35601,4,4,0
2015,Warrant Officer,35613,1,1,0
2015,Warrant Officer,35803,1,1,0
2015,Warrant Officer,36010,1,1,0
2015,Warrant Officer,36043,1,1,0
2015,Warrant Officer,36078,1,1,0
2015,Warrant Officer,36109,6,6,0
2015,Warrant Officer,36203,1,1,0
2015,Warrant Officer,36205,1,1,0
2015,Warrant Officer,36251,2,2,0
2015,Warrant Officer,36362,1,1,0
2015,Warrant Officer,36605,2,2,0
2015,Warrant Officer,36608,1,1,0
2015,Warrant Officer,36701,1,1,0
2015,Warrant Officer,36832,1,1,0
2015,Warrant Officer,37167,4,4,0
2015,Warrant Officer,37388,1,1,0
2015,Warrant Officer,37404,1,1,0
2015,Warrant Officer,37777,1,1,0
2015,Warrant Officer,38301,2,2,0
2015,Warrant Officer,38663,1,1,0
2015,Warrant Officer,38801,2,2,0
2015,Warrant Officer,38803,1,1,0
2015,Warrant Officer,38901,1,1,0
2015,Warrant Officer,39051,1,1,0
2015,Warrant Officer,39307,1,1,0
2015,Warrant Officer,39407,2,2,0
2015,Warrant Officer,39440,1,1,0
2015,Warrant Officer,39501,1,1,0
2015,Warrant Officer,39505,2,2,0
2015,Warrant Officer,39567,1,1,0
2015,Warrant Officer,39760,2,2,0
2015,Warrant Officer,40475,1,1,0
2015,Warrant Officer,40601,2,2,0
2015,Warrant Officer,41005,1,1,0
2015,Warrant Officer,43213,1,1,0
2015,Warrant Officer,43217,7,7,0
2015,Warrant Officer,43452,2,2,0
2015,Warrant Officer,43756,1,1,0
2015,Warrant Officer,44720,3,3,0
2015,Warrant Officer,45502,1,1,0
2015,Warrant Officer,45804,1,1,0
2015,Warrant Officer,46124,1,1,0
2015,Warrant Officer,46176,4,4,0
2015,Warrant Officer,46241,2,2,0
2015,Warrant Officer,46901,2,2,0
2015,Warrant Officer,47303,1,1,0
2015,Warrant Officer,47374,1,1,0
2015,Warrant Officer,47804,1,1,0
2015,Warrant Officer,48180,1,1,0
2015,Warrant Officer,48234,1,1,0
2015,Warrant Officer,48706,1,1,0
2015,Warrant Officer,48843,1,1,0
2015,Warrant Officer,48906,2,2,0
2015,Warrant Officer,49201,2,2,0
2015,Warrant Officer,49306,1,1,0
2015,Warrant Officer,50036,1,1,0
2015,Warrant Officer,52806,1,1,0
2015,Warrant Officer,53095,1,1,0
2015,Warrant Officer,53144,1,1,0
2015,Warrant Officer,53190,1,1,0
2015,Warrant Officer,53212,1,1,0
2015,Warrant Officer,53704,5,5,0
2015,Warrant Officer,53948,1,1,0
2015,Warrant Officer,54409,1,1,0
2015,Warrant Officer,54656,1,1,0
2015,Warrant Officer,54665,1,1,0
2015,Warrant Officer,54902,1,1,0
2015,Warrant Officer,55101,1,1,0
2015,Warrant Officer,55107,2,2,0
2015,Warrant Officer,55431,1,1,0
2015,Warrant Officer,56303,1,1,0
2015,Warrant Officer,56345,1,1,0
2015,Warrant Officer,57703,2,2,0
2015,Warrant Officer,58102,3,3,0
2015,Warrant Officer,58506,1,1,0
2015,Warrant Officer,59602,4,4,0
2015,Warrant Officer,59636,3,3,0
2015,Warrant Officer,59725,1,1,0
2015,Warrant Officer,60546,1,1,0
2015,Warrant Officer,60638,2,2,0
2015,Warrant Officer,60651,1,1,0
2015,Warrant Officer,61607,2,2,0
2015,Warrant Officer,61801,1,1,0
2015,Warrant Officer,62301,1,1,0
2015,Warrant Officer,62521,1,1,0
2015,Warrant Officer,62702,3,3,0
2015,Warrant Officer,64506,2,2,0
2015,Warrant Officer,64804,1,1,0
2015,Warrant Officer,65101,1,1,0
2015,Warrant Officer,65202,1,1,0
2015,Warrant Officer,65301,4,4,0
2015,Warrant Officer,65305,3,3,0
2015,Warrant Officer,65473,3,3,0
2015,Warrant Officer,65803,1,1,0
2015,Warrant Officer,66027,2,2,0
2015,Warrant Officer,66061,1,1,0
2015,Warrant Officer,66502,5,5,0
2015,Warrant Officer,66611,1,1,0
2015,Warrant Officer,66619,1,1,0
2015,Warrant Officer,67401,1,1,0
2015,Warrant Officer,67654,1,1,0
2015,Warrant Officer,68066,1,1,0
2015,Warrant Officer,68524,3,3,0
2015,Warrant Officer,68801,3,3,0
2015,Warrant Officer,69361,1,1,0
2015,Warrant Officer,70401,7,7,0
2015,Warrant Officer,71360,5,5,0
2015,Warrant Officer,72023,1,1,0
2015,Warrant Officer,72199,4,4,0
2015,Warrant Officer,72701,2,2,0
2015,Warrant Officer,72927,1,1,0
2015,Warrant Officer,73051,4,4,0
2015,Warrant Officer,73064,1,1,0
2015,Warrant Officer,73069,6,6,0
2015,Warrant Officer,73111,1,1,0
2015,Warrant Officer,74012,1,1,0
2015,Warrant Officer,74014,1,1,0
2015,Warrant Officer,75237,1,1,0
2015,Warrant Officer,76115,1,1,0
2015,Warrant Officer,76502,3,3,0
2015,Warrant Officer,77034,2,2,0
2015,Warrant Officer,77515,1,1,0
2015,Warrant Officer,78218,1,1,0
2015,Warrant Officer,78219,6,6,0
2015,Warrant Officer,78617,6,6,0
2015,Warrant Officer,78665,1,1,0
2015,Warrant Officer,78703,3,3,0
2015,Warrant Officer,78731,1,1,0
2015,Warrant Officer,80011,4,4,0
2015,Warrant Officer,80012,1,1,0
2015,Warrant Officer,80112,4,4,0
2015,Warrant Officer,80137,1,1,0
2015,Warrant Officer,80216,1,1,0
2015,Warrant Officer,80916,1,1,0
2015,Warrant Officer,81212,1,1,0
2015,Warrant Officer,82009,3,3,0
2015,Warrant Officer,82716,1,1,0
2015,Warrant Officer,83705,4,4,0
2015,Warrant Officer,83854,1,1,0
2015,Warrant Officer,84020,3,3,0
2015,Warrant Officer,84065,4,4,0
2015,Warrant Officer,84084,3,3,0
2015,Warrant Officer,84405,1,1,0
2015,Warrant Officer,84720,1,1,0
2015,Warrant Officer,85008,10,10,0
2015,Warrant Officer,85653,6,6,0
2015,Warrant Officer,87144,1,1,0
2015,Warrant Officer,87401,1,1,0
2015,Warrant Officer,87508,3,3,0
2015,Warrant Officer,88007,2,2,0
2015,Warrant Officer,89139,2,2,0
2015,Warrant Officer,89165,1,1,0
2015,Warrant Officer,89506,7,7,0
2015,Warrant Officer,89701,1,1,0
2015,Warrant Officer,90201,2,2,0
2015,Warrant Officer,90720,6,6,0
2015,Warrant Officer,92111,1,1,0
2015,Warrant Officer,93003,1,1,0
2015,Warrant Officer,93405,1,1,0
2015,Warrant Officer,93422,1,1,0
2015,Warrant Officer,93727,2,2,0
2015,Warrant Officer,94043,1,1,0
2015,Warrant Officer,94804,1,1,0
2015,Warrant Officer,94903,2,2,0
2015,Warrant Officer,95206,3,3,0
2015,Warrant Officer,95401,1,1,0
2015,Warrant Officer,95655,2,2,0
2015,Warrant Officer,95826,1,1,0
2015,Warrant Officer,95828,2,2,0
2015,Warrant Officer,95832,1,1,0
2015,Warrant Officer,96707,5,5,0
2015,Warrant Officer,96857,1,1,0
2015,Warrant Officer,97015,1,1,0
2015,Warrant Officer,97302,4,4,0
2015,Warrant Officer,97801,1,1,0
2015,Warrant Officer,98321,1,1,0
2015,Warrant Officer,98430,3,3,0
2015,Warrant Officer,98433,5,5,0
2015,Warrant Officer,99011,2,2,0
2015,Warrant Officer,99505,8,8,0
2016,Enlisted,     ,5,1,4
2016,Enlisted,00602,16,6,10
2016,Enlisted,00605,6,3,3
2016,Enlisted,00612,12,2,10
2016,Enlisted,00623,9,2,7
2016,Enlisted,00624,17,0,17
2016,Enlisted,00641,13,3,10
2016,Enlisted,00681,24,4,20
2016,Enlisted,00683,6,1,5
2016,Enlisted,00693,13,1,12
2016,Enlisted,00705,7,2,5
2016,Enlisted,00714,6,0,6
2016,Enlisted,00725,6,2,4
2016,Enlisted,00732,2,1,1
2016,Enlisted,00733,8,0,8
2016,Enlisted,00735,9,1,8
2016,Enlisted,00736,4,0,4
2016,Enlisted,00737,19,1,18
2016,Enlisted,00751,35,4,31
2016,Enlisted,00769,16,1,15
2016,Enlisted,00777,9,0,9
2016,Enlisted,00785,13,1,12
2016,Enlisted,00792,4,2,2
2016,Enlisted,00795,134,5,129
2016,Enlisted,00802,23,0,23
2016,Enlisted,00820,3,1,2
2016,Enlisted,00850,37,8,29
2016,Enlisted,00851,3,0,3
2016,Enlisted,00901,12,7,5
2016,Enlisted,00934,42,9,33
2016,Enlisted,00951,9,1,8
2016,Enlisted,00963,14,1,13
2016,Enlisted,01013,7,7,0
2016,Enlisted,01022,1,1,0
2016,Enlisted,01030,24,1,23
2016,Enlisted,01062,10,3,7
2016,Enlisted,01082,22,3,19
2016,Enlisted,01085,23,4,19
2016,Enlisted,01109,13,2,11
2016,Enlisted,01201,12,3,9
2016,Enlisted,01301,21,6,15
2016,Enlisted,01434,46,9,37
2016,Enlisted,01440,13,4,9
2016,Enlisted,01453,12,2,10
2016,Enlisted,01588,12,2,10
2016,Enlisted,01605,47,18,29
2016,Enlisted,01702,2,2,0
2016,Enlisted,01731,8,6,2
2016,Enlisted,01760,22,11,11
2016,Enlisted,01844,21,4,17
2016,Enlisted,01867,31,6,25
2016,Enlisted,01923,33,3,30
2016,Enlisted,01950,6,2,4
2016,Enlisted,02043,26,0,26
2016,Enlisted,02122,17,5,12
2016,Enlisted,02138,19,2,17
2016,Enlisted,02169,10,2,8
2016,Enlisted,02176,26,8,18
2016,Enlisted,02184,25,5,20
2016,Enlisted,02301,55,8,47
2016,Enlisted,02324,8,0,8
2016,Enlisted,02346,12,2,10
2016,Enlisted,02420,10,2,8
2016,Enlisted,02465,4,0,4
2016,Enlisted,02532,18,7,11
2016,Enlisted,02542,55,9,46
2016,Enlisted,02724,25,4,21
2016,Enlisted,02769,10,1,9
2016,Enlisted,02780,13,2,11
2016,Enlisted,02809,3,0,3
2016,Enlisted,02818,96,15,81
2016,Enlisted,02842,7,7,0
2016,Enlisted,02852,26,5,21
2016,Enlisted,02885,23,2,21
2016,Enlisted,02886,13,4,9
2016,Enlisted,02896,4,0,4
2016,Enlisted,02904,9,1,8
2016,Enlisted,02920,1,1,0
2016,Enlisted,03055,27,6,21
2016,Enlisted,03060,14,1,13
2016,Enlisted,03101,35,6,29
2016,Enlisted,03235,3,1,2
2016,Enlisted,03244,13,2,11
2016,Enlisted,03264,2,1,1
2016,Enlisted,03301,38,11,27
2016,Enlisted,03570,9,1,8
2016,Enlisted,03766,27,2,25
2016,Enlisted,03801,5,1,4
2016,Enlisted,03867,1,0,1
2016,Enlisted,03878,16,3,13
2016,Enlisted,04011,15,1,14
2016,Enlisted,04073,7,1,6
2016,Enlisted,04092,10,0,10
2016,Enlisted,04240,4,1,3
2016,Enlisted,04268,2,0,2
2016,Enlisted,04330,11,3,8
2016,Enlisted,04333,4,0,4
2016,Enlisted,04401,28,8,20
2016,Enlisted,04412,20,7,13
2016,Enlisted,04619,3,0,3
2016,Enlisted,04730,5,1,4
2016,Enlisted,04736,4,1,3
2016,Enlisted,04901,20,5,15
2016,Enlisted,04915,8,0,8
2016,Enlisted,04976,5,2,3
2016,Enlisted,05001,8,1,7
2016,Enlisted,05033,8,2,6
2016,Enlisted,05158,17,3,14
2016,Enlisted,05201,9,2,7
2016,Enlisted,05403,8,3,5
2016,Enlisted,05404,6,1,5
2016,Enlisted,05446,17,5,12
2016,Enlisted,05450,6,1,5
2016,Enlisted,05465,55,12,43
2016,Enlisted,05478,7,0,7
2016,Enlisted,05488,5,0,5
2016,Enlisted,05491,3,1,2
2016,Enlisted,05495,9,3,6
2016,Enlisted,05602,2,0,2
2016,Enlisted,05661,3,0,3
2016,Enlisted,05663,15,2,13
2016,Enlisted,05676,12,4,8
2016,Enlisted,05701,14,5,9
2016,Enlisted,05851,15,9,6
2016,Enlisted,05855,5,1,4
2016,Enlisted,06051,15,2,13
2016,Enlisted,06066,7,2,5
2016,Enlisted,06082,19,2,17
2016,Enlisted,06096,22,4,18
2016,Enlisted,06105,4,4,0
2016,Enlisted,06110,36,8,28
2016,Enlisted,06320,23,8,15
2016,Enlisted,06333,3,0,3
2016,Enlisted,06340,12,4,8
2016,Enlisted,06357,27,10,17
2016,Enlisted,06360,24,3,21
2016,Enlisted,06457,70,13,57
2016,Enlisted,06489,15,1,14
2016,Enlisted,06498,16,0,16
2016,Enlisted,06512,31,6,25
2016,Enlisted,06614,27,9,18
2016,Enlisted,06702,8,0,8
2016,Enlisted,06810,28,5,23
2016,Enlisted,07052,40,10,30
2016,Enlisted,07090,18,4,14
2016,Enlisted,07095,22,9,13
2016,Enlisted,07107,28,6,22
2016,Enlisted,07306,65,8,57
2016,Enlisted,07457,19,5,14
2016,Enlisted,07666,40,14,26
2016,Enlisted,07728,43,11,32
2016,Enlisted,07801,89,7,82
2016,Enlisted,07840,8,1,7
2016,Enlisted,07865,28,3,25
2016,Enlisted,07960,29,5,24
2016,Enlisted,08002,1,1,0
2016,Enlisted,08012,21,9,12
2016,Enlisted,08060,26,9,17
2016,Enlisted,08096,36,11,25
2016,Enlisted,08098,11,7,4
2016,Enlisted,08210,26,1,25
2016,Enlisted,08360,15,6,9
2016,Enlisted,08401,5,1,4
2016,Enlisted,08628,3,2,1
2016,Enlisted,08640,9,8,1
2016,Enlisted,08648,10,8,2
2016,Enlisted,08733,39,11,28
2016,Enlisted,08750,25,5,20
2016,Enlisted,08753,28,7,21
2016,Enlisted,08759,11,5,6
2016,Enlisted,08822,17,4,13
2016,Enlisted,08873,38,8,30
2016,Enlisted,09096,1,0,1
2016,Enlisted,10010,79,19,60
2016,Enlisted,10314,45,5,40
2016,Enlisted,10468,13,2,11
2016,Enlisted,10566,27,6,21
2016,Enlisted,10567,76,19,57
2016,Enlisted,10701,42,11,31
2016,Enlisted,10962,29,6,23
2016,Enlisted,11252,105,28,77
2016,Enlisted,11357,32,2,30
2016,Enlisted,11433,62,14,48
2016,Enlisted,11735,116,24,92
2016,Enlisted,11779,44,6,38
2016,Enlisted,12078,19,6,13
2016,Enlisted,12110,46,14,32
2016,Enlisted,12180,29,8,21
2016,Enlisted,12189,11,5,6
2016,Enlisted,12302,38,14,24
2016,Enlisted,12311,1,0,1
2016,Enlisted,12401,16,4,12
2016,Enlisted,12451,5,0,5
2016,Enlisted,12553,30,11,19
2016,Enlisted,12804,20,4,16
2016,Enlisted,12962,9,0,9
2016,Enlisted,12983,3,2,1
2016,Enlisted,13021,16,3,13
2016,Enlisted,13211,43,19,24
2016,Enlisted,13501,63,19,44
2016,Enlisted,13602,18,12,6
2016,Enlisted,13669,10,1,9
2016,Enlisted,13856,8,1,7
2016,Enlisted,13905,26,10,16
2016,Enlisted,14048,5,0,5
2016,Enlisted,14094,8,0,8
2016,Enlisted,14204,63,17,46
2016,Enlisted,14213,42,9,33
2016,Enlisted,14304,14,6,8
2016,Enlisted,14454,18,10,8
2016,Enlisted,14456,18,8,10
2016,Enlisted,14624,68,17,51
2016,Enlisted,14701,8,2,6
2016,Enlisted,14760,2,1,1
2016,Enlisted,14843,9,0,9
2016,Enlisted,14845,9,2,7
2016,Enlisted,14850,12,4,8
2016,Enlisted,15010,25,6,19
2016,Enlisted,15216,48,13,35
2016,Enlisted,15301,23,6,17
2016,Enlisted,15370,9,1,8
2016,Enlisted,15425,22,4,18
2016,Enlisted,15537,3,1,2
2016,Enlisted,15541,19,2,17
2016,Enlisted,15601,6,3,3
2016,Enlisted,15666,27,7,20
2016,Enlisted,15701,19,1,18
2016,Enlisted,15767,5,1,4
2016,Enlisted,15779,4,0,4
2016,Enlisted,15902,7,2,5
2016,Enlisted,15904,86,10,76
2016,Enlisted,16001,27,4,23
2016,Enlisted,16101,14,2,12
2016,Enlisted,16148,11,2,9
2016,Enlisted,16226,15,2,13
2016,Enlisted,16301,14,1,13
2016,Enlisted,16403,66,14,52
2016,Enlisted,16635,7,1,6
2016,Enlisted,16648,3,0,3
2016,Enlisted,16652,3,2,1
2016,Enlisted,16735,7,1,6
2016,Enlisted,16738,11,4,7
2016,Enlisted,16803,41,4,37
2016,Enlisted,16830,23,1,22
2016,Enlisted,16901,3,1,2
2016,Enlisted,17003,223,35,188
2016,Enlisted,17013,34,10,24
2016,Enlisted,17022,11,1,10
2016,Enlisted,17033,6,4,2
2016,Enlisted,17042,32,9,23
2016,Enlisted,17044,11,1,10
2016,Enlisted,17098,7,3,4
2016,Enlisted,17103,52,11,41
2016,Enlisted,17201,14,1,13
2016,Enlisted,17222,10,2,8
2016,Enlisted,17325,26,6,20
2016,Enlisted,17331,4,1,3
2016,Enlisted,17404,5,2,3
2016,Enlisted,17701,17,2,15
2016,Enlisted,17745,28,4,24
2016,Enlisted,17821,31,10,21
2016,Enlisted,17837,20,4,16
2016,Enlisted,18040,34,5,29
2016,Enlisted,18102,14,3,11
2016,Enlisted,18201,14,4,10
2016,Enlisted,18235,12,2,10
2016,Enlisted,18252,1,0,1
2016,Enlisted,18301,4,0,4
2016,Enlisted,18407,6,2,4
2016,Enlisted,18431,18,4,14
2016,Enlisted,18466,7,1,6
2016,Enlisted,18509,32,7,25
2016,Enlisted,18634,6,1,5
2016,Enlisted,18643,2,1,1
2016,Enlisted,18651,11,2,9
2016,Enlisted,18704,41,7,34
2016,Enlisted,18834,10,1,9
2016,Enlisted,18960,10,1,9
2016,Enlisted,19044,24,2,22
2016,Enlisted,19090,33,5,28
2016,Enlisted,19103,11,3,8
2016,Enlisted,19104,14,3,11
2016,Enlisted,19153,29,4,25
2016,Enlisted,19154,130,20,110
2016,Enlisted,19320,62,17,45
2016,Enlisted,19460,19,1,18
2016,Enlisted,19462,41,6,35
2016,Enlisted,19475,9,2,7
2016,Enlisted,19526,4,2,2
2016,Enlisted,19530,34,4,30
2016,Enlisted,19605,51,7,44
2016,Enlisted,19706,40,2,38
2016,Enlisted,19711,24,3,21
2016,Enlisted,19720,26,11,15
2016,Enlisted,19804,23,4,19
2016,Enlisted,19808,1,1,0
2016,Enlisted,19930,5,5,0
2016,Enlisted,19939,12,2,10
2016,Enlisted,19947,11,0,11
2016,Enlisted,19973,25,4,21
2016,Enlisted,19977,11,4,7
2016,Enlisted,20003,86,41,45
2016,Enlisted,20112,18,11,7
2016,Enlisted,20175,12,1,11
2016,Enlisted,20186,12,5,7
2016,Enlisted,20373,31,9,22
2016,Enlisted,20623,12,5,7
2016,Enlisted,20646,13,7,6
2016,Enlisted,20653,5,2,3
2016,Enlisted,20708,90,55,35
2016,Enlisted,20755,1,1,0
2016,Enlisted,20770,9,1,8
2016,Enlisted,20783,1,1,0
2016,Enlisted,20882,11,4,7
2016,Enlisted,20904,12,5,7
2016,Enlisted,21010,39,14,25
2016,Enlisted,21043,24,4,20
2016,Enlisted,21057,12,6,6
2016,Enlisted,21061,33,11,22
2016,Enlisted,21078,17,2,15
2016,Enlisted,21136,28,9,19
2016,Enlisted,21201,2,2,0
2016,Enlisted,21204,17,9,8
2016,Enlisted,21208,16,3,13
2016,Enlisted,21216,23,5,18
2016,Enlisted,21222,12,8,4
2016,Enlisted,21228,27,3,24
2016,Enlisted,21236,11,3,8
2016,Enlisted,21401,15,9,6
2016,Enlisted,21502,9,2,7
2016,Enlisted,21601,3,1,2
2016,Enlisted,21701,24,10,14
2016,Enlisted,21719,28,7,21
2016,Enlisted,21740,8,1,7
2016,Enlisted,21801,18,3,15
2016,Enlisted,21921,4,0,4
2016,Enlisted,22032,11,8,3
2016,Enlisted,22060,30,16,14
2016,Enlisted,22401,55,14,41
2016,Enlisted,22427,11,4,7
2016,Enlisted,22601,36,12,24
2016,Enlisted,22664,7,4,3
2016,Enlisted,22731,10,1,9
2016,Enlisted,22801,15,2,13
2016,Enlisted,22902,31,6,25
2016,Enlisted,23069,20,6,14
2016,Enlisted,23139,8,0,8
2016,Enlisted,23150,52,18,34
2016,Enlisted,23181,23,4,19
2016,Enlisted,23237,21,5,16
2016,Enlisted,23417,9,1,8
2016,Enlisted,23451,65,15,50
2016,Enlisted,23502,36,9,27
2016,Enlisted,23666,25,2,23
2016,Enlisted,23701,38,16,22
2016,Enlisted,23805,19,7,12
2016,Enlisted,23824,44,23,21
2016,Enlisted,23847,11,2,9
2016,Enlisted,23851,4,0,4
2016,Enlisted,23901,4,0,4
2016,Enlisted,24073,7,2,5
2016,Enlisted,24112,12,5,7
2016,Enlisted,24151,15,1,14
2016,Enlisted,24210,7,0,7
2016,Enlisted,24251,18,3,15
2016,Enlisted,24301,10,0,10
2016,Enlisted,24401,11,5,6
2016,Enlisted,24422,9,2,7
2016,Enlisted,24450,5,2,3
2016,Enlisted,24502,51,11,40
2016,Enlisted,24523,4,0,4
2016,Enlisted,24531,1,0,1
2016,Enlisted,24541,6,1,5
2016,Enlisted,24592,12,0,12
2016,Enlisted,24609,7,1,6
2016,Enlisted,24701,21,1,20
2016,Enlisted,24801,2,0,2
2016,Enlisted,24957,14,3,11
2016,Enlisted,25064,1,0,1
2016,Enlisted,25168,37,7,30
2016,Enlisted,25262,7,0,7
2016,Enlisted,25309,2,0,2
2016,Enlisted,25311,3,3,0
2016,Enlisted,25401,28,3,25
2016,Enlisted,25530,40,20,20
2016,Enlisted,25550,21,9,12
2016,Enlisted,25601,5,0,5
2016,Enlisted,25625,5,0,5
2016,Enlisted,25661,3,0,3
2016,Enlisted,25704,7,1,6
2016,Enlisted,25846,59,6,53
2016,Enlisted,26003,6,5,1
2016,Enlisted,26041,20,0,20
2016,Enlisted,26101,15,5,10
2016,Enlisted,26187,36,30,6
2016,Enlisted,26201,9,0,9
2016,Enlisted,26241,11,2,9
2016,Enlisted,26250,3,1,2
2016,Enlisted,26301,14,1,13
2016,Enlisted,26426,10,2,8
2016,Enlisted,26505,11,3,8
2016,Enlisted,26537,37,19,18
2016,Enlisted,26554,20,2,18
2016,Enlisted,26624,3,0,3
2016,Enlisted,26651,13,2,11
2016,Enlisted,26726,2,0,2
2016,Enlisted,26836,8,1,7
2016,Enlisted,27028,5,2,3
2016,Enlisted,27030,7,1,6
2016,Enlisted,27103,36,15,21
2016,Enlisted,27204,6,2,4
2016,Enlisted,27217,32,11,21
2016,Enlisted,27260,12,5,7
2016,Enlisted,27292,12,4,8
2016,Enlisted,27320,21,3,18
2016,Enlisted,27344,9,3,6
2016,Enlisted,27360,8,4,4
2016,Enlisted,27401,27,10,17
2016,Enlisted,27504,16,5,11
2016,Enlisted,27509,20,11,9
2016,Enlisted,27515,4,2,2
2016,Enlisted,27530,22,12,10
2016,Enlisted,27549,7,4,3
2016,Enlisted,27560,44,21,23
2016,Enlisted,27573,8,1,7
2016,Enlisted,27577,22,16,6
2016,Enlisted,27581,7,3,4
2016,Enlisted,27596,4,2,2
2016,Enlisted,27607,7,5,2
2016,Enlisted,27704,25,12,13
2016,Enlisted,27803,10,4,6
2016,Enlisted,27828,2,1,1
2016,Enlisted,27830,1,1,0
2016,Enlisted,27856,10,5,5
2016,Enlisted,27870,6,6,0
2016,Enlisted,27874,1,0,1
2016,Enlisted,27886,5,1,4
2016,Enlisted,27889,7,7,0
2016,Enlisted,27892,10,7,3
2016,Enlisted,27897,9,4,5
2016,Enlisted,27909,2,0,2
2016,Enlisted,27932,9,1,8
2016,Enlisted,28001,12,10,2
2016,Enlisted,28012,14,7,7
2016,Enlisted,28027,20,5,15
2016,Enlisted,28043,16,3,13
2016,Enlisted,28054,13,4,9
2016,Enlisted,28086,7,1,6
2016,Enlisted,28092,9,2,7
2016,Enlisted,28110,6,3,3
2016,Enlisted,28115,4,1,3
2016,Enlisted,28147,9,4,5
2016,Enlisted,28170,29,5,24
2016,Enlisted,28208,61,23,38
2016,Enlisted,28306,10,6,4
2016,Enlisted,28310,15,10,5
2016,Enlisted,28328,14,11,3
2016,Enlisted,28334,14,8,6
2016,Enlisted,28337,5,3,2
2016,Enlisted,28345,22,6,16
2016,Enlisted,28352,11,4,7
2016,Enlisted,28359,18,14,4
2016,Enlisted,28365,5,4,1
2016,Enlisted,28371,4,2,2
2016,Enlisted,28376,33,17,16
2016,Enlisted,28377,16,12,4
2016,Enlisted,28379,16,6,10
2016,Enlisted,28382,12,6,6
2016,Enlisted,28384,6,1,5
2016,Enlisted,28387,2,0,2
2016,Enlisted,28388,6,0,6
2016,Enlisted,28401,1,1,0
2016,Enlisted,28405,21,10,11
2016,Enlisted,28470,6,2,4
2016,Enlisted,28472,3,2,1
2016,Enlisted,28504,20,10,10
2016,Enlisted,28518,4,2,2
2016,Enlisted,28540,30,18,12
2016,Enlisted,28560,17,3,14
2016,Enlisted,28577,4,1,3
2016,Enlisted,28580,5,3,2
2016,Enlisted,28590,21,5,16
2016,Enlisted,28601,25,7,18
2016,Enlisted,28607,9,1,8
2016,Enlisted,28621,5,1,4
2016,Enlisted,28645,40,8,32
2016,Enlisted,28655,4,1,3
2016,Enlisted,28658,8,1,7
2016,Enlisted,28659,9,1,8
2016,Enlisted,28677,2,0,2
2016,Enlisted,28681,13,4,9
2016,Enlisted,28721,23,3,20
2016,Enlisted,28726,13,6,7
2016,Enlisted,28734,19,3,16
2016,Enlisted,28752,1,0,1
2016,Enlisted,28779,3,2,1
2016,Enlisted,28806,10,2,8
2016,Enlisted,28906,2,0,2
2016,Enlisted,29006,27,4,23
2016,Enlisted,29020,15,2,13
2016,Enlisted,29044,82,23,59
2016,Enlisted,29102,9,1,8
2016,Enlisted,29108,10,2,8
2016,Enlisted,29115,4,1,3
2016,Enlisted,29138,18,3,15
2016,Enlisted,29151,10,1,9
2016,Enlisted,29161,36,4,32
2016,Enlisted,29170,12,2,10
2016,Enlisted,29201,3,3,0
2016,Enlisted,29303,12,4,8
2016,Enlisted,29325,7,1,6
2016,Enlisted,29341,23,10,13
2016,Enlisted,29360,19,5,14
2016,Enlisted,29379,32,8,24
2016,Enlisted,29385,13,1,12
2016,Enlisted,29403,12,6,6
2016,Enlisted,29409,3,1,2
2016,Enlisted,29418,24,6,18
2016,Enlisted,29440,8,2,6
2016,Enlisted,29461,26,5,21
2016,Enlisted,29465,28,2,26
2016,Enlisted,29483,33,3,30
2016,Enlisted,29488,12,1,11
2016,Enlisted,29506,7,3,4
2016,Enlisted,29510,7,3,4
2016,Enlisted,29512,37,6,31
2016,Enlisted,29526,1,0,1
2016,Enlisted,29532,10,1,9
2016,Enlisted,29536,6,2,4
2016,Enlisted,29544,9,1,8
2016,Enlisted,29550,11,1,10
2016,Enlisted,29556,26,4,22
2016,Enlisted,29571,8,2,6
2016,Enlisted,29574,24,7,17
2016,Enlisted,29577,11,2,9
2016,Enlisted,29605,33,8,25
2016,Enlisted,29620,11,0,11
2016,Enlisted,29625,18,6,12
2016,Enlisted,29631,23,5,18
2016,Enlisted,29641,7,1,6
2016,Enlisted,29644,24,8,16
2016,Enlisted,29646,11,1,10
2016,Enlisted,29651,18,7,11
2016,Enlisted,29653,20,5,15
2016,Enlisted,29678,11,1,10
2016,Enlisted,29706,12,1,11
2016,Enlisted,29715,13,1,12
2016,Enlisted,29720,12,0,12
2016,Enlisted,29732,15,5,10
2016,Enlisted,29810,3,1,2
2016,Enlisted,29812,11,0,11
2016,Enlisted,29824,22,5,17
2016,Enlisted,29829,25,7,18
2016,Enlisted,29835,9,0,9
2016,Enlisted,29906,19,3,16
2016,Enlisted,29944,6,1,5
2016,Enlisted,30014,18,0,18
2016,Enlisted,30032,33,3,30
2016,Enlisted,30040,134,25,109
2016,Enlisted,30046,19,7,12
2016,Enlisted,30060,77,27,50
2016,Enlisted,30069,69,15,54
2016,Enlisted,30114,16,5,11
2016,Enlisted,30125,15,6,9
2016,Enlisted,30134,9,1,8
2016,Enlisted,30144,39,8,31
2016,Enlisted,30161,36,5,31
2016,Enlisted,30224,8,4,4
2016,Enlisted,30233,12,1,11
2016,Enlisted,30240,24,10,14
2016,Enlisted,30263,8,5,3
2016,Enlisted,30294,48,13,35
2016,Enlisted,30297,61,21,40
2016,Enlisted,30336,127,15,112
2016,Enlisted,30401,9,3,6
2016,Enlisted,30427,20,5,15
2016,Enlisted,30439,10,6,4
2016,Enlisted,30461,2,0,2
2016,Enlisted,30501,7,3,4
2016,Enlisted,30577,17,4,13
2016,Enlisted,30635,10,2,8
2016,Enlisted,30643,8,2,6
2016,Enlisted,30655,14,4,10
2016,Enlisted,30673,18,9,9
2016,Enlisted,30680,44,20,24
2016,Enlisted,30701,14,2,12
2016,Enlisted,30720,12,5,7
2016,Enlisted,30824,7,1,6
2016,Enlisted,30830,9,4,5
2016,Enlisted,30904,59,11,48
2016,Enlisted,30905,18,10,8
2016,Enlisted,31015,20,5,15
2016,Enlisted,31029,32,10,22
2016,Enlisted,31040,15,7,8
2016,Enlisted,31061,19,4,15
2016,Enlisted,31211,42,12,30
2016,Enlisted,31313,9,4,5
2016,Enlisted,31314,99,39,60
2016,Enlisted,31329,14,1,13
2016,Enlisted,31406,47,13,34
2016,Enlisted,31409,26,14,12
2016,Enlisted,31520,9,4,5
2016,Enlisted,31533,14,0,14
2016,Enlisted,31601,12,6,6
2016,Enlisted,31701,7,0,7
2016,Enlisted,31792,36,6,30
2016,Enlisted,31794,8,2,6
2016,Enlisted,31901,16,2,14
2016,Enlisted,31905,20,6,14
2016,Enlisted,32055,10,8,2
2016,Enlisted,32064,26,11,15
2016,Enlisted,32084,18,3,15
2016,Enlisted,32086,2,2,0
2016,Enlisted,32091,102,52,50
2016,Enlisted,32114,3,2,1
2016,Enlisted,32164,24,10,14
2016,Enlisted,32177,5,1,4
2016,Enlisted,32221,109,53,56
2016,Enlisted,32311,31,17,14
2016,Enlisted,32351,10,5,5
2016,Enlisted,32406,22,7,15
2016,Enlisted,32425,11,7,4
2016,Enlisted,32428,8,4,4
2016,Enlisted,32447,14,3,11
2016,Enlisted,32514,29,13,16
2016,Enlisted,32536,11,2,9
2016,Enlisted,32609,3,2,1
2016,Enlisted,32724,4,2,2
2016,Enlisted,32727,4,2,2
2016,Enlisted,32771,21,15,6
2016,Enlisted,32806,12,10,2
2016,Enlisted,32827,5,4,1
2016,Enlisted,32856,4,1,3
2016,Enlisted,32924,13,7,6
2016,Enlisted,32935,28,14,14
2016,Enlisted,33020,16,7,9
2016,Enlisted,33024,5,2,3
2016,Enlisted,33025,31,10,21
2016,Enlisted,33039,3,0,3
2016,Enlisted,33127,45,7,38
2016,Enlisted,33315,21,11,10
2016,Enlisted,33405,4,1,3
2016,Enlisted,33406,29,6,23
2016,Enlisted,33523,20,9,11
2016,Enlisted,33563,8,3,5
2016,Enlisted,33567,11,1,10
2016,Enlisted,33606,12,6,6
2016,Enlisted,33711,20,11,9
2016,Enlisted,33782,96,46,50
2016,Enlisted,33811,21,9,12
2016,Enlisted,33825,4,0,4
2016,Enlisted,33830,15,2,13
2016,Enlisted,33844,1,1,0
2016,Enlisted,33859,17,6,11
2016,Enlisted,33873,1,1,0
2016,Enlisted,33880,14,10,4
2016,Enlisted,33916,6,2,4
2016,Enlisted,34208,9,2,7
2016,Enlisted,34221,3,1,2
2016,Enlisted,34237,7,5,2
2016,Enlisted,34266,23,10,13
2016,Enlisted,34429,19,8,11
2016,Enlisted,34474,21,17,4
2016,Enlisted,34604,5,4,1
2016,Enlisted,34748,8,5,3
2016,Enlisted,34947,13,4,9
2016,Enlisted,35010,18,2,16
2016,Enlisted,35040,5,4,1
2016,Enlisted,35042,18,7,11
2016,Enlisted,35055,28,11,17
2016,Enlisted,35072,6,1,5
2016,Enlisted,35121,28,5,23
2016,Enlisted,35124,26,10,16
2016,Enlisted,35146,12,6,6
2016,Enlisted,35150,8,0,8
2016,Enlisted,35161,33,12,21
2016,Enlisted,35178,7,2,5
2016,Enlisted,35209,18,4,14
2016,Enlisted,35217,24,10,14
2016,Enlisted,35405,25,3,22
2016,Enlisted,35442,8,2,6
2016,Enlisted,35476,15,3,12
2016,Enlisted,35501,8,3,5
2016,Enlisted,35555,4,2,2
2016,Enlisted,35565,14,5,9
2016,Enlisted,35592,3,1,2
2016,Enlisted,35594,8,3,5
2016,Enlisted,35601,18,5,13
2016,Enlisted,35613,8,3,5
2016,Enlisted,35630,25,2,23
2016,Enlisted,35660,2,1,1
2016,Enlisted,35710,8,6,2
2016,Enlisted,35768,7,1,6
2016,Enlisted,35803,43,13,30
2016,Enlisted,35805,26,8,18
2016,Enlisted,35904,19,8,11
2016,Enlisted,35967,12,10,2
2016,Enlisted,36009,13,3,10
2016,Enlisted,36010,12,3,9
2016,Enlisted,36016,3,0,3
2016,Enlisted,36032,11,0,11
2016,Enlisted,36043,36,7,29
2016,Enlisted,36067,23,4,19
2016,Enlisted,36072,5,4,1
2016,Enlisted,36078,22,8,14
2016,Enlisted,36081,11,1,10
2016,Enlisted,36083,11,3,8
2016,Enlisted,36109,19,10,9
2016,Enlisted,36117,2,1,1
2016,Enlisted,36121,5,1,4
2016,Enlisted,36203,12,3,9
2016,Enlisted,36205,47,12,35
2016,Enlisted,36250,8,4,4
2016,Enlisted,36251,4,0,4
2016,Enlisted,36265,28,12,16
2016,Enlisted,36302,22,7,15
2016,Enlisted,36322,8,5,3
2016,Enlisted,36323,3,0,3
2016,Enlisted,36330,32,8,24
2016,Enlisted,36331,1,0,1
2016,Enlisted,36340,10,4,6
2016,Enlisted,36344,4,1,3
2016,Enlisted,36421,15,3,12
2016,Enlisted,36426,7,1,6
2016,Enlisted,36442,4,1,3
2016,Enlisted,36460,4,3,1
2016,Enlisted,36502,15,3,12
2016,Enlisted,36522,2,0,2
2016,Enlisted,36532,14,4,10
2016,Enlisted,36535,17,7,10
2016,Enlisted,36545,1,0,1
2016,Enlisted,36605,52,14,38
2016,Enlisted,36608,13,1,12
2016,Enlisted,36701,2,2,0
2016,Enlisted,36726,13,0,13
2016,Enlisted,36732,4,1,3
2016,Enlisted,36801,3,2,1
2016,Enlisted,36832,15,4,11
2016,Enlisted,36854,42,7,35
2016,Enlisted,36867,9,5,4
2016,Enlisted,37015,6,2,4
2016,Enlisted,37033,9,3,6
2016,Enlisted,37042,4,2,2
2016,Enlisted,37056,20,11,9
2016,Enlisted,37066,13,5,8
2016,Enlisted,37083,14,4,10
2016,Enlisted,37090,23,7,16
2016,Enlisted,37091,3,0,3
2016,Enlisted,37097,7,3,4
2016,Enlisted,37110,20,6,14
2016,Enlisted,37129,43,12,31
2016,Enlisted,37160,7,0,7
2016,Enlisted,37167,61,30,31
2016,Enlisted,37172,11,4,7
2016,Enlisted,37178,5,4,1
2016,Enlisted,37185,16,9,7
2016,Enlisted,37204,63,31,32
2016,Enlisted,37217,8,6,2
2016,Enlisted,37303,3,0,3
2016,Enlisted,37321,12,2,10
2016,Enlisted,37323,13,2,11
2016,Enlisted,37327,8,2,6
2016,Enlisted,37334,5,1,4
2016,Enlisted,37356,1,1,0
2016,Enlisted,37388,23,11,12
2016,Enlisted,37398,10,5,5
2016,Enlisted,37404,32,10,22
2016,Enlisted,37615,9,4,5
2016,Enlisted,37620,8,2,6
2016,Enlisted,37644,10,2,8
2016,Enlisted,37645,9,4,5
2016,Enlisted,37650,3,0,3
2016,Enlisted,37683,1,0,1
2016,Enlisted,37717,6,2,4
2016,Enlisted,37743,3,3,0
2016,Enlisted,37757,19,9,10
2016,Enlisted,37760,2,1,1
2016,Enlisted,37771,13,3,10
2016,Enlisted,37777,11,7,4
2016,Enlisted,37801,2,1,1
2016,Enlisted,37821,13,5,8
2016,Enlisted,37825,1,1,0
2016,Enlisted,37841,14,4,10
2016,Enlisted,37854,5,1,4
2016,Enlisted,37857,7,2,5
2016,Enlisted,37860,5,2,3
2016,Enlisted,37863,4,2,2
2016,Enlisted,37874,4,2,2
2016,Enlisted,37919,16,9,7
2016,Enlisted,37939,3,1,2
2016,Enlisted,38001,17,4,13
2016,Enlisted,38008,8,3,5
2016,Enlisted,38012,10,2,8
2016,Enlisted,38019,10,6,4
2016,Enlisted,38024,5,2,3
2016,Enlisted,38053,38,15,23
2016,Enlisted,38063,5,2,3
2016,Enlisted,38079,6,1,5
2016,Enlisted,38118,29,6,23
2016,Enlisted,38201,7,4,3
2016,Enlisted,38225,5,1,4
2016,Enlisted,38242,12,6,6
2016,Enlisted,38261,15,7,8
2016,Enlisted,38301,2,2,0
2016,Enlisted,38302,12,4,8
2016,Enlisted,38320,10,7,3
2016,Enlisted,38340,26,6,20
2016,Enlisted,38343,14,3,11
2016,Enlisted,38344,6,3,3
2016,Enlisted,38351,6,2,4
2016,Enlisted,38358,10,4,6
2016,Enlisted,38363,2,2,0
2016,Enlisted,38372,6,2,4
2016,Enlisted,38375,14,3,11
2016,Enlisted,38382,19,3,16
2016,Enlisted,38401,13,4,9
2016,Enlisted,38462,3,2,1
2016,Enlisted,38464,6,0,6
2016,Enlisted,38478,5,1,4
2016,Enlisted,38485,8,2,6
2016,Enlisted,38506,19,8,11
2016,Enlisted,38556,16,5,11
2016,Enlisted,38563,5,4,1
2016,Enlisted,38570,8,1,7
2016,Enlisted,38572,5,1,4
2016,Enlisted,38583,4,0,4
2016,Enlisted,38606,18,5,13
2016,Enlisted,38614,8,0,8
2016,Enlisted,38632,12,3,9
2016,Enlisted,38635,7,2,5
2016,Enlisted,38655,8,3,5
2016,Enlisted,38663,7,0,7
2016,Enlisted,38668,17,4,13
2016,Enlisted,38671,27,7,20
2016,Enlisted,38701,16,1,15
2016,Enlisted,38703,1,0,1
2016,Enlisted,38732,4,2,2
2016,Enlisted,38737,11,0,11
2016,Enlisted,38751,2,0,2
2016,Enlisted,38801,42,6,36
2016,Enlisted,38803,18,4,14
2016,Enlisted,38821,5,0,5
2016,Enlisted,38829,8,1,7
2016,Enlisted,38834,10,1,9
2016,Enlisted,38843,10,1,9
2016,Enlisted,38851,10,1,9
2016,Enlisted,38852,7,2,5
2016,Enlisted,38858,7,1,6
2016,Enlisted,38860,13,0,13
2016,Enlisted,38863,11,2,9
2016,Enlisted,38901,25,12,13
2016,Enlisted,38902,21,2,19
2016,Enlisted,38915,6,1,5
2016,Enlisted,38916,11,4,7
2016,Enlisted,38921,8,1,7
2016,Enlisted,38926,1,0,1
2016,Enlisted,38935,16,4,12
2016,Enlisted,38965,11,0,11
2016,Enlisted,38967,6,1,5
2016,Enlisted,39043,22,6,16
2016,Enlisted,39046,11,5,6
2016,Enlisted,39051,28,6,22
2016,Enlisted,39059,7,0,7
2016,Enlisted,39060,17,0,17
2016,Enlisted,39074,5,0,5
2016,Enlisted,39090,3,0,3
2016,Enlisted,39111,18,3,15
2016,Enlisted,39114,4,0,4
2016,Enlisted,39117,4,1,3
2016,Enlisted,39120,6,0,6
2016,Enlisted,39159,4,1,3
2016,Enlisted,39168,2,1,1
2016,Enlisted,39183,30,3,27
2016,Enlisted,39194,6,0,6
2016,Enlisted,39202,3,3,0
2016,Enlisted,39204,32,6,26
2016,Enlisted,39209,22,3,19
2016,Enlisted,39216,19,11,8
2016,Enlisted,39296,9,7,2
2016,Enlisted,39307,19,5,14
2016,Enlisted,39328,3,0,3
2016,Enlisted,39339,5,0,5
2016,Enlisted,39345,13,0,13
2016,Enlisted,39350,24,3,21
2016,Enlisted,39355,7,1,6
2016,Enlisted,39367,13,0,13
2016,Enlisted,39403,6,0,6
2016,Enlisted,39407,54,18,36
2016,Enlisted,39422,2,0,2
2016,Enlisted,39429,8,0,8
2016,Enlisted,39440,7,1,6
2016,Enlisted,39452,15,1,14
2016,Enlisted,39455,3,0,3
2016,Enlisted,39466,11,0,11
2016,Enlisted,39470,21,5,16
2016,Enlisted,39475,1,0,1
2016,Enlisted,39476,5,0,5
2016,Enlisted,39501,11,1,10
2016,Enlisted,39505,21,7,14
2016,Enlisted,39507,19,3,16
2016,Enlisted,39532,18,3,15
2016,Enlisted,39556,7,2,5
2016,Enlisted,39567,12,2,10
2016,Enlisted,39577,8,2,6
2016,Enlisted,39601,22,2,20
2016,Enlisted,39638,4,1,3
2016,Enlisted,39648,21,5,16
2016,Enlisted,39654,14,3,11
2016,Enlisted,39667,10,4,6
2016,Enlisted,39704,1,0,1
2016,Enlisted,39730,7,0,7
2016,Enlisted,39735,4,0,4
2016,Enlisted,39744,7,0,7
2016,Enlisted,39760,17,2,15
2016,Enlisted,39773,6,0,6
2016,Enlisted,40004,6,1,5
2016,Enlisted,40065,6,0,6
2016,Enlisted,40069,10,2,8
2016,Enlisted,40108,5,2,3
2016,Enlisted,40121,9,4,5
2016,Enlisted,40205,33,5,28
2016,Enlisted,40209,1,0,1
2016,Enlisted,40218,45,7,38
2016,Enlisted,40311,3,1,2
2016,Enlisted,40330,3,0,3
2016,Enlisted,40351,10,1,9
2016,Enlisted,40422,1,1,0
2016,Enlisted,40472,23,0,23
2016,Enlisted,40475,78,9,69
2016,Enlisted,40510,33,7,26
2016,Enlisted,40601,58,21,37
2016,Enlisted,40741,16,2,14
2016,Enlisted,40769,6,5,1
2016,Enlisted,40831,14,1,13
2016,Enlisted,40906,8,3,5
2016,Enlisted,40965,9,3,6
2016,Enlisted,41005,28,6,22
2016,Enlisted,41008,2,0,2
2016,Enlisted,41031,20,3,17
2016,Enlisted,41056,11,0,11
2016,Enlisted,41094,20,2,18
2016,Enlisted,41101,14,2,12
2016,Enlisted,41164,11,0,11
2016,Enlisted,41339,9,1,8
2016,Enlisted,41653,13,1,12
2016,Enlisted,41701,14,1,13
2016,Enlisted,42025,15,5,10
2016,Enlisted,42064,1,0,1
2016,Enlisted,42071,29,2,27
2016,Enlisted,42086,19,3,16
2016,Enlisted,42101,14,5,9
2016,Enlisted,42141,23,4,19
2016,Enlisted,42167,8,1,7
2016,Enlisted,42240,1,1,0
2016,Enlisted,42276,6,3,3
2016,Enlisted,42301,22,2,20
2016,Enlisted,42330,16,7,9
2016,Enlisted,42345,38,12,26
2016,Enlisted,42420,2,1,1
2016,Enlisted,42431,20,4,16
2016,Enlisted,42501,18,2,16
2016,Enlisted,42633,7,0,7
2016,Enlisted,42701,19,2,17
2016,Enlisted,42718,5,2,3
2016,Enlisted,42754,5,2,3
2016,Enlisted,43015,25,4,21
2016,Enlisted,43040,42,0,42
2016,Enlisted,43055,46,5,41
2016,Enlisted,43102,18,4,14
2016,Enlisted,43213,75,18,57
2016,Enlisted,43217,48,11,37
2016,Enlisted,43235,9,7,2
2016,Enlisted,43402,25,6,19
2016,Enlisted,43465,107,19,88
2016,Enlisted,43614,44,3,41
2016,Enlisted,43756,55,1,54
2016,Enlisted,43812,13,3,10
2016,Enlisted,44023,40,0,40
2016,Enlisted,44055,27,1,26
2016,Enlisted,44128,76,8,68
2016,Enlisted,44142,19,6,13
2016,Enlisted,44224,60,6,54
2016,Enlisted,44256,46,3,43
2016,Enlisted,44313,15,2,13
2016,Enlisted,44444,54,8,46
2016,Enlisted,44515,50,4,46
2016,Enlisted,44601,11,2,9
2016,Enlisted,44622,10,0,10
2016,Enlisted,44691,19,3,16
2016,Enlisted,44720,120,11,109
2016,Enlisted,44857,35,4,31
2016,Enlisted,44870,25,5,20
2016,Enlisted,44883,30,8,22
2016,Enlisted,44903,32,3,29
2016,Enlisted,45015,38,5,33
2016,Enlisted,45036,15,4,11
2016,Enlisted,45044,28,1,27
2016,Enlisted,45215,79,14,65
2016,Enlisted,45331,12,0,12
2016,Enlisted,45346,36,4,32
2016,Enlisted,45356,26,2,24
2016,Enlisted,45385,13,3,10
2016,Enlisted,45430,47,4,43
2016,Enlisted,45502,32,4,28
2016,Enlisted,45505,45,10,35
2016,Enlisted,45601,30,4,26
2016,Enlisted,45662,33,5,28
2016,Enlisted,45804,14,3,11
2016,Enlisted,45885,16,2,14
2016,Enlisted,46012,9,4,5
2016,Enlisted,46036,9,1,8
2016,Enlisted,46041,12,3,9
2016,Enlisted,46052,10,5,5
2016,Enlisted,46122,49,7,42
2016,Enlisted,46124,25,7,18
2016,Enlisted,46131,171,28,143
2016,Enlisted,46135,6,2,4
2016,Enlisted,46140,50,11,39
2016,Enlisted,46151,25,6,19
2016,Enlisted,46176,31,8,23
2016,Enlisted,46208,7,1,6
2016,Enlisted,46216,31,4,27
2016,Enlisted,46241,206,55,151
2016,Enlisted,46323,4,0,4
2016,Enlisted,46350,5,1,4
2016,Enlisted,46360,2,1,1
2016,Enlisted,46383,16,4,12
2016,Enlisted,46402,12,3,9
2016,Enlisted,46406,23,8,15
2016,Enlisted,46517,2,2,0
2016,Enlisted,46563,29,3,26
2016,Enlisted,46580,20,3,17
2016,Enlisted,46613,38,5,33
2016,Enlisted,46703,5,0,5
2016,Enlisted,46714,25,2,23
2016,Enlisted,46750,12,4,8
2016,Enlisted,46825,89,16,73
2016,Enlisted,46901,4,2,2
2016,Enlisted,46947,26,1,25
2016,Enlisted,46953,11,3,8
2016,Enlisted,47150,28,5,23
2016,Enlisted,47167,8,4,4
2016,Enlisted,47170,6,2,4
2016,Enlisted,47203,85,10,75
2016,Enlisted,47223,5,0,5
2016,Enlisted,47250,7,1,6
2016,Enlisted,47265,4,0,4
2016,Enlisted,47274,7,3,4
2016,Enlisted,47303,7,4,3
2016,Enlisted,47331,5,2,3
2016,Enlisted,47348,38,3,35
2016,Enlisted,47374,11,2,9
2016,Enlisted,47394,24,4,20
2016,Enlisted,47401,39,5,34
2016,Enlisted,47421,10,3,7
2016,Enlisted,47441,34,5,29
2016,Enlisted,47501,16,5,11
2016,Enlisted,47546,38,6,32
2016,Enlisted,47591,10,0,10
2016,Enlisted,47715,63,12,51
2016,Enlisted,47804,8,2,6
2016,Enlisted,47834,21,1,20
2016,Enlisted,47872,12,2,10
2016,Enlisted,47905,48,6,42
2016,Enlisted,47933,20,5,15
2016,Enlisted,47960,12,1,11
2016,Enlisted,47977,1,1,0
2016,Enlisted,48060,9,4,5
2016,Enlisted,48180,57,11,46
2016,Enlisted,48197,22,5,17
2016,Enlisted,48208,41,9,32
2016,Enlisted,48234,68,12,56
2016,Enlisted,48341,26,11,15
2016,Enlisted,48446,15,4,11
2016,Enlisted,48601,66,17,49
2016,Enlisted,48640,29,5,24
2016,Enlisted,48706,36,3,33
2016,Enlisted,48801,13,4,9
2016,Enlisted,48817,43,6,37
2016,Enlisted,48837,56,16,40
2016,Enlisted,48838,15,6,9
2016,Enlisted,48843,26,5,21
2016,Enlisted,48906,31,20,11
2016,Enlisted,48912,15,3,12
2016,Enlisted,49009,50,13,37
2016,Enlisted,49012,47,10,37
2016,Enlisted,49047,19,5,14
2016,Enlisted,49091,8,5,3
2016,Enlisted,49201,24,9,15
2016,Enlisted,49202,7,3,4
2016,Enlisted,49224,10,2,8
2016,Enlisted,49306,3,1,2
2016,Enlisted,49307,23,6,17
2016,Enlisted,49437,12,3,9
2016,Enlisted,49509,88,29,59
2016,Enlisted,49601,5,3,2
2016,Enlisted,49660,3,1,2
2016,Enlisted,49707,2,1,1
2016,Enlisted,49721,4,1,3
2016,Enlisted,49739,53,16,37
2016,Enlisted,49783,18,2,16
2016,Enlisted,49802,3,0,3
2016,Enlisted,49837,22,3,19
2016,Enlisted,49849,6,0,6
2016,Enlisted,49855,4,1,3
2016,Enlisted,49908,3,2,1
2016,Enlisted,49913,4,0,4
2016,Enlisted,49935,3,0,3
2016,Enlisted,50025,9,1,8
2016,Enlisted,50036,36,3,33
2016,Enlisted,50126,9,2,7
2016,Enlisted,50131,203,34,169
2016,Enlisted,50138,6,2,4
2016,Enlisted,50158,10,2,8
2016,Enlisted,50220,5,1,4
2016,Enlisted,50401,11,1,10
2016,Enlisted,50501,15,2,13
2016,Enlisted,50511,6,4,2
2016,Enlisted,50588,10,2,8
2016,Enlisted,50616,6,2,4
2016,Enlisted,50662,15,0,15
2016,Enlisted,50703,42,9,33
2016,Enlisted,51031,14,0,14
2016,Enlisted,51111,35,5,30
2016,Enlisted,51201,11,0,11
2016,Enlisted,51301,1,0,1
2016,Enlisted,51334,17,1,16
2016,Enlisted,51401,7,1,6
2016,Enlisted,51442,8,0,8
2016,Enlisted,51503,37,7,30
2016,Enlisted,51566,6,1,5
2016,Enlisted,51601,7,1,6
2016,Enlisted,52002,38,5,33
2016,Enlisted,52246,56,7,49
2016,Enlisted,52353,6,1,5
2016,Enlisted,52404,41,5,36
2016,Enlisted,52501,9,0,9
2016,Enlisted,52556,12,1,11
2016,Enlisted,52577,8,0,8
2016,Enlisted,52632,19,1,18
2016,Enlisted,52638,11,2,9
2016,Enlisted,52641,15,4,11
2016,Enlisted,52732,25,3,22
2016,Enlisted,52761,6,0,6
2016,Enlisted,52806,40,10,30
2016,Enlisted,53027,4,0,4
2016,Enlisted,53066,42,5,37
2016,Enlisted,53073,7,0,7
2016,Enlisted,53089,28,3,25
2016,Enlisted,53094,25,4,21
2016,Enlisted,53095,17,5,12
2016,Enlisted,53105,12,3,9
2016,Enlisted,53121,4,1,3
2016,Enlisted,53144,4,1,3
2016,Enlisted,53154,5,0,5
2016,Enlisted,53186,13,4,9
2016,Enlisted,53190,8,0,8
2016,Enlisted,53212,54,12,42
2016,Enlisted,53403,12,2,10
2016,Enlisted,53511,13,4,9
2016,Enlisted,53538,9,1,8
2016,Enlisted,53545,1,1,0
2016,Enlisted,53704,77,16,61
2016,Enlisted,53818,9,0,9
2016,Enlisted,53821,9,0,9
2016,Enlisted,53901,6,2,4
2016,Enlisted,53948,6,0,6
2016,Enlisted,53959,12,2,10
2016,Enlisted,53963,8,3,5
2016,Enlisted,54017,15,1,14
2016,Enlisted,54022,11,1,10
2016,Enlisted,54143,11,1,10
2016,Enlisted,54241,1,0,1
2016,Enlisted,54303,19,2,17
2016,Enlisted,54401,3,2,1
2016,Enlisted,54405,8,1,7
2016,Enlisted,54409,21,2,19
2016,Enlisted,54449,12,3,9
2016,Enlisted,54451,6,1,5
2016,Enlisted,54455,19,1,18
2016,Enlisted,54456,4,0,4
2016,Enlisted,54481,8,0,8
2016,Enlisted,54487,4,2,2
2016,Enlisted,54495,13,2,11
2016,Enlisted,54501,6,0,6
2016,Enlisted,54612,18,2,16
2016,Enlisted,54615,18,3,15
2016,Enlisted,54618,17,2,15
2016,Enlisted,54650,23,7,16
2016,Enlisted,54656,9,1,8
2016,Enlisted,54660,5,0,5
2016,Enlisted,54665,5,1,4
2016,Enlisted,54703,34,1,33
2016,Enlisted,54729,10,1,9
2016,Enlisted,54751,10,1,9
2016,Enlisted,54801,10,0,10
2016,Enlisted,54806,17,1,16
2016,Enlisted,54843,7,1,6
2016,Enlisted,54868,3,0,3
2016,Enlisted,54880,9,2,7
2016,Enlisted,54902,25,3,22
2016,Enlisted,54914,26,8,18
2016,Enlisted,54923,12,1,11
2016,Enlisted,54929,8,3,5
2016,Enlisted,54935,17,3,14
2016,Enlisted,54971,11,1,10
2016,Enlisted,54981,6,0,6
2016,Enlisted,55008,45,3,42
2016,Enlisted,55016,17,4,13
2016,Enlisted,55021,32,2,30
2016,Enlisted,55033,19,4,15
2016,Enlisted,55057,7,0,7
2016,Enlisted,55060,6,1,5
2016,Enlisted,55063,18,4,14
2016,Enlisted,55066,11,0,11
2016,Enlisted,55068,39,14,25
2016,Enlisted,55077,26,3,23
2016,Enlisted,55082,30,3,27
2016,Enlisted,55106,19,1,18
2016,Enlisted,55107,60,9,51
2016,Enlisted,55112,80,3,77
2016,Enlisted,55113,6,1,5
2016,Enlisted,55118,34,3,31
2016,Enlisted,55303,15,3,12
2016,Enlisted,55350,18,2,16
2016,Enlisted,55355,24,1,23
2016,Enlisted,55362,26,2,24
2016,Enlisted,55413,5,2,3
2016,Enlisted,55431,28,2,26
2016,Enlisted,55443,28,4,24
2016,Enlisted,55719,15,1,14
2016,Enlisted,55720,22,1,21
2016,Enlisted,55744,17,1,16
2016,Enlisted,55746,22,2,20
2016,Enlisted,55811,75,3,72
2016,Enlisted,55904,29,7,22
2016,Enlisted,55912,35,1,34
2016,Enlisted,55987,13,0,13
2016,Enlisted,56001,26,4,22
2016,Enlisted,56007,17,1,16
2016,Enlisted,56031,14,1,13
2016,Enlisted,56073,13,1,12
2016,Enlisted,56081,14,0,14
2016,Enlisted,56082,9,2,7
2016,Enlisted,56143,17,1,16
2016,Enlisted,56156,6,0,6
2016,Enlisted,56164,4,0,4
2016,Enlisted,56201,16,1,15
2016,Enlisted,56208,14,0,14
2016,Enlisted,56256,9,1,8
2016,Enlisted,56258,12,2,10
2016,Enlisted,56265,12,0,12
2016,Enlisted,56267,11,0,11
2016,Enlisted,56277,10,0,10
2016,Enlisted,56278,14,0,14
2016,Enlisted,56283,10,4,6
2016,Enlisted,56303,37,5,32
2016,Enlisted,56308,36,2,34
2016,Enlisted,56345,137,11,126
2016,Enlisted,56378,13,0,13
2016,Enlisted,56401,17,1,16
2016,Enlisted,56482,9,0,9
2016,Enlisted,56501,11,1,10
2016,Enlisted,56537,13,2,11
2016,Enlisted,56560,34,2,32
2016,Enlisted,56601,21,4,17
2016,Enlisted,56701,11,0,11
2016,Enlisted,56716,23,1,22
2016,Enlisted,57006,8,1,7
2016,Enlisted,57028,3,0,3
2016,Enlisted,57042,9,2,7
2016,Enlisted,57069,5,1,4
2016,Enlisted,57078,7,0,7
2016,Enlisted,57104,32,4,28
2016,Enlisted,57201,23,3,20
2016,Enlisted,57231,2,0,2
2016,Enlisted,57252,8,0,8
2016,Enlisted,57301,8,1,7
2016,Enlisted,57325,8,1,7
2016,Enlisted,57350,10,1,9
2016,Enlisted,57366,2,0,2
2016,Enlisted,57380,12,1,11
2016,Enlisted,57401,11,1,10
2016,Enlisted,57501,9,1,8
2016,Enlisted,57601,8,0,8
2016,Enlisted,57702,10,3,7
2016,Enlisted,57703,9,1,8
2016,Enlisted,57717,15,2,13
2016,Enlisted,57783,5,1,4
2016,Enlisted,57785,2,1,1
2016,Enlisted,58054,4,1,3
2016,Enlisted,58072,11,1,10
2016,Enlisted,58075,11,2,9
2016,Enlisted,58102,59,17,42
2016,Enlisted,58201,22,5,17
2016,Enlisted,58237,2,1,1
2016,Enlisted,58257,14,2,12
2016,Enlisted,58301,12,4,8
2016,Enlisted,58368,1,0,1
2016,Enlisted,58402,12,0,12
2016,Enlisted,58433,4,1,3
2016,Enlisted,58474,6,0,6
2016,Enlisted,58495,3,0,3
2016,Enlisted,58506,102,34,68
2016,Enlisted,58601,14,0,14
2016,Enlisted,58702,1,0,1
2016,Enlisted,58703,20,3,17
2016,Enlisted,58801,1,0,1
2016,Enlisted,58802,5,1,4
2016,Enlisted,59036,3,0,3
2016,Enlisted,59047,12,1,11
2016,Enlisted,59102,48,12,36
2016,Enlisted,59218,5,1,4
2016,Enlisted,59230,1,0,1
2016,Enlisted,59270,5,1,4
2016,Enlisted,59301,5,1,4
2016,Enlisted,59405,8,0,8
2016,Enlisted,59457,11,2,9
2016,Enlisted,59501,4,0,4
2016,Enlisted,59538,9,0,9
2016,Enlisted,59602,39,7,32
2016,Enlisted,59636,23,8,15
2016,Enlisted,59701,17,3,14
2016,Enlisted,59711,10,1,9
2016,Enlisted,59714,28,4,24
2016,Enlisted,59725,6,1,5
2016,Enlisted,59808,43,8,35
2016,Enlisted,59840,2,0,2
2016,Enlisted,59901,7,0,7
2016,Enlisted,59923,1,1,0
2016,Enlisted,60037,49,2,47
2016,Enlisted,60098,5,1,4
2016,Enlisted,60120,28,9,19
2016,Enlisted,60178,14,0,14
2016,Enlisted,60435,24,4,20
2016,Enlisted,60472,55,8,47
2016,Enlisted,60505,24,4,20
2016,Enlisted,60546,133,20,113
2016,Enlisted,60615,95,16,79
2016,Enlisted,60616,15,8,7
2016,Enlisted,60638,30,3,27
2016,Enlisted,60651,39,6,33
2016,Enlisted,60901,21,5,16
2016,Enlisted,61021,17,2,15
2016,Enlisted,61032,36,4,32
2016,Enlisted,61071,31,1,30
2016,Enlisted,61115,48,4,44
2016,Enlisted,61264,32,2,30
2016,Enlisted,61341,20,1,19
2016,Enlisted,61401,13,1,12
2016,Enlisted,61434,14,2,12
2016,Enlisted,61443,20,2,18
2016,Enlisted,61455,43,4,39
2016,Enlisted,61607,87,12,75
2016,Enlisted,61701,20,5,15
2016,Enlisted,61734,2,1,1
2016,Enlisted,61761,28,5,23
2016,Enlisted,61764,16,2,14
2016,Enlisted,61801,15,6,9
2016,Enlisted,61820,12,1,11
2016,Enlisted,61834,15,2,13
2016,Enlisted,61938,12,1,11
2016,Enlisted,61944,15,1,14
2016,Enlisted,61951,7,0,7
2016,Enlisted,62056,36,5,31
2016,Enlisted,62205,34,4,30
2016,Enlisted,62269,14,0,14
2016,Enlisted,62286,34,7,27
2016,Enlisted,62301,2,0,2
2016,Enlisted,62305,9,5,4
2016,Enlisted,62401,22,4,18
2016,Enlisted,62439,11,3,8
2016,Enlisted,62521,48,2,46
2016,Enlisted,62702,107,14,93
2016,Enlisted,62864,26,4,22
2016,Enlisted,62896,22,3,19
2016,Enlisted,62959,47,11,36
2016,Enlisted,62966,16,0,16
2016,Enlisted,63020,7,2,5
2016,Enlisted,63028,5,0,5
2016,Enlisted,63044,66,10,56
2016,Enlisted,63077,10,1,9
2016,Enlisted,63109,32,11,21
2016,Enlisted,63125,22,4,18
2016,Enlisted,63383,6,1,5
2016,Enlisted,63401,4,2,2
2016,Enlisted,63501,3,0,3
2016,Enlisted,63552,10,2,8
2016,Enlisted,63640,4,1,3
2016,Enlisted,63645,10,4,6
2016,Enlisted,63703,12,4,8
2016,Enlisted,63755,6,2,4
2016,Enlisted,63775,7,1,6
2016,Enlisted,63801,5,1,4
2016,Enlisted,63841,2,0,2
2016,Enlisted,63857,5,2,3
2016,Enlisted,63873,7,0,7
2016,Enlisted,63901,9,1,8
2016,Enlisted,63935,6,1,5
2016,Enlisted,64052,10,2,8
2016,Enlisted,64067,22,1,21
2016,Enlisted,64085,12,2,10
2016,Enlisted,64093,14,3,11
2016,Enlisted,64101,3,0,3
2016,Enlisted,64129,79,20,59
2016,Enlisted,64402,2,0,2
2016,Enlisted,64468,11,0,11
2016,Enlisted,64506,23,3,20
2016,Enlisted,64601,9,2,7
2016,Enlisted,64683,9,1,8
2016,Enlisted,64701,33,4,29
2016,Enlisted,64735,6,1,5
2016,Enlisted,64772,5,1,4
2016,Enlisted,64804,10,2,8
2016,Enlisted,64831,11,1,10
2016,Enlisted,64836,12,1,11
2016,Enlisted,64850,1,1,0
2016,Enlisted,65101,13,3,10
2016,Enlisted,65109,32,6,26
2016,Enlisted,65202,30,7,23
2016,Enlisted,65233,30,11,19
2016,Enlisted,65251,1,0,1
2016,Enlisted,65265,10,1,9
2016,Enlisted,65270,4,0,4
2016,Enlisted,65301,8,2,6
2016,Enlisted,65305,25,2,23
2016,Enlisted,65340,12,5,7
2016,Enlisted,65401,49,6,43
2016,Enlisted,65473,17,4,13
2016,Enlisted,65536,65,7,58
2016,Enlisted,65605,9,4,5
2016,Enlisted,65708,9,6,3
2016,Enlisted,65723,11,4,7
2016,Enlisted,65775,11,3,8
2016,Enlisted,65802,46,16,30
2016,Enlisted,65803,27,11,16
2016,Enlisted,66027,17,9,8
2016,Enlisted,66044,18,14,4
2016,Enlisted,66061,21,7,14
2016,Enlisted,66067,10,4,6
2016,Enlisted,66071,2,0,2
2016,Enlisted,66102,27,22,5
2016,Enlisted,66219,9,3,6
2016,Enlisted,66434,5,2,3
2016,Enlisted,66436,1,1,0
2016,Enlisted,66441,19,11,8
2016,Enlisted,66502,60,45,15
2016,Enlisted,66508,5,0,5
2016,Enlisted,66611,6,5,1
2016,Enlisted,66619,70,32,38
2016,Enlisted,66749,10,2,8
2016,Enlisted,66762,16,3,13
2016,Enlisted,66801,2,1,1
2016,Enlisted,66901,4,0,4
2016,Enlisted,66967,2,2,0
2016,Enlisted,67010,5,1,4
2016,Enlisted,67114,5,1,4
2016,Enlisted,67124,3,1,2
2016,Enlisted,67217,33,11,22
2016,Enlisted,67219,56,22,34
2016,Enlisted,67337,5,1,4
2016,Enlisted,67401,12,10,2
2016,Enlisted,67410,6,5,1
2016,Enlisted,67432,4,2,2
2016,Enlisted,67501,10,2,8
2016,Enlisted,67530,6,2,4
2016,Enlisted,67601,2,1,1
2016,Enlisted,67654,2,2,0
2016,Enlisted,67701,1,0,1
2016,Enlisted,67801,3,0,3
2016,Enlisted,68003,1,1,0
2016,Enlisted,68066,7,0,7
2016,Enlisted,68073,18,9,9
2016,Enlisted,68106,13,5,8
2016,Enlisted,68142,33,9,24
2016,Enlisted,68310,26,6,20
2016,Enlisted,68410,8,1,7
2016,Enlisted,68508,37,21,16
2016,Enlisted,68524,39,9,30
2016,Enlisted,68601,4,0,4
2016,Enlisted,68602,5,0,5
2016,Enlisted,68701,5,0,5
2016,Enlisted,68763,3,2,1
2016,Enlisted,68787,3,1,2
2016,Enlisted,68801,37,4,33
2016,Enlisted,68803,1,0,1
2016,Enlisted,68847,6,3,3
2016,Enlisted,68901,19,5,14
2016,Enlisted,69001,1,0,1
2016,Enlisted,69101,6,3,3
2016,Enlisted,69162,3,1,2
2016,Enlisted,69337,5,1,4
2016,Enlisted,69361,6,1,5
2016,Enlisted,70072,12,2,10
2016,Enlisted,70084,31,4,27
2016,Enlisted,70117,111,19,92
2016,Enlisted,70364,19,6,13
2016,Enlisted,70390,13,1,12
2016,Enlisted,70401,51,7,44
2016,Enlisted,70403,8,1,7
2016,Enlisted,70427,7,0,7
2016,Enlisted,70433,22,2,20
2016,Enlisted,70438,12,2,10
2016,Enlisted,70460,18,2,16
2016,Enlisted,70508,33,14,19
2016,Enlisted,70510,20,3,17
2016,Enlisted,70517,16,3,13
2016,Enlisted,70526,5,1,4
2016,Enlisted,70544,26,3,23
2016,Enlisted,70563,28,3,25
2016,Enlisted,70570,11,1,10
2016,Enlisted,70582,6,1,5
2016,Enlisted,70586,8,2,6
2016,Enlisted,70601,43,14,29
2016,Enlisted,70633,14,3,11
2016,Enlisted,70634,6,3,3
2016,Enlisted,70701,3,1,2
2016,Enlisted,70714,11,0,11
2016,Enlisted,70721,99,10,89
2016,Enlisted,70737,23,0,23
2016,Enlisted,70760,10,1,9
2016,Enlisted,70764,18,1,17
2016,Enlisted,70820,59,6,53
2016,Enlisted,71019,19,3,16
2016,Enlisted,71055,47,5,42
2016,Enlisted,71101,29,5,24
2016,Enlisted,71111,15,4,11
2016,Enlisted,71203,23,2,21
2016,Enlisted,71220,5,0,5
2016,Enlisted,71232,12,1,11
2016,Enlisted,71241,4,0,4
2016,Enlisted,71251,6,0,6
2016,Enlisted,71263,4,0,4
2016,Enlisted,71270,31,2,29
2016,Enlisted,71292,16,1,15
2016,Enlisted,71295,2,0,2
2016,Enlisted,71303,15,4,11
2016,Enlisted,71322,17,3,14
2016,Enlisted,71342,6,1,5
2016,Enlisted,71351,17,0,17
2016,Enlisted,71360,111,21,90
2016,Enlisted,71373,6,2,4
2016,Enlisted,71415,6,0,6
2016,Enlisted,71417,14,1,13
2016,Enlisted,71457,9,3,6
2016,Enlisted,71459,21,3,18
2016,Enlisted,71601,4,1,3
2016,Enlisted,71602,8,1,7
2016,Enlisted,71655,2,0,2
2016,Enlisted,71730,4,1,3
2016,Enlisted,71761,1,0,1
2016,Enlisted,71801,10,3,7
2016,Enlisted,71823,11,1,10
2016,Enlisted,71854,12,1,11
2016,Enlisted,71857,5,1,4
2016,Enlisted,71913,9,0,9
2016,Enlisted,71923,5,0,5
2016,Enlisted,71953,11,1,10
2016,Enlisted,72007,7,1,6
2016,Enlisted,72012,12,2,10
2016,Enlisted,72015,19,3,16
2016,Enlisted,72023,20,2,18
2016,Enlisted,72034,24,4,20
2016,Enlisted,72064,10,1,9
2016,Enlisted,72086,6,0,6
2016,Enlisted,72104,17,2,15
2016,Enlisted,72110,10,0,10
2016,Enlisted,72114,52,7,45
2016,Enlisted,72119,2,2,0
2016,Enlisted,72143,31,6,25
2016,Enlisted,72150,8,3,5
2016,Enlisted,72160,20,4,16
2016,Enlisted,72199,134,31,103
2016,Enlisted,72335,25,1,24
2016,Enlisted,72401,28,7,21
2016,Enlisted,72432,12,1,11
2016,Enlisted,72450,17,5,12
2016,Enlisted,72476,32,2,30
2016,Enlisted,72501,17,3,14
2016,Enlisted,72543,13,1,12
2016,Enlisted,72601,2,0,2
2016,Enlisted,72650,2,0,2
2016,Enlisted,72653,13,3,10
2016,Enlisted,72701,18,6,12
2016,Enlisted,72712,50,3,47
2016,Enlisted,72744,4,1,3
2016,Enlisted,72756,17,4,13
2016,Enlisted,72761,8,1,7
2016,Enlisted,72802,11,4,7
2016,Enlisted,72830,8,1,7
2016,Enlisted,72834,10,0,10
2016,Enlisted,72905,18,5,13
2016,Enlisted,72923,22,5,17
2016,Enlisted,72927,1,1,0
2016,Enlisted,72949,12,3,9
2016,Enlisted,73034,39,9,30
2016,Enlisted,73036,26,4,22
2016,Enlisted,73051,30,9,21
2016,Enlisted,73064,52,10,42
2016,Enlisted,73069,114,33,81
2016,Enlisted,73111,21,8,13
2016,Enlisted,73179,3,0,3
2016,Enlisted,73401,13,0,13
2016,Enlisted,73503,29,8,21
2016,Enlisted,73521,15,5,10
2016,Enlisted,73705,24,2,22
2016,Enlisted,74003,12,2,10
2016,Enlisted,74012,35,2,33
2016,Enlisted,74014,39,8,31
2016,Enlisted,74017,10,2,8
2016,Enlisted,74075,37,7,30
2016,Enlisted,74107,61,15,46
2016,Enlisted,74116,31,10,21
2016,Enlisted,74301,20,5,15
2016,Enlisted,74403,63,10,53
2016,Enlisted,74423,7,1,6
2016,Enlisted,74447,19,4,15
2016,Enlisted,74501,22,4,18
2016,Enlisted,74601,6,1,5
2016,Enlisted,74701,7,1,6
2016,Enlisted,74804,12,3,9
2016,Enlisted,74820,39,11,28
2016,Enlisted,74834,25,6,19
2016,Enlisted,74848,13,5,8
2016,Enlisted,74953,8,3,5
2016,Enlisted,75020,2,2,0
2016,Enlisted,75051,148,61,87
2016,Enlisted,75077,43,11,32
2016,Enlisted,75098,27,11,16
2016,Enlisted,75110,16,6,10
2016,Enlisted,75159,27,15,12
2016,Enlisted,75160,9,7,2
2016,Enlisted,75165,12,4,8
2016,Enlisted,75220,1,1,0
2016,Enlisted,75237,24,14,10
2016,Enlisted,75402,32,14,18
2016,Enlisted,75570,9,2,7
2016,Enlisted,75662,22,12,10
2016,Enlisted,75672,9,2,7
2016,Enlisted,75709,16,8,8
2016,Enlisted,75803,11,5,6
2016,Enlisted,75901,33,7,26
2016,Enlisted,76086,17,8,9
2016,Enlisted,76105,28,14,14
2016,Enlisted,76108,40,22,18
2016,Enlisted,76115,16,9,7
2016,Enlisted,76207,14,3,11
2016,Enlisted,76234,16,5,11
2016,Enlisted,76302,36,10,26
2016,Enlisted,76401,10,6,4
2016,Enlisted,76502,49,33,16
2016,Enlisted,76528,23,19,4
2016,Enlisted,76542,79,46,33
2016,Enlisted,76574,6,4,2
2016,Enlisted,76705,1,0,1
2016,Enlisted,76707,65,42,23
2016,Enlisted,76801,17,8,9
2016,Enlisted,76905,47,11,36
2016,Enlisted,77034,69,31,38
2016,Enlisted,77067,48,19,29
2016,Enlisted,77082,84,45,39
2016,Enlisted,77340,26,13,13
2016,Enlisted,77437,44,10,34
2016,Enlisted,77471,6,5,1
2016,Enlisted,77515,28,3,25
2016,Enlisted,77568,9,6,3
2016,Enlisted,77802,24,12,12
2016,Enlisted,77833,11,2,9
2016,Enlisted,77904,14,8,6
2016,Enlisted,78041,32,12,20
2016,Enlisted,78130,16,3,13
2016,Enlisted,78155,10,6,4
2016,Enlisted,78218,54,35,19
2016,Enlisted,78219,75,49,26
2016,Enlisted,78257,166,92,74
2016,Enlisted,78363,8,2,6
2016,Enlisted,78416,16,10,6
2016,Enlisted,78520,16,4,12
2016,Enlisted,78596,74,15,59
2016,Enlisted,78602,5,2,3
2016,Enlisted,78617,138,33,105
2016,Enlisted,78624,25,13,12
2016,Enlisted,78665,55,24,31
2016,Enlisted,78666,99,46,53
2016,Enlisted,78703,164,83,81
2016,Enlisted,78731,21,20,1
2016,Enlisted,78746,2,2,0
2016,Enlisted,78861,4,2,2
2016,Enlisted,79107,25,7,18
2016,Enlisted,79403,31,14,17
2016,Enlisted,79607,13,6,7
2016,Enlisted,79706,22,9,13
2016,Enlisted,79924,9,4,5
2016,Enlisted,79936,121,39,82
2016,Enlisted,79963,14,4,10
2016,Enlisted,80011,56,40,16
2016,Enlisted,80012,22,8,14
2016,Enlisted,80112,1,1,0
2016,Enlisted,80137,41,28,13
2016,Enlisted,80216,64,28,36
2016,Enlisted,80501,9,1,8
2016,Enlisted,80504,19,9,10
2016,Enlisted,80521,22,12,10
2016,Enlisted,80550,8,3,5
2016,Enlisted,80621,27,11,16
2016,Enlisted,80751,3,2,1
2016,Enlisted,80907,10,6,4
2016,Enlisted,80913,26,12,14
2016,Enlisted,80916,19,13,6
2016,Enlisted,80920,61,39,22
2016,Enlisted,81004,22,14,8
2016,Enlisted,81050,15,4,11
2016,Enlisted,81101,18,6,12
2016,Enlisted,81212,2,0,2
2016,Enlisted,81303,16,13,3
2016,Enlisted,81401,11,3,8
2016,Enlisted,81501,40,22,18
2016,Enlisted,82005,5,1,4
2016,Enlisted,82009,27,9,18
2016,Enlisted,82072,11,3,8
2016,Enlisted,82214,2,1,1
2016,Enlisted,82240,5,0,5
2016,Enlisted,82401,14,1,13
2016,Enlisted,82435,1,0,1
2016,Enlisted,82520,10,1,9
2016,Enlisted,82604,4,0,4
2016,Enlisted,82633,6,6,0
2016,Enlisted,82716,8,0,8
2016,Enlisted,82801,6,3,3
2016,Enlisted,82901,2,1,1
2016,Enlisted,82930,3,1,2
2016,Enlisted,83110,39,7,32
2016,Enlisted,83202,20,4,16
2016,Enlisted,83221,5,1,4
2016,Enlisted,83263,9,0,9
2016,Enlisted,83301,9,2,7
2016,Enlisted,83318,5,1,4
2016,Enlisted,83330,12,5,7
2016,Enlisted,83338,13,0,13
2016,Enlisted,83402,11,3,8
2016,Enlisted,83440,6,1,5
2016,Enlisted,83442,6,0,6
2016,Enlisted,83445,7,1,6
2016,Enlisted,83501,14,4,10
2016,Enlisted,83530,1,1,0
2016,Enlisted,83544,2,0,2
2016,Enlisted,83605,17,4,13
2016,Enlisted,83617,4,0,4
2016,Enlisted,83647,9,3,6
2016,Enlisted,83661,4,1,3
2016,Enlisted,83676,10,4,6
2016,Enlisted,83687,8,4,4
2016,Enlisted,83705,148,47,101
2016,Enlisted,83805,1,0,1
2016,Enlisted,83843,7,3,4
2016,Enlisted,83854,9,3,6
2016,Enlisted,84003,14,2,12
2016,Enlisted,84020,53,19,34
2016,Enlisted,84043,27,8,19
2016,Enlisted,84058,19,5,14
2016,Enlisted,84065,112,44,68
2016,Enlisted,84074,9,3,6
2016,Enlisted,84078,4,1,3
2016,Enlisted,84084,96,24,72
2016,Enlisted,84116,19,7,12
2016,Enlisted,84302,5,0,5
2016,Enlisted,84321,7,3,4
2016,Enlisted,84323,6,0,6
2016,Enlisted,84405,33,14,19
2016,Enlisted,84501,13,1,12
2016,Enlisted,84511,3,2,1
2016,Enlisted,84631,3,1,2
2016,Enlisted,84642,8,2,6
2016,Enlisted,84647,12,1,11
2016,Enlisted,84660,15,4,11
2016,Enlisted,84663,4,1,3
2016,Enlisted,84701,4,0,4
2016,Enlisted,84713,4,1,3
2016,Enlisted,84720,9,5,4
2016,Enlisted,84770,7,1,6
2016,Enlisted,84790,26,6,20
2016,Enlisted,85008,195,81,114
2016,Enlisted,85015,3,2,1
2016,Enlisted,85020,28,10,18
2016,Enlisted,85122,41,14,27
2016,Enlisted,85128,7,6,1
2016,Enlisted,85132,80,29,51
2016,Enlisted,85201,7,2,5
2016,Enlisted,85281,14,3,11
2016,Enlisted,85286,15,7,8
2016,Enlisted,85301,2,1,1
2016,Enlisted,85312,26,8,18
2016,Enlisted,85365,11,5,6
2016,Enlisted,85396,6,6,0
2016,Enlisted,85546,17,5,12
2016,Enlisted,85607,9,3,6
2016,Enlisted,85653,37,14,23
2016,Enlisted,85706,67,13,54
2016,Enlisted,85713,37,15,22
2016,Enlisted,85901,14,5,9
2016,Enlisted,86015,52,12,40
2016,Enlisted,86301,47,12,35
2016,Enlisted,87002,19,1,18
2016,Enlisted,87123,51,18,33
2016,Enlisted,87144,131,34,97
2016,Enlisted,87305,4,1,3
2016,Enlisted,87401,22,5,17
2016,Enlisted,87508,14,7,7
2016,Enlisted,87532,3,0,3
2016,Enlisted,87557,4,0,4
2016,Enlisted,87701,4,2,2
2016,Enlisted,87747,1,0,1
2016,Enlisted,88007,84,38,46
2016,Enlisted,88101,5,3,2
2016,Enlisted,88203,11,3,8
2016,Enlisted,88240,8,1,7
2016,Enlisted,88310,12,3,9
2016,Enlisted,88415,2,1,1
2016,Enlisted,88435,2,1,1
2016,Enlisted,89002,23,5,18
2016,Enlisted,89032,4,0,4
2016,Enlisted,89115,117,29,88
2016,Enlisted,89139,13,9,4
2016,Enlisted,89165,106,12,94
2016,Enlisted,89301,1,0,1
2016,Enlisted,89406,15,4,11
2016,Enlisted,89445,9,1,8
2016,Enlisted,89447,5,1,4
2016,Enlisted,89506,75,27,48
2016,Enlisted,89509,7,1,6
2016,Enlisted,89701,32,7,25
2016,Enlisted,89801,9,1,8
2016,Enlisted,90025,7,4,3
2016,Enlisted,90201,69,26,43
2016,Enlisted,90249,18,5,13
2016,Enlisted,90266,10,9,1
2016,Enlisted,90302,39,17,22
2016,Enlisted,90501,28,8,20
2016,Enlisted,90640,17,9,8
2016,Enlisted,90720,162,80,82
2016,Enlisted,90731,9,6,3
2016,Enlisted,90813,20,11,9
2016,Enlisted,90822,77,36,41
2016,Enlisted,91205,37,13,24
2016,Enlisted,91406,17,8,9
2016,Enlisted,91505,33,15,18
2016,Enlisted,91702,58,24,34
2016,Enlisted,91764,47,24,23
2016,Enlisted,91766,22,9,13
2016,Enlisted,91950,39,12,27
2016,Enlisted,92020,25,11,14
2016,Enlisted,92025,16,8,8
2016,Enlisted,92111,50,28,22
2016,Enlisted,92220,7,4,3
2016,Enlisted,92227,2,1,1
2016,Enlisted,92243,7,5,2
2016,Enlisted,92307,5,2,3
2016,Enlisted,92311,3,2,1
2016,Enlisted,92324,2,2,0
2016,Enlisted,92410,4,2,2
2016,Enlisted,92501,37,20,17
2016,Enlisted,92518,47,21,26
2016,Enlisted,92707,10,5,5
2016,Enlisted,92833,39,22,17
2016,Enlisted,92866,50,26,24
2016,Enlisted,92879,10,7,3
2016,Enlisted,93003,17,9,8
2016,Enlisted,93030,8,3,5
2016,Enlisted,93103,7,5,2
2016,Enlisted,93257,17,2,15
2016,Enlisted,93291,21,6,15
2016,Enlisted,93307,49,15,34
2016,Enlisted,93405,20,4,16
2016,Enlisted,93422,9,2,7
2016,Enlisted,93451,32,17,15
2016,Enlisted,93454,3,2,1
2016,Enlisted,93536,23,12,11
2016,Enlisted,93702,20,4,16
2016,Enlisted,93727,74,19,55
2016,Enlisted,93955,8,4,4
2016,Enlisted,94035,14,7,7
2016,Enlisted,94043,7,7,0
2016,Enlisted,94066,3,0,3
2016,Enlisted,94132,18,9,9
2016,Enlisted,94401,16,4,12
2016,Enlisted,94510,11,4,7
2016,Enlisted,94519,13,8,5
2016,Enlisted,94533,16,6,10
2016,Enlisted,94565,41,17,24
2016,Enlisted,94568,28,11,17
2016,Enlisted,94590,26,8,18
2016,Enlisted,94596,10,4,6
2016,Enlisted,94804,24,12,12
2016,Enlisted,94903,13,7,6
2016,Enlisted,94952,8,4,4
2016,Enlisted,95020,3,0,3
2016,Enlisted,95023,18,7,11
2016,Enlisted,95110,21,7,14
2016,Enlisted,95206,59,26,33
2016,Enlisted,95240,7,3,4
2016,Enlisted,95341,14,2,12
2016,Enlisted,95351,30,14,16
2016,Enlisted,95361,15,7,8
2016,Enlisted,95380,11,4,7
2016,Enlisted,95401,16,6,10
2016,Enlisted,95453,2,2,0
2016,Enlisted,95503,8,3,5
2016,Enlisted,95603,34,14,20
2016,Enlisted,95655,12,5,7
2016,Enlisted,95667,1,0,1
2016,Enlisted,95678,6,4,2
2016,Enlisted,95815,5,1,4
2016,Enlisted,95826,12,9,3
2016,Enlisted,95828,55,31,24
2016,Enlisted,95832,10,8,2
2016,Enlisted,95926,16,5,11
2016,Enlisted,95965,14,0,14
2016,Enlisted,96001,6,0,6
2016,Enlisted,96067,4,1,3
2016,Enlisted,96080,6,3,3
2016,Enlisted,96130,2,2,0
2016,Enlisted,96707,109,58,51
2016,Enlisted,96716,10,3,7
2016,Enlisted,96720,31,4,27
2016,Enlisted,96732,7,1,6
2016,Enlisted,96750,3,1,2
2016,Enlisted,96782,37,14,23
2016,Enlisted,96786,38,15,23
2016,Enlisted,96789,20,6,14
2016,Enlisted,96795,1,1,0
2016,Enlisted,96816,7,7,0
2016,Enlisted,96820,1,1,0
2016,Enlisted,96857,10,4,6
2016,Enlisted,96913,82,14,68
2016,Enlisted,97015,111,37,74
2016,Enlisted,97030,28,9,19
2016,Enlisted,97031,4,2,2
2016,Enlisted,97051,1,0,1
2016,Enlisted,97058,9,2,7
2016,Enlisted,97071,20,8,12
2016,Enlisted,97116,20,12,8
2016,Enlisted,97124,8,5,3
2016,Enlisted,97128,7,3,4
2016,Enlisted,97146,14,4,10
2016,Enlisted,97211,36,24,12
2016,Enlisted,97217,5,3,2
2016,Enlisted,97218,52,13,39
2016,Enlisted,97301,6,2,4
2016,Enlisted,97302,19,10,9
2016,Enlisted,97303,29,15,14
2016,Enlisted,97309,25,13,12
2016,Enlisted,97321,11,0,11
2016,Enlisted,97330,21,7,14
2016,Enlisted,97338,3,2,1
2016,Enlisted,97355,15,4,11
2016,Enlisted,97365,3,1,2
2016,Enlisted,97420,8,2,6
2016,Enlisted,97470,4,2,2
2016,Enlisted,97477,56,20,36
2016,Enlisted,97501,40,13,27
2016,Enlisted,97520,13,7,6
2016,Enlisted,97526,13,1,12
2016,Enlisted,97603,18,4,14
2016,Enlisted,97702,28,14,14
2016,Enlisted,97754,3,2,1
2016,Enlisted,97756,6,2,4
2016,Enlisted,97801,27,3,24
2016,Enlisted,97814,3,1,2
2016,Enlisted,97838,12,4,8
2016,Enlisted,97850,17,5,12
2016,Enlisted,97862,9,0,9
2016,Enlisted,97914,2,1,1
2016,Enlisted,98032,101,48,53
2016,Enlisted,98052,28,17,11
2016,Enlisted,98108,38,26,12
2016,Enlisted,98119,77,50,27
2016,Enlisted,98201,7,3,4
2016,Enlisted,98221,20,7,13
2016,Enlisted,98271,21,9,12
2016,Enlisted,98290,14,8,6
2016,Enlisted,98312,20,9,11
2016,Enlisted,98321,7,7,0
2016,Enlisted,98366,3,2,1
2016,Enlisted,98372,17,9,8
2016,Enlisted,98430,25,19,6
2016,Enlisted,98433,132,102,30
2016,Enlisted,98501,34,22,12
2016,Enlisted,98516,3,3,0
2016,Enlisted,98531,29,16,13
2016,Enlisted,98563,6,5,1
2016,Enlisted,98632,15,7,8
2016,Enlisted,98682,41,20,21
2016,Enlisted,98801,4,3,1
2016,Enlisted,98823,7,4,3
2016,Enlisted,98837,24,7,17
2016,Enlisted,98901,26,8,18
2016,Enlisted,98903,13,5,8
2016,Enlisted,98930,7,2,5
2016,Enlisted,99011,39,15,24
2016,Enlisted,99217,22,12,10
2016,Enlisted,99219,10,5,5
2016,Enlisted,99224,2,1,1
2016,Enlisted,99301,9,2,7
2016,Enlisted,99362,7,1,6
2016,Enlisted,99505,136,70,66
2016,Enlisted,99559,5,4,1
2016,Enlisted,99611,7,1,6
2016,Enlisted,99614,1,0,1
2016,Enlisted,99622,2,0,2
2016,Enlisted,99654,4,3,1
2016,Enlisted,99687,21,10,11
2016,Enlisted,99701,29,16,13
2016,Enlisted,99723,1,0,1
2016,Enlisted,99752,9,2,7
2016,Enlisted,99821,8,0,8
2016,Enlisted,99901,3,1,2
2016,Officer,00602,1,1,0
2016,Officer,00612,1,1,0
2016,Officer,00683,1,1,0
2016,Officer,00693,2,2,0
2016,Officer,00725,1,1,0
2016,Officer,00732,4,4,0
2016,Officer,00736,1,1,0
2016,Officer,00751,4,4,0
2016,Officer,00792,1,1,0
2016,Officer,00795,2,2,0
2016,Officer,00850,5,4,1
2016,Officer,00851,1,1,0
2016,Officer,00901,6,5,1
2016,Officer,00934,3,3,0
2016,Officer,01013,1,1,0
2016,Officer,01030,1,1,0
2016,Officer,01082,2,2,0
2016,Officer,01085,1,1,0
2016,Officer,01109,1,1,0
2016,Officer,01301,1,1,0
2016,Officer,01434,6,6,0
2016,Officer,01605,4,4,0
2016,Officer,01702,2,2,0
2016,Officer,01731,7,7,0
2016,Officer,01844,5,5,0
2016,Officer,01867,3,3,0
2016,Officer,02043,2,2,0
2016,Officer,02138,1,1,0
2016,Officer,02176,5,5,0
2016,Officer,02301,12,12,0
2016,Officer,02420,1,1,0
2016,Officer,02542,2,2,0
2016,Officer,02769,2,2,0
2016,Officer,02780,4,4,0
2016,Officer,02809,1,0,1
2016,Officer,02816,3,3,0
2016,Officer,02818,5,2,3
2016,Officer,02842,6,6,0
2016,Officer,02852,2,2,0
2016,Officer,02885,1,0,1
2016,Officer,02886,1,1,0
2016,Officer,02904,1,1,0
2016,Officer,02906,2,2,0
2016,Officer,02920,2,2,0
2016,Officer,03055,3,3,0
2016,Officer,03101,3,3,0
2016,Officer,03244,2,2,0
2016,Officer,03301,5,5,0
2016,Officer,03570,2,2,0
2016,Officer,03766,3,3,0
2016,Officer,04011,2,1,1
2016,Officer,04268,1,1,0
2016,Officer,04333,2,2,0
2016,Officer,04401,2,2,0
2016,Officer,04412,2,2,0
2016,Officer,04736,1,1,0
2016,Officer,05001,1,1,0
2016,Officer,05033,2,2,0
2016,Officer,05158,2,2,0
2016,Officer,05201,3,3,0
2016,Officer,05403,1,1,0
2016,Officer,05404,2,2,0
2016,Officer,05446,8,8,0
2016,Officer,05465,14,14,0
2016,Officer,05478,3,3,0
2016,Officer,05495,3,3,0
2016,Officer,05602,3,3,0
2016,Officer,05663,4,4,0
2016,Officer,05676,2,2,0
2016,Officer,05851,2,2,0
2016,Officer,05855,2,2,0
2016,Officer,06051,2,2,0
2016,Officer,06082,1,1,0
2016,Officer,06096,2,1,1
2016,Officer,06105,1,1,0
2016,Officer,06110,1,1,0
2016,Officer,06320,1,1,0
2016,Officer,06340,1,1,0
2016,Officer,06357,3,3,0
2016,Officer,06457,4,2,2
2016,Officer,06489,3,2,1
2016,Officer,06498,4,3,1
2016,Officer,06512,2,1,1
2016,Officer,06614,2,1,1
2016,Officer,06810,4,3,1
2016,Officer,07052,4,4,0
2016,Officer,07090,2,2,0
2016,Officer,07095,4,4,0
2016,Officer,07107,1,1,0
2016,Officer,07306,2,2,0
2016,Officer,07457,2,2,0
2016,Officer,07666,8,8,0
2016,Officer,07728,2,2,0
2016,Officer,07801,2,2,0
2016,Officer,07865,4,4,0
2016,Officer,07960,3,3,0
2016,Officer,08012,2,2,0
2016,Officer,08037,1,1,0
2016,Officer,08210,2,2,0
2016,Officer,08360,3,3,0
2016,Officer,08640,11,5,6
2016,Officer,08733,3,2,1
2016,Officer,08750,6,5,1
2016,Officer,08753,3,3,0
2016,Officer,08759,1,1,0
2016,Officer,08822,1,1,0
2016,Officer,08873,2,2,0
2016,Officer,10010,3,2,1
2016,Officer,10314,1,1,0
2016,Officer,10468,1,0,1
2016,Officer,10566,2,1,1
2016,Officer,10567,3,2,1
2016,Officer,10701,5,5,0
2016,Officer,10962,1,1,0
2016,Officer,11252,4,4,0
2016,Officer,11357,5,5,0
2016,Officer,11433,2,1,1
2016,Officer,11735,5,4,1
2016,Officer,12110,5,3,2
2016,Officer,12180,6,5,1
2016,Officer,12189,3,2,1
2016,Officer,12302,2,2,0
2016,Officer,12401,4,4,0
2016,Officer,12553,1,1,0
2016,Officer,12804,2,1,1
2016,Officer,13021,1,1,0
2016,Officer,13211,6,6,0
2016,Officer,13501,5,3,2
2016,Officer,13602,2,2,0
2016,Officer,13669,1,1,0
2016,Officer,13905,3,2,1
2016,Officer,14048,1,1,0
2016,Officer,14094,3,2,1
2016,Officer,14204,3,1,2
2016,Officer,14213,4,3,1
2016,Officer,14304,6,5,1
2016,Officer,14454,1,1,0
2016,Officer,14624,3,2,1
2016,Officer,14701,2,1,1
2016,Officer,14845,1,1,0
2016,Officer,15010,1,1,0
2016,Officer,15216,6,6,0
2016,Officer,15301,5,3,2
2016,Officer,15425,1,1,0
2016,Officer,15541,1,1,0
2016,Officer,15601,1,1,0
2016,Officer,15666,2,2,0
2016,Officer,15701,1,1,0
2016,Officer,16101,1,1,0
2016,Officer,16301,1,1,0
2016,Officer,16403,5,5,0
2016,Officer,16635,1,1,0
2016,Officer,16652,1,1,0
2016,Officer,16803,3,3,0
2016,Officer,16830,2,2,0
2016,Officer,16901,3,3,0
2016,Officer,17003,20,17,3
2016,Officer,17013,3,3,0
2016,Officer,17022,6,4,2
2016,Officer,17033,1,1,0
2016,Officer,17042,3,3,0
2016,Officer,17044,1,1,0
2016,Officer,17103,11,10,1
2016,Officer,17201,2,2,0
2016,Officer,17325,1,1,0
2016,Officer,17331,3,3,0
2016,Officer,17745,1,1,0
2016,Officer,17837,3,3,0
2016,Officer,18102,3,3,0
2016,Officer,18235,1,1,0
2016,Officer,18301,1,1,0
2016,Officer,18466,2,2,0
2016,Officer,18509,2,2,0
2016,Officer,18704,3,3,0
2016,Officer,18960,2,2,0
2016,Officer,19044,6,6,0
2016,Officer,19103,1,1,0
2016,Officer,19104,4,4,0
2016,Officer,19153,1,1,0
2016,Officer,19154,4,4,0
2016,Officer,19460,1,1,0
2016,Officer,19462,3,3,0
2016,Officer,19526,2,2,0
2016,Officer,19605,4,4,0
2016,Officer,19711,1,1,0
2016,Officer,19720,2,2,0
2016,Officer,19804,2,2,0
2016,Officer,19808,1,1,0
2016,Officer,19977,4,4,0
2016,Officer,20003,28,23,5
2016,Officer,20112,1,1,0
2016,Officer,20175,1,1,0
2016,Officer,20186,4,2,2
2016,Officer,20373,3,3,0
2016,Officer,20623,2,2,0
2016,Officer,20646,2,2,0
2016,Officer,20708,2,2,0
2016,Officer,20882,1,1,0
2016,Officer,21010,5,5,0
2016,Officer,21043,2,2,0
2016,Officer,21057,1,1,0
2016,Officer,21061,1,1,0
2016,Officer,21078,1,1,0
2016,Officer,21136,6,6,0
2016,Officer,21201,2,2,0
2016,Officer,21204,5,5,0
2016,Officer,21228,1,1,0
2016,Officer,21236,1,1,0
2016,Officer,21401,3,3,0
2016,Officer,21719,1,1,0
2016,Officer,21740,1,1,0
2016,Officer,22032,3,3,0
2016,Officer,22060,4,4,0
2016,Officer,22401,3,3,0
2016,Officer,22427,1,1,0
2016,Officer,22601,6,6,0
2016,Officer,22664,2,2,0
2016,Officer,22731,2,2,0
2016,Officer,22801,2,2,0
2016,Officer,22902,2,2,0
2016,Officer,23069,2,1,1
2016,Officer,23139,3,2,1
2016,Officer,23150,5,5,0
2016,Officer,23434,1,1,0
2016,Officer,23451,9,8,1
2016,Officer,23502,13,8,5
2016,Officer,23666,2,2,0
2016,Officer,23701,2,2,0
2016,Officer,23805,6,5,1
2016,Officer,23824,5,4,1
2016,Officer,23847,1,1,0
2016,Officer,24073,1,0,1
2016,Officer,24112,3,2,1
2016,Officer,24151,2,2,0
2016,Officer,24251,1,1,0
2016,Officer,24301,2,2,0
2016,Officer,24502,4,4,0
2016,Officer,24523,4,2,2
2016,Officer,24541,2,2,0
2016,Officer,24592,1,1,0
2016,Officer,24609,1,1,0
2016,Officer,24801,3,3,0
2016,Officer,25168,1,1,0
2016,Officer,25309,1,1,0
2016,Officer,25311,4,4,0
2016,Officer,25530,3,3,0
2016,Officer,25846,2,2,0
2016,Officer,26041,2,2,0
2016,Officer,26101,5,5,0
2016,Officer,26187,5,5,0
2016,Officer,26330,1,1,0
2016,Officer,26505,1,1,0
2016,Officer,26537,4,4,0
2016,Officer,26554,2,2,0
2016,Officer,26624,1,1,0
2016,Officer,26651,1,1,0
2016,Officer,26836,1,1,0
2016,Officer,27030,1,1,0
2016,Officer,27103,3,3,0
2016,Officer,27204,1,0,1
2016,Officer,27217,2,2,0
2016,Officer,27260,1,1,0
2016,Officer,27292,3,3,0
2016,Officer,27344,4,4,0
2016,Officer,27360,1,1,0
2016,Officer,27401,3,3,0
2016,Officer,27504,1,1,0
2016,Officer,27530,1,1,0
2016,Officer,27549,3,3,0
2016,Officer,27560,8,8,0
2016,Officer,27577,1,1,0
2016,Officer,27581,1,1,0
2016,Officer,27607,10,10,0
2016,Officer,27704,9,9,0
2016,Officer,27803,1,1,0
2016,Officer,27828,2,2,0
2016,Officer,27856,1,1,0
2016,Officer,27870,2,2,0
2016,Officer,27889,2,2,0
2016,Officer,27897,1,1,0
2016,Officer,27932,2,2,0
2016,Officer,28001,5,5,0
2016,Officer,28012,5,5,0
2016,Officer,28027,1,1,0
2016,Officer,28054,2,2,0
2016,Officer,28086,1,1,0
2016,Officer,28110,1,1,0
2016,Officer,28115,1,1,0
2016,Officer,28170,1,1,0
2016,Officer,28208,5,3,2
2016,Officer,28310,1,1,0
2016,Officer,28328,1,1,0
2016,Officer,28334,1,1,0
2016,Officer,28352,1,0,1
2016,Officer,28359,1,1,0
2016,Officer,28365,1,1,0
2016,Officer,28371,1,1,0
2016,Officer,28376,3,3,0
2016,Officer,28377,1,1,0
2016,Officer,28382,2,2,0
2016,Officer,28388,3,3,0
2016,Officer,28472,1,1,0
2016,Officer,28540,1,1,0
2016,Officer,28601,2,2,0
2016,Officer,28645,3,3,0
2016,Officer,28681,1,1,0
2016,Officer,28721,1,1,0
2016,Officer,28726,1,1,0
2016,Officer,28806,2,2,0
2016,Officer,29020,1,1,0
2016,Officer,29044,10,10,0
2016,Officer,29102,1,1,0
2016,Officer,29151,2,2,0
2016,Officer,29161,2,2,0
2016,Officer,29170,4,4,0
2016,Officer,29201,13,13,0
2016,Officer,29303,6,6,0
2016,Officer,29341,1,1,0
2016,Officer,29379,1,1,0
2016,Officer,29403,1,1,0
2016,Officer,29418,6,6,0
2016,Officer,29440,1,1,0
2016,Officer,29461,1,1,0
2016,Officer,29465,1,1,0
2016,Officer,29483,1,1,0
2016,Officer,29506,1,1,0
2016,Officer,29510,1,1,0
2016,Officer,29532,2,2,0
2016,Officer,29574,1,1,0
2016,Officer,29605,1,1,0
2016,Officer,29625,1,1,0
2016,Officer,29631,3,3,0
2016,Officer,29641,2,2,0
2016,Officer,29644,1,1,0
2016,Officer,29646,4,4,0
2016,Officer,29651,3,3,0
2016,Officer,29653,2,2,0
2016,Officer,29678,1,1,0
2016,Officer,29715,1,1,0
2016,Officer,29720,1,1,0
2016,Officer,29732,1,1,0
2016,Officer,29812,1,1,0
2016,Officer,29824,1,1,0
2016,Officer,29906,2,2,0
2016,Officer,30014,2,2,0
2016,Officer,30040,10,9,1
2016,Officer,30060,23,22,1
2016,Officer,30069,3,2,1
2016,Officer,30114,1,1,0
2016,Officer,30125,1,0,1
2016,Officer,30134,1,1,0
2016,Officer,30224,2,1,1
2016,Officer,30263,1,1,0
2016,Officer,30294,2,1,1
2016,Officer,30297,4,4,0
2016,Officer,30336,4,3,1
2016,Officer,30427,1,1,0
2016,Officer,30439,1,1,0
2016,Officer,30461,3,3,0
2016,Officer,30501,2,2,0
2016,Officer,30635,1,0,1
2016,Officer,30643,1,1,0
2016,Officer,30655,2,1,1
2016,Officer,30673,1,1,0
2016,Officer,30680,3,2,1
2016,Officer,30701,2,2,0
2016,Officer,30824,1,1,0
2016,Officer,30904,5,4,1
2016,Officer,30905,2,2,0
2016,Officer,31029,3,3,0
2016,Officer,31211,7,7,0
2016,Officer,31313,1,1,0
2016,Officer,31314,3,2,1
2016,Officer,31329,1,0,1
2016,Officer,31520,1,1,0
2016,Officer,31533,2,2,0
2016,Officer,31601,2,2,0
2016,Officer,31701,1,1,0
2016,Officer,31794,1,1,0
2016,Officer,31901,1,1,0
2016,Officer,31905,2,2,0
2016,Officer,32055,2,2,0
2016,Officer,32064,4,4,0
2016,Officer,32084,2,2,0
2016,Officer,32086,2,2,0
2016,Officer,32091,6,6,0
2016,Officer,32221,6,6,0
2016,Officer,32311,2,2,0
2016,Officer,32351,2,2,0
2016,Officer,32406,4,4,0
2016,Officer,32425,2,2,0
2016,Officer,32447,1,1,0
2016,Officer,32514,2,2,0
2016,Officer,32536,1,1,0
2016,Officer,32609,1,1,0
2016,Officer,32724,5,5,0
2016,Officer,32771,1,1,0
2016,Officer,32827,2,2,0
2016,Officer,32856,1,1,0
2016,Officer,32924,1,1,0
2016,Officer,32935,1,1,0
2016,Officer,33020,1,1,0
2016,Officer,33025,2,2,0
2016,Officer,33039,1,1,0
2016,Officer,33127,3,3,0
2016,Officer,33315,1,1,0
2016,Officer,33406,3,3,0
2016,Officer,33563,1,1,0
2016,Officer,33567,3,3,0
2016,Officer,33711,1,1,0
2016,Officer,33782,6,6,0
2016,Officer,33811,2,2,0
2016,Officer,33825,1,1,0
2016,Officer,33830,1,1,0
2016,Officer,33859,2,2,0
2016,Officer,33873,1,1,0
2016,Officer,33880,2,2,0
2016,Officer,33916,2,2,0
2016,Officer,34208,4,4,0
2016,Officer,34221,3,3,0
2016,Officer,34237,2,2,0
2016,Officer,34266,1,1,0
2016,Officer,34474,5,5,0
2016,Officer,34604,1,1,0
2016,Officer,34748,2,2,0
2016,Officer,34947,1,1,0
2016,Officer,35040,1,1,0
2016,Officer,35042,5,5,0
2016,Officer,35055,1,1,0
2016,Officer,35121,4,4,0
2016,Officer,35161,4,4,0
2016,Officer,35178,2,2,0
2016,Officer,35209,2,2,0
2016,Officer,35217,12,12,0
2016,Officer,35405,1,1,0
2016,Officer,35476,1,1,0
2016,Officer,35555,2,2,0
2016,Officer,35565,2,2,0
2016,Officer,35601,4,4,0
2016,Officer,35630,2,2,0
2016,Officer,35768,1,1,0
2016,Officer,35803,4,4,0
2016,Officer,35805,2,2,0
2016,Officer,36043,2,2,0
2016,Officer,36067,1,1,0
2016,Officer,36078,1,1,0
2016,Officer,36081,1,1,0
2016,Officer,36109,6,6,0
2016,Officer,36117,1,1,0
2016,Officer,36121,1,1,0
2016,Officer,36203,1,1,0
2016,Officer,36205,6,6,0
2016,Officer,36251,1,1,0
2016,Officer,36265,1,1,0
2016,Officer,36323,1,1,0
2016,Officer,36330,2,2,0
2016,Officer,36340,1,1,0
2016,Officer,36421,2,2,0
2016,Officer,36426,1,1,0
2016,Officer,36532,1,1,0
2016,Officer,36605,5,5,0
2016,Officer,36608,1,1,0
2016,Officer,36832,1,1,0
2016,Officer,36854,1,1,0
2016,Officer,36867,1,1,0
2016,Officer,37033,1,1,0
2016,Officer,37056,1,1,0
2016,Officer,37090,2,2,0
2016,Officer,37097,1,1,0
2016,Officer,37167,12,9,3
2016,Officer,37204,5,4,1
2016,Officer,37217,3,3,0
2016,Officer,37323,1,0,1
2016,Officer,37388,1,1,0
2016,Officer,37398,2,2,0
2016,Officer,37404,5,4,1
2016,Officer,37615,1,1,0
2016,Officer,37620,1,0,1
2016,Officer,37645,2,2,0
2016,Officer,37650,1,1,0
2016,Officer,37760,1,1,0
2016,Officer,37771,1,1,0
2016,Officer,37777,1,1,0
2016,Officer,37825,1,1,0
2016,Officer,37857,1,1,0
2016,Officer,37919,1,1,0
2016,Officer,37939,1,1,0
2016,Officer,38001,2,1,1
2016,Officer,38019,1,1,0
2016,Officer,38024,1,1,0
2016,Officer,38063,1,0,1
2016,Officer,38118,1,1,0
2016,Officer,38201,1,0,1
2016,Officer,38242,1,1,0
2016,Officer,38261,1,1,0
2016,Officer,38302,3,2,1
2016,Officer,38340,1,1,0
2016,Officer,38358,1,1,0
2016,Officer,38382,2,1,1
2016,Officer,38462,1,1,0
2016,Officer,38464,1,0,1
2016,Officer,38478,1,1,0
2016,Officer,38506,1,1,0
2016,Officer,38563,1,1,0
2016,Officer,38572,2,2,0
2016,Officer,38606,2,2,0
2016,Officer,38614,2,2,0
2016,Officer,38655,1,0,1
2016,Officer,38668,1,1,0
2016,Officer,38751,1,1,0
2016,Officer,38801,2,2,0
2016,Officer,38803,1,1,0
2016,Officer,38821,3,3,0
2016,Officer,38834,1,1,0
2016,Officer,38843,1,1,0
2016,Officer,38852,2,2,0
2016,Officer,38902,1,1,0
2016,Officer,38915,2,2,0
2016,Officer,38926,1,1,0
2016,Officer,39043,1,1,0
2016,Officer,39046,3,3,0
2016,Officer,39060,2,2,0
2016,Officer,39074,2,1,1
2016,Officer,39111,3,3,0
2016,Officer,39120,1,1,0
2016,Officer,39183,3,3,0
2016,Officer,39202,1,1,0
2016,Officer,39204,7,5,2
2016,Officer,39216,1,1,0
2016,Officer,39296,7,6,1
2016,Officer,39307,2,1,1
2016,Officer,39345,1,1,0
2016,Officer,39355,2,2,0
2016,Officer,39403,1,1,0
2016,Officer,39407,7,7,0
2016,Officer,39422,1,1,0
2016,Officer,39429,1,1,0
2016,Officer,39440,2,2,0
2016,Officer,39501,2,2,0
2016,Officer,39507,5,5,0
2016,Officer,39556,1,1,0
2016,Officer,39648,5,5,0
2016,Officer,39760,1,1,0
2016,Officer,39773,1,1,0
2016,Officer,40065,1,0,1
2016,Officer,40218,3,3,0
2016,Officer,40330,1,1,0
2016,Officer,40475,5,5,0
2016,Officer,40510,5,4,1
2016,Officer,40601,10,8,2
2016,Officer,40741,1,1,0
2016,Officer,40906,2,2,0
2016,Officer,40965,1,1,0
2016,Officer,41005,2,2,0
2016,Officer,41008,1,1,0
2016,Officer,41031,1,0,1
2016,Officer,41056,1,1,0
2016,Officer,41101,5,4,1
2016,Officer,41164,2,2,0
2016,Officer,41653,2,1,1
2016,Officer,42025,2,2,0
2016,Officer,42064,1,1,0
2016,Officer,42071,1,1,0
2016,Officer,42101,1,1,0
2016,Officer,42167,2,1,1
2016,Officer,42301,2,2,0
2016,Officer,42345,1,1,0
2016,Officer,42754,1,1,0
2016,Officer,43015,2,2,0
2016,Officer,43040,1,1,0
2016,Officer,43055,3,0,3
2016,Officer,43102,2,0,2
2016,Officer,43213,6,3,3
2016,Officer,43217,5,5,0
2016,Officer,43235,8,5,3
2016,Officer,43402,1,1,0
2016,Officer,43465,2,1,1
2016,Officer,43756,2,1,1
2016,Officer,44023,1,1,0
2016,Officer,44055,2,2,0
2016,Officer,44128,1,1,0
2016,Officer,44142,2,2,0
2016,Officer,44224,1,1,0
2016,Officer,44256,2,1,1
2016,Officer,44313,3,2,1
2016,Officer,44444,1,1,0
2016,Officer,44515,3,2,1
2016,Officer,44601,2,1,1
2016,Officer,44720,3,2,1
2016,Officer,44857,1,1,0
2016,Officer,44883,3,3,0
2016,Officer,44903,1,1,0
2016,Officer,45015,2,1,1
2016,Officer,45044,2,2,0
2016,Officer,45215,3,2,1
2016,Officer,45331,1,1,0
2016,Officer,45346,1,0,1
2016,Officer,45430,1,1,0
2016,Officer,45502,2,1,1
2016,Officer,45804,1,1,0
2016,Officer,46012,1,1,0
2016,Officer,46041,1,1,0
2016,Officer,46052,2,2,0
2016,Officer,46122,1,1,0
2016,Officer,46124,3,2,1
2016,Officer,46131,11,9,2
2016,Officer,46135,1,1,0
2016,Officer,46140,1,0,1
2016,Officer,46151,1,1,0
2016,Officer,46176,2,2,0
2016,Officer,46216,3,3,0
2016,Officer,46241,28,24,4
2016,Officer,46323,1,1,0
2016,Officer,46360,2,2,0
2016,Officer,46383,3,3,0
2016,Officer,46402,1,1,0
2016,Officer,46406,2,2,0
2016,Officer,46517,2,2,0
2016,Officer,46613,6,6,0
2016,Officer,46703,2,2,0
2016,Officer,46714,2,2,0
2016,Officer,46825,3,3,0
2016,Officer,46901,6,6,0
2016,Officer,46947,1,1,0
2016,Officer,46953,3,1,2
2016,Officer,47150,1,1,0
2016,Officer,47167,1,1,0
2016,Officer,47203,3,2,1
2016,Officer,47274,2,2,0
2016,Officer,47303,1,1,0
2016,Officer,47331,3,2,1
2016,Officer,47401,3,3,0
2016,Officer,47441,1,1,0
2016,Officer,47546,2,2,0
2016,Officer,47715,4,4,0
2016,Officer,47804,2,2,0
2016,Officer,47872,1,1,0
2016,Officer,47905,4,4,0
2016,Officer,47933,1,1,0
2016,Officer,47960,1,1,0
2016,Officer,47977,1,1,0
2016,Officer,48045,1,1,0
2016,Officer,48060,1,1,0
2016,Officer,48180,8,6,2
2016,Officer,48197,4,4,0
2016,Officer,48208,2,2,0
2016,Officer,48234,9,9,0
2016,Officer,48341,2,1,1
2016,Officer,48601,7,7,0
2016,Officer,48801,1,0,1
2016,Officer,48837,2,1,1
2016,Officer,48843,1,0,1
2016,Officer,48906,8,8,0
2016,Officer,48912,5,3,2
2016,Officer,49009,6,4,2
2016,Officer,49012,4,4,0
2016,Officer,49307,4,4,0
2016,Officer,49509,11,11,0
2016,Officer,49660,1,1,0
2016,Officer,49739,2,2,0
2016,Officer,49849,2,2,0
2016,Officer,50036,4,4,0
2016,Officer,50126,1,1,0
2016,Officer,50131,27,23,4
2016,Officer,50321,1,1,0
2016,Officer,50511,1,1,0
2016,Officer,50588,1,1,0
2016,Officer,50616,1,0,1
2016,Officer,50703,5,5,0
2016,Officer,51031,1,1,0
2016,Officer,51111,1,1,0
2016,Officer,51201,1,1,0
2016,Officer,51401,1,1,0
2016,Officer,51442,1,1,0
2016,Officer,51503,2,2,0
2016,Officer,52002,1,1,0
2016,Officer,52246,3,3,0
2016,Officer,52353,1,1,0
2016,Officer,52404,2,2,0
2016,Officer,52501,1,1,0
2016,Officer,52556,1,1,0
2016,Officer,52577,1,1,0
2016,Officer,52632,1,1,0
2016,Officer,52638,1,1,0
2016,Officer,52732,1,1,0
2016,Officer,52806,6,5,1
2016,Officer,53073,1,1,0
2016,Officer,53089,3,3,0
2016,Officer,53094,1,1,0
2016,Officer,53095,4,4,0
2016,Officer,53105,2,1,1
2016,Officer,53186,1,1,0
2016,Officer,53190,1,1,0
2016,Officer,53212,7,7,0
2016,Officer,53403,2,2,0
2016,Officer,53538,1,1,0
2016,Officer,53545,2,2,0
2016,Officer,53704,12,10,2
2016,Officer,54017,1,1,0
2016,Officer,54022,1,1,0
2016,Officer,54241,1,0,1
2016,Officer,54303,1,1,0
2016,Officer,54401,1,1,0
2016,Officer,54409,1,1,0
2016,Officer,54455,1,1,0
2016,Officer,54487,1,1,0
2016,Officer,54495,2,2,0
2016,Officer,54612,2,1,1
2016,Officer,54615,1,1,0
2016,Officer,54618,2,2,0
2016,Officer,54650,1,1,0
2016,Officer,54703,1,1,0
2016,Officer,54868,1,1,0
2016,Officer,54880,1,1,0
2016,Officer,54914,3,3,0
2016,Officer,54923,3,2,1
2016,Officer,54929,3,3,0
2016,Officer,54935,2,1,1
2016,Officer,54971,1,1,0
2016,Officer,55008,1,1,0
2016,Officer,55016,3,3,0
2016,Officer,55021,2,2,0
2016,Officer,55033,1,1,0
2016,Officer,55063,1,1,0
2016,Officer,55066,2,2,0
2016,Officer,55068,6,6,0
2016,Officer,55077,1,1,0
2016,Officer,55082,2,2,0
2016,Officer,55101,5,5,0
2016,Officer,55107,8,6,2
2016,Officer,55112,3,3,0
2016,Officer,55113,1,1,0
2016,Officer,55118,2,2,0
2016,Officer,55362,1,1,0
2016,Officer,55431,5,5,0
2016,Officer,55443,3,3,0
2016,Officer,55744,1,1,0
2016,Officer,55811,1,1,0
2016,Officer,55904,1,1,0
2016,Officer,55987,1,1,0
2016,Officer,56001,3,3,0
2016,Officer,56007,1,1,0
2016,Officer,56081,1,1,0
2016,Officer,56258,1,1,0
2016,Officer,56265,1,1,0
2016,Officer,56278,1,1,0
2016,Officer,56303,2,1,1
2016,Officer,56345,8,7,1
2016,Officer,56401,2,2,0
2016,Officer,56482,3,1,2
2016,Officer,56501,1,1,0
2016,Officer,56560,4,4,0
2016,Officer,57006,2,2,0
2016,Officer,57042,1,1,0
2016,Officer,57078,2,2,0
2016,Officer,57104,3,3,0
2016,Officer,57201,6,4,2
2016,Officer,57252,1,0,1
2016,Officer,57301,1,1,0
2016,Officer,57501,2,2,0
2016,Officer,57702,3,3,0
2016,Officer,57706,1,1,0
2016,Officer,57717,1,1,0
2016,Officer,57785,1,1,0
2016,Officer,58072,3,3,0
2016,Officer,58075,1,1,0
2016,Officer,58102,9,9,0
2016,Officer,58368,1,1,0
2016,Officer,58402,1,1,0
2016,Officer,58433,1,1,0
2016,Officer,58506,9,9,0
2016,Officer,58703,2,2,0
2016,Officer,58802,1,1,0
2016,Officer,59047,1,1,0
2016,Officer,59102,6,6,0
2016,Officer,59218,1,1,0
2016,Officer,59230,1,1,0
2016,Officer,59301,1,1,0
2016,Officer,59405,1,1,0
2016,Officer,59602,2,2,0
2016,Officer,59636,3,3,0
2016,Officer,59714,1,1,0
2016,Officer,59808,3,3,0
2016,Officer,59840,1,1,0
2016,Officer,59901,1,1,0
2016,Officer,60037,2,2,0
2016,Officer,60435,1,1,0
2016,Officer,60472,4,4,0
2016,Officer,60505,1,1,0
2016,Officer,60546,9,9,0
2016,Officer,60615,4,4,0
2016,Officer,60616,2,2,0
2016,Officer,60651,3,3,0
2016,Officer,61021,2,2,0
2016,Officer,61115,4,4,0
2016,Officer,61264,4,4,0
2016,Officer,61341,1,1,0
2016,Officer,61401,3,3,0
2016,Officer,61443,2,2,0
2016,Officer,61607,8,7,1
2016,Officer,61701,2,2,0
2016,Officer,61761,3,3,0
2016,Officer,61764,1,1,0
2016,Officer,61801,5,5,0
2016,Officer,61938,2,2,0
2016,Officer,62269,1,1,0
2016,Officer,62286,1,1,0
2016,Officer,62305,1,1,0
2016,Officer,62401,3,3,0
2016,Officer,62521,1,1,0
2016,Officer,62702,14,13,1
2016,Officer,62864,1,1,0
2016,Officer,62959,1,1,0
2016,Officer,63020,2,1,1
2016,Officer,63028,2,2,0
2016,Officer,63044,2,1,1
2016,Officer,63109,3,3,0
2016,Officer,63125,1,1,0
2016,Officer,63383,2,2,0
2016,Officer,63401,1,1,0
2016,Officer,63640,3,3,0
2016,Officer,63703,2,2,0
2016,Officer,63857,1,1,0
2016,Officer,63901,2,2,0
2016,Officer,64067,5,4,1
2016,Officer,64085,2,2,0
2016,Officer,64093,1,1,0
2016,Officer,64129,8,7,1
2016,Officer,64402,1,1,0
2016,Officer,64468,4,4,0
2016,Officer,64506,5,5,0
2016,Officer,64601,1,1,0
2016,Officer,64701,2,2,0
2016,Officer,64759,6,5,1
2016,Officer,64772,2,1,1
2016,Officer,64804,2,2,0
2016,Officer,64836,1,1,0
2016,Officer,64850,1,1,0
2016,Officer,65101,7,6,1
2016,Officer,65109,2,2,0
2016,Officer,65202,2,2,0
2016,Officer,65233,1,1,0
2016,Officer,65251,1,0,1
2016,Officer,65301,1,1,0
2016,Officer,65305,5,5,0
2016,Officer,65340,1,1,0
2016,Officer,65401,1,1,0
2016,Officer,65473,4,3,1
2016,Officer,65536,2,2,0
2016,Officer,65605,1,1,0
2016,Officer,65708,1,0,1
2016,Officer,65723,1,0,1
2016,Officer,65802,4,2,2
2016,Officer,65803,3,3,0
2016,Officer,66027,5,4,1
2016,Officer,66061,3,3,0
2016,Officer,66067,1,1,0
2016,Officer,66102,1,1,0
2016,Officer,66219,3,2,1
2016,Officer,66502,1,1,0
2016,Officer,66611,4,1,3
2016,Officer,66619,6,6,0
2016,Officer,66749,2,2,0
2016,Officer,66801,1,1,0
2016,Officer,67114,1,1,0
2016,Officer,67217,1,1,0
2016,Officer,67219,2,2,0
2016,Officer,67337,3,2,1
2016,Officer,67401,1,1,0
2016,Officer,67410,1,1,0
2016,Officer,67501,3,3,0
2016,Officer,67601,5,5,0
2016,Officer,68066,1,1,0
2016,Officer,68073,3,3,0
2016,Officer,68106,4,4,0
2016,Officer,68142,1,1,0
2016,Officer,68310,3,2,1
2016,Officer,68410,1,1,0
2016,Officer,68508,7,6,1
2016,Officer,68524,9,7,2
2016,Officer,68601,4,4,0
2016,Officer,68763,1,1,0
2016,Officer,68801,2,2,0
2016,Officer,68847,2,2,0
2016,Officer,68901,1,1,0
2016,Officer,69337,1,1,0
2016,Officer,70117,14,10,4
2016,Officer,70364,2,2,0
2016,Officer,70390,1,1,0
2016,Officer,70401,2,2,0
2016,Officer,70403,1,1,0
2016,Officer,70427,1,1,0
2016,Officer,70433,1,0,1
2016,Officer,70438,1,1,0
2016,Officer,70508,5,5,0
2016,Officer,70510,1,1,0
2016,Officer,70517,2,2,0
2016,Officer,70526,1,1,0
2016,Officer,70563,1,1,0
2016,Officer,70582,1,0,1
2016,Officer,70601,1,1,0
2016,Officer,70714,1,1,0
2016,Officer,70721,7,7,0
2016,Officer,70737,1,1,0
2016,Officer,70760,2,2,0
2016,Officer,70820,8,8,0
2016,Officer,71055,3,3,0
2016,Officer,71101,1,1,0
2016,Officer,71220,1,1,0
2016,Officer,71270,1,1,0
2016,Officer,71322,1,1,0
2016,Officer,71360,5,5,0
2016,Officer,71457,1,1,0
2016,Officer,71602,1,1,0
2016,Officer,71730,2,2,0
2016,Officer,71801,1,1,0
2016,Officer,71854,2,1,1
2016,Officer,71913,1,1,0
2016,Officer,72007,1,1,0
2016,Officer,72012,2,2,0
2016,Officer,72034,2,1,1
2016,Officer,72064,1,1,0
2016,Officer,72086,1,0,1
2016,Officer,72110,1,1,0
2016,Officer,72114,2,2,0
2016,Officer,72143,2,2,0
2016,Officer,72160,1,1,0
2016,Officer,72199,15,10,5
2016,Officer,72335,2,1,1
2016,Officer,72401,1,1,0
2016,Officer,72476,2,2,0
2016,Officer,72653,2,2,0
2016,Officer,72701,5,4,1
2016,Officer,72712,3,3,0
2016,Officer,72802,2,2,0
2016,Officer,72923,4,3,1
2016,Officer,72949,2,2,0
2016,Officer,73034,1,1,0
2016,Officer,73036,1,1,0
2016,Officer,73051,2,2,0
2016,Officer,73064,3,2,1
2016,Officer,73069,9,8,1
2016,Officer,73111,4,4,0
2016,Officer,73179,2,2,0
2016,Officer,73503,1,0,1
2016,Officer,73705,2,2,0
2016,Officer,74014,8,8,0
2016,Officer,74075,2,2,0
2016,Officer,74107,3,3,0
2016,Officer,74301,1,1,0
2016,Officer,74403,2,2,0
2016,Officer,74447,1,1,0
2016,Officer,74501,4,3,1
2016,Officer,74601,2,1,1
2016,Officer,74804,2,1,1
2016,Officer,74820,1,1,0
2016,Officer,74834,1,1,0
2016,Officer,75020,2,2,0
2016,Officer,75051,10,10,0
2016,Officer,75160,1,1,0
2016,Officer,75709,1,1,0
2016,Officer,75803,1,1,0
2016,Officer,75901,1,1,0
2016,Officer,76086,1,1,0
2016,Officer,76105,4,4,0
2016,Officer,76108,6,6,0
2016,Officer,76115,3,3,0
2016,Officer,76234,1,1,0
2016,Officer,76302,3,3,0
2016,Officer,76502,7,7,0
2016,Officer,76542,1,1,0
2016,Officer,76707,3,3,0
2016,Officer,76905,1,1,0
2016,Officer,77034,10,10,0
2016,Officer,77067,4,4,0
2016,Officer,77082,2,2,0
2016,Officer,77340,3,3,0
2016,Officer,77471,1,1,0
2016,Officer,77568,1,1,0
2016,Officer,77802,8,8,0
2016,Officer,77833,2,2,0
2016,Officer,78041,1,1,0
2016,Officer,78130,6,6,0
2016,Officer,78155,2,2,0
2016,Officer,78218,3,3,0
2016,Officer,78219,4,4,0
2016,Officer,78257,11,11,0
2016,Officer,78363,1,1,0
2016,Officer,78416,4,4,0
2016,Officer,78520,1,1,0
2016,Officer,78596,5,5,0
2016,Officer,78617,2,2,0
2016,Officer,78665,6,6,0
2016,Officer,78666,8,8,0
2016,Officer,78703,20,20,0
2016,Officer,78731,9,9,0
2016,Officer,78746,4,4,0
2016,Officer,78861,1,1,0
2016,Officer,79403,2,2,0
2016,Officer,79607,4,4,0
2016,Officer,79936,3,3,0
2016,Officer,79963,1,1,0
2016,Officer,80011,14,13,1
2016,Officer,80112,3,3,0
2016,Officer,80137,1,1,0
2016,Officer,80216,3,3,0
2016,Officer,80501,1,1,0
2016,Officer,80504,2,1,1
2016,Officer,80521,1,1,0
2016,Officer,80550,1,1,0
2016,Officer,80751,1,1,0
2016,Officer,80907,6,5,1
2016,Officer,80913,3,3,0
2016,Officer,80916,8,8,0
2016,Officer,80920,7,4,3
2016,Officer,82009,10,8,2
2016,Officer,82072,3,3,0
2016,Officer,82240,2,2,0
2016,Officer,82520,1,1,0
2016,Officer,82604,3,1,2
2016,Officer,82801,2,1,1
2016,Officer,82901,1,1,0
2016,Officer,83202,1,1,0
2016,Officer,83221,2,2,0
2016,Officer,83301,2,1,1
2016,Officer,83402,1,1,0
2016,Officer,83442,1,1,0
2016,Officer,83605,2,2,0
2016,Officer,83617,1,1,0
2016,Officer,83647,1,1,0
2016,Officer,83705,10,9,1
2016,Officer,84003,1,1,0
2016,Officer,84020,4,3,1
2016,Officer,84043,3,3,0
2016,Officer,84058,2,1,1
2016,Officer,84065,18,14,4
2016,Officer,84084,7,7,0
2016,Officer,84323,1,1,0
2016,Officer,84405,1,1,0
2016,Officer,84501,1,1,0
2016,Officer,84660,1,1,0
2016,Officer,84663,1,1,0
2016,Officer,84701,1,1,0
2016,Officer,84720,1,1,0
2016,Officer,84770,1,1,0
2016,Officer,85008,29,26,3
2016,Officer,85020,1,1,0
2016,Officer,85122,1,1,0
2016,Officer,85128,2,2,0
2016,Officer,85132,8,7,1
2016,Officer,85281,3,2,1
2016,Officer,85286,1,1,0
2016,Officer,85312,1,1,0
2016,Officer,85653,2,2,0
2016,Officer,85706,2,2,0
2016,Officer,85713,2,2,0
2016,Officer,85901,1,1,0
2016,Officer,86015,2,2,0
2016,Officer,86301,1,1,0
2016,Officer,87002,1,1,0
2016,Officer,87123,3,2,1
2016,Officer,87144,13,13,0
2016,Officer,87401,2,2,0
2016,Officer,87508,2,2,0
2016,Officer,88007,5,5,0
2016,Officer,88203,3,3,0
2016,Officer,88240,1,1,0
2016,Officer,88310,1,1,0
2016,Officer,89002,2,2,0
2016,Officer,89115,6,6,0
2016,Officer,89139,5,5,0
2016,Officer,89165,7,7,0
2016,Officer,89506,2,2,0
2016,Officer,89509,2,2,0
2016,Officer,90201,12,12,0
2016,Officer,90249,2,2,0
2016,Officer,90266,3,3,0
2016,Officer,90302,2,2,0
2016,Officer,90640,3,3,0
2016,Officer,90720,10,10,0
2016,Officer,90731,1,1,0
2016,Officer,90813,1,1,0
2016,Officer,90822,7,7,0
2016,Officer,91702,6,6,0
2016,Officer,91764,2,2,0
2016,Officer,91766,1,1,0
2016,Officer,92025,1,1,0
2016,Officer,92111,3,3,0
2016,Officer,92243,1,1,0
2016,Officer,92324,1,1,0
2016,Officer,92410,1,1,0
2016,Officer,92707,1,1,0
2016,Officer,92866,1,1,0
2016,Officer,93003,3,3,0
2016,Officer,93030,1,1,0
2016,Officer,93103,1,1,0
2016,Officer,93291,1,1,0
2016,Officer,93307,4,4,0
2016,Officer,93451,3,3,0
2016,Officer,93727,6,6,0
2016,Officer,93955,1,1,0
2016,Officer,94035,1,1,0
2016,Officer,94401,2,2,0
2016,Officer,94533,6,6,0
2016,Officer,94565,2,2,0
2016,Officer,94568,2,2,0
2016,Officer,94952,1,1,0
2016,Officer,95110,1,1,0
2016,Officer,95206,4,4,0
2016,Officer,95240,2,2,0
2016,Officer,95341,1,1,0
2016,Officer,95351,3,3,0
2016,Officer,95361,2,2,0
2016,Officer,95401,1,1,0
2016,Officer,95603,1,1,0
2016,Officer,95655,2,2,0
2016,Officer,95826,4,4,0
2016,Officer,95828,13,13,0
2016,Officer,95965,1,1,0
2016,Officer,96130,1,1,0
2016,Officer,96707,13,13,0
2016,Officer,96716,2,2,0
2016,Officer,96720,3,3,0
2016,Officer,96782,1,1,0
2016,Officer,96786,5,5,0
2016,Officer,96789,2,2,0
2016,Officer,96816,3,3,0
2016,Officer,96857,1,1,0
2016,Officer,96913,11,8,3
2016,Officer,97015,13,13,0
2016,Officer,97030,1,1,0
2016,Officer,97031,1,1,0
2016,Officer,97051,2,2,0
2016,Officer,97071,1,1,0
2016,Officer,97116,4,3,1
2016,Officer,97124,3,3,0
2016,Officer,97211,4,3,1
2016,Officer,97218,6,6,0
2016,Officer,97301,3,3,0
2016,Officer,97302,1,1,0
2016,Officer,97303,3,3,0
2016,Officer,97304,1,1,0
2016,Officer,97309,7,7,0
2016,Officer,97321,1,0,1
2016,Officer,97338,1,0,1
2016,Officer,97355,3,3,0
2016,Officer,97420,2,2,0
2016,Officer,97470,1,1,0
2016,Officer,97477,1,1,0
2016,Officer,97501,2,2,0
2016,Officer,97520,2,2,0
2016,Officer,97526,1,1,0
2016,Officer,97603,1,1,0
2016,Officer,97702,3,2,1
2016,Officer,97754,2,1,1
2016,Officer,97756,2,0,2
2016,Officer,97801,1,0,1
2016,Officer,97838,1,1,0
2016,Officer,97850,2,0,2
2016,Officer,98032,5,5,0
2016,Officer,98119,6,6,0
2016,Officer,98290,2,2,0
2016,Officer,98430,16,15,1
2016,Officer,98433,13,12,1
2016,Officer,98531,1,1,0
2016,Officer,98563,1,1,0
2016,Officer,98632,3,3,0
2016,Officer,98682,4,4,0
2016,Officer,98903,1,1,0
2016,Officer,99011,1,1,0
2016,Officer,99217,2,2,0
2016,Officer,99219,2,2,0
2016,Officer,99224,1,1,0
2016,Officer,99505,14,12,2
2016,Officer,99687,1,1,0
2016,Officer,99731,1,1,0
2016,Warrant Officer,00735,1,1,0
2016,Warrant Officer,00751,2,2,0
2016,Warrant Officer,00795,1,1,0
2016,Warrant Officer,00850,2,2,0
2016,Warrant Officer,00901,2,2,0
2016,Warrant Officer,00951,1,1,0
2016,Warrant Officer,01434,1,1,0
2016,Warrant Officer,01453,1,1,0
2016,Warrant Officer,01760,1,1,0
2016,Warrant Officer,02043,1,1,0
2016,Warrant Officer,02301,1,1,0
2016,Warrant Officer,02542,3,3,0
2016,Warrant Officer,02842,2,2,0
2016,Warrant Officer,02852,3,3,0
2016,Warrant Officer,02920,1,1,0
2016,Warrant Officer,03301,4,4,0
2016,Warrant Officer,04011,1,1,0
2016,Warrant Officer,04333,4,4,0
2016,Warrant Officer,04401,5,5,0
2016,Warrant Officer,05403,2,2,0
2016,Warrant Officer,05446,2,2,0
2016,Warrant Officer,06096,2,2,0
2016,Warrant Officer,07052,1,1,0
2016,Warrant Officer,07666,2,2,0
2016,Warrant Officer,08640,1,1,0
2016,Warrant Officer,08733,2,2,0
2016,Warrant Officer,08759,1,1,0
2016,Warrant Officer,08873,1,1,0
2016,Warrant Officer,09096,1,1,0
2016,Warrant Officer,10314,2,2,0
2016,Warrant Officer,11433,1,1,0
2016,Warrant Officer,11779,2,2,0
2016,Warrant Officer,12110,3,3,0
2016,Warrant Officer,12180,2,2,0
2016,Warrant Officer,12804,1,1,0
2016,Warrant Officer,13211,2,2,0
2016,Warrant Officer,14624,2,2,0
2016,Warrant Officer,15301,2,2,0
2016,Warrant Officer,15902,3,3,0
2016,Warrant Officer,15904,1,1,0
2016,Warrant Officer,17003,9,9,0
2016,Warrant Officer,17013,1,1,0
2016,Warrant Officer,17103,2,2,0
2016,Warrant Officer,19044,2,2,0
2016,Warrant Officer,19605,1,1,0
2016,Warrant Officer,19720,1,1,0
2016,Warrant Officer,19977,1,1,0
2016,Warrant Officer,20003,4,4,0
2016,Warrant Officer,20653,1,1,0
2016,Warrant Officer,20708,2,2,0
2016,Warrant Officer,21010,7,7,0
2016,Warrant Officer,21057,1,1,0
2016,Warrant Officer,21136,1,1,0
2016,Warrant Officer,21201,1,1,0
2016,Warrant Officer,21204,2,2,0
2016,Warrant Officer,21401,1,1,0
2016,Warrant Officer,23150,5,5,0
2016,Warrant Officer,23824,2,2,0
2016,Warrant Officer,24112,1,1,0
2016,Warrant Officer,24401,2,2,0
2016,Warrant Officer,25168,1,1,0
2016,Warrant Officer,26187,17,17,0
2016,Warrant Officer,26330,1,1,0
2016,Warrant Officer,27401,1,1,0
2016,Warrant Officer,27560,6,6,0
2016,Warrant Officer,27607,2,2,0
2016,Warrant Officer,27828,1,1,0
2016,Warrant Officer,27870,1,1,0
2016,Warrant Officer,28334,1,1,0
2016,Warrant Officer,28376,1,1,0
2016,Warrant Officer,28560,1,1,0
2016,Warrant Officer,29044,10,10,0
2016,Warrant Officer,29170,1,1,0
2016,Warrant Officer,29303,2,2,0
2016,Warrant Officer,29403,1,1,0
2016,Warrant Officer,29483,2,2,0
2016,Warrant Officer,29605,2,2,0
2016,Warrant Officer,30060,4,4,0
2016,Warrant Officer,31406,1,1,0
2016,Warrant Officer,31409,3,3,0
2016,Warrant Officer,32086,1,1,0
2016,Warrant Officer,32091,2,2,0
2016,Warrant Officer,32221,6,6,0
2016,Warrant Officer,33606,1,1,0
2016,Warrant Officer,33782,2,2,0
2016,Warrant Officer,33811,1,1,0
2016,Warrant Officer,33873,1,1,0
2016,Warrant Officer,34266,1,1,0
2016,Warrant Officer,35042,2,2,0
2016,Warrant Officer,35178,1,1,0
2016,Warrant Officer,35209,1,1,0
2016,Warrant Officer,35217,2,2,0
2016,Warrant Officer,35710,2,2,0
2016,Warrant Officer,36043,3,3,0
2016,Warrant Officer,36109,2,2,0
2016,Warrant Officer,36205,3,3,0
2016,Warrant Officer,36421,1,1,0
2016,Warrant Officer,36502,1,1,0
2016,Warrant Officer,36608,2,2,0
2016,Warrant Officer,36701,1,1,0
2016,Warrant Officer,36801,1,1,0
2016,Warrant Officer,36832,2,2,0
2016,Warrant Officer,37204,2,2,0
2016,Warrant Officer,37217,1,1,0
2016,Warrant Officer,37404,2,2,0
2016,Warrant Officer,37777,2,2,0
2016,Warrant Officer,38301,1,1,0
2016,Warrant Officer,38302,1,1,0
2016,Warrant Officer,38343,1,1,0
2016,Warrant Officer,38583,1,1,0
2016,Warrant Officer,38801,5,5,0
2016,Warrant Officer,39204,1,1,0
2016,Warrant Officer,39209,1,1,0
2016,Warrant Officer,39296,3,3,0
2016,Warrant Officer,39307,3,3,0
2016,Warrant Officer,39345,1,1,0
2016,Warrant Officer,40205,2,2,0
2016,Warrant Officer,40475,1,1,0
2016,Warrant Officer,40510,2,2,0
2016,Warrant Officer,40601,11,11,0
2016,Warrant Officer,41005,1,1,0
2016,Warrant Officer,41101,2,2,0
2016,Warrant Officer,42025,2,2,0
2016,Warrant Officer,42301,2,2,0
2016,Warrant Officer,42330,2,2,0
2016,Warrant Officer,43213,3,3,0
2016,Warrant Officer,43217,3,3,0
2016,Warrant Officer,43235,2,2,0
2016,Warrant Officer,43812,1,1,0
2016,Warrant Officer,44142,1,1,0
2016,Warrant Officer,44256,2,2,0
2016,Warrant Officer,44515,1,1,0
2016,Warrant Officer,44720,1,1,0
2016,Warrant Officer,45215,1,1,0
2016,Warrant Officer,45346,1,1,0
2016,Warrant Officer,45502,2,2,0
2016,Warrant Officer,46124,1,1,0
2016,Warrant Officer,46131,3,3,0
2016,Warrant Officer,46176,6,6,0
2016,Warrant Officer,46241,2,2,0
2016,Warrant Officer,46901,4,4,0
2016,Warrant Officer,47303,1,1,0
2016,Warrant Officer,48045,1,1,0
2016,Warrant Officer,48180,1,1,0
2016,Warrant Officer,48837,3,3,0
2016,Warrant Officer,48838,1,1,0
2016,Warrant Officer,48906,2,2,0
2016,Warrant Officer,49509,1,1,0
2016,Warrant Officer,49739,1,1,0
2016,Warrant Officer,49837,1,1,0
2016,Warrant Officer,50036,8,8,0
2016,Warrant Officer,50131,3,3,0
2016,Warrant Officer,50703,1,1,0
2016,Warrant Officer,52577,1,1,0
2016,Warrant Officer,52806,3,3,0
2016,Warrant Officer,53095,2,2,0
2016,Warrant Officer,53704,4,4,0
2016,Warrant Officer,55021,3,3,0
2016,Warrant Officer,55068,5,5,0
2016,Warrant Officer,55101,2,2,0
2016,Warrant Officer,55107,7,7,0
2016,Warrant Officer,55303,1,1,0
2016,Warrant Officer,55413,1,1,0
2016,Warrant Officer,55431,4,4,0
2016,Warrant Officer,55443,1,1,0
2016,Warrant Officer,56303,2,2,0
2016,Warrant Officer,56345,1,1,0
2016,Warrant Officer,57104,2,2,0
2016,Warrant Officer,57380,1,1,0
2016,Warrant Officer,57501,1,1,0
2016,Warrant Officer,57702,2,2,0
2016,Warrant Officer,58072,1,1,0
2016,Warrant Officer,58102,1,1,0
2016,Warrant Officer,58201,2,2,0
2016,Warrant Officer,58506,3,3,0
2016,Warrant Officer,59102,2,2,0
2016,Warrant Officer,59602,2,2,0
2016,Warrant Officer,59636,1,1,0
2016,Warrant Officer,59701,2,2,0
2016,Warrant Officer,59901,1,1,0
2016,Warrant Officer,59923,1,1,0
2016,Warrant Officer,60638,1,1,0
2016,Warrant Officer,60651,1,1,0
2016,Warrant Officer,61455,1,1,0
2016,Warrant Officer,62521,2,2,0
2016,Warrant Officer,62702,1,1,0
2016,Warrant Officer,64506,1,1,0
2016,Warrant Officer,65101,4,4,0
2016,Warrant Officer,65305,3,3,0
2016,Warrant Officer,65473,2,2,0
2016,Warrant Officer,65803,2,2,0
2016,Warrant Officer,66027,1,1,0
2016,Warrant Officer,66611,2,2,0
2016,Warrant Officer,66619,3,3,0
2016,Warrant Officer,67219,1,1,0
2016,Warrant Officer,67401,1,1,0
2016,Warrant Officer,68142,1,1,0
2016,Warrant Officer,68524,3,3,0
2016,Warrant Officer,68601,2,2,0
2016,Warrant Officer,68701,1,1,0
2016,Warrant Officer,68801,3,3,0
2016,Warrant Officer,68847,1,1,0
2016,Warrant Officer,70401,3,3,0
2016,Warrant Officer,71270,1,1,0
2016,Warrant Officer,71360,3,3,0
2016,Warrant Officer,72199,12,12,0
2016,Warrant Officer,72543,1,1,0
2016,Warrant Officer,72701,4,4,0
2016,Warrant Officer,72744,1,1,0
2016,Warrant Officer,72905,1,1,0
2016,Warrant Officer,73051,4,4,0
2016,Warrant Officer,73064,1,1,0
2016,Warrant Officer,73069,3,3,0
2016,Warrant Officer,73111,4,4,0
2016,Warrant Officer,73179,2,2,0
2016,Warrant Officer,73503,1,1,0
2016,Warrant Officer,74014,2,2,0
2016,Warrant Officer,74116,1,1,0
2016,Warrant Officer,74423,1,1,0
2016,Warrant Officer,74447,1,1,0
2016,Warrant Officer,74834,2,2,0
2016,Warrant Officer,75051,1,1,0
2016,Warrant Officer,75110,1,1,0
2016,Warrant Officer,75237,2,2,0
2016,Warrant Officer,75709,1,1,0
2016,Warrant Officer,76115,1,1,0
2016,Warrant Officer,76502,1,1,0
2016,Warrant Officer,76707,1,1,0
2016,Warrant Officer,77034,3,3,0
2016,Warrant Officer,77082,1,1,0
2016,Warrant Officer,78218,1,1,0
2016,Warrant Officer,78219,5,5,0
2016,Warrant Officer,78257,1,1,0
2016,Warrant Officer,78617,5,5,0
2016,Warrant Officer,78666,1,1,0
2016,Warrant Officer,78703,10,10,0
2016,Warrant Officer,79403,1,1,0
2016,Warrant Officer,80011,5,5,0
2016,Warrant Officer,80012,1,1,0
2016,Warrant Officer,80916,1,1,0
2016,Warrant Officer,82009,2,2,0
2016,Warrant Officer,82604,1,1,0
2016,Warrant Officer,83501,1,1,0
2016,Warrant Officer,83647,2,2,0
2016,Warrant Officer,83705,4,4,0
2016,Warrant Officer,84003,1,1,0
2016,Warrant Officer,84020,3,3,0
2016,Warrant Officer,84058,3,3,0
2016,Warrant Officer,84065,4,4,0
2016,Warrant Officer,84084,7,7,0
2016,Warrant Officer,84116,3,3,0
2016,Warrant Officer,84321,1,1,0
2016,Warrant Officer,84405,1,1,0
2016,Warrant Officer,84790,1,1,0
2016,Warrant Officer,85008,7,7,0
2016,Warrant Officer,85132,1,1,0
2016,Warrant Officer,85653,8,8,0
2016,Warrant Officer,85713,2,2,0
2016,Warrant Officer,86015,1,1,0
2016,Warrant Officer,87144,2,2,0
2016,Warrant Officer,87401,1,1,0
2016,Warrant Officer,87508,3,3,0
2016,Warrant Officer,87557,1,1,0
2016,Warrant Officer,89032,2,2,0
2016,Warrant Officer,89165,1,1,0
2016,Warrant Officer,89506,2,2,0
2016,Warrant Officer,89701,3,3,0
2016,Warrant Officer,90720,7,7,0
2016,Warrant Officer,93727,1,1,0
2016,Warrant Officer,94533,1,1,0
2016,Warrant Officer,95206,4,4,0
2016,Warrant Officer,95655,4,4,0
2016,Warrant Officer,96857,6,6,0
2016,Warrant Officer,96913,1,1,0
2016,Warrant Officer,97015,3,3,0
2016,Warrant Officer,97211,1,1,0
2016,Warrant Officer,97302,3,3,0
2016,Warrant Officer,97309,1,1,0
2016,Warrant Officer,98108,1,1,0
2016,Warrant Officer,98119,1,1,0
2016,Warrant Officer,98321,1,1,0
2016,Warrant Officer,98430,4,4,0
2016,Warrant Officer,98433,9,9,0
2016,Warrant Officer,99505,7,7,0
2017,Enlisted,     ,3,3,0
2017,Enlisted,00604,6,3,3
2017,Enlisted,00612,9,3,6
2017,Enlisted,00623,3,0,3
2017,Enlisted,00624,9,1,8
2017,Enlisted,00641,10,1,9
2017,Enlisted,00681,5,0,5
2017,Enlisted,00682,25,4,21
2017,Enlisted,00683,1,1,0
2017,Enlisted,00693,12,1,11
2017,Enlisted,00705,12,1,11
2017,Enlisted,00714,9,0,9
2017,Enlisted,00725,14,2,12
2017,Enlisted,00735,150,150,0
2017,Enlisted,00736,34,3,31
2017,Enlisted,00737,3,0,3
2017,Enlisted,00751,40,2,38
2017,Enlisted,00769,14,1,13
2017,Enlisted,00785,5,0,5
2017,Enlisted,00792,11,3,8
2017,Enlisted,00795,103,8,95
2017,Enlisted,00802,9,1,8
2017,Enlisted,00850,22,2,20
2017,Enlisted,00901,8,2,6
2017,Enlisted,00907,6,0,6
2017,Enlisted,00934,71,9,62
2017,Enlisted,00951,2,0,2
2017,Enlisted,00963,1,0,1
2017,Enlisted,01013,14,6,8
2017,Enlisted,01030,18,1,17
2017,Enlisted,01062,3,0,3
2017,Enlisted,01082,37,3,34
2017,Enlisted,01085,20,3,17
2017,Enlisted,01109,28,2,26
2017,Enlisted,01201,7,0,7
2017,Enlisted,01301,7,2,5
2017,Enlisted,01434,38,8,30
2017,Enlisted,01440,5,0,5
2017,Enlisted,01453,11,0,11
2017,Enlisted,01588,18,2,16
2017,Enlisted,01605,45,6,39
2017,Enlisted,01702,12,2,10
2017,Enlisted,01731,8,1,7
2017,Enlisted,01760,23,6,17
2017,Enlisted,01844,23,2,21
2017,Enlisted,01867,76,8,68
2017,Enlisted,01923,20,4,16
2017,Enlisted,01950,1,0,1
2017,Enlisted,02043,16,1,15
2017,Enlisted,02122,27,6,21
2017,Enlisted,02138,34,7,27
2017,Enlisted,02169,1,0,1
2017,Enlisted,02176,21,4,17
2017,Enlisted,02184,28,4,24
2017,Enlisted,02301,50,7,43
2017,Enlisted,02324,5,2,3
2017,Enlisted,02346,16,3,13
2017,Enlisted,02420,12,1,11
2017,Enlisted,02465,4,0,4
2017,Enlisted,02532,21,3,18
2017,Enlisted,02542,91,14,77
2017,Enlisted,02724,23,2,21
2017,Enlisted,02769,8,2,6
2017,Enlisted,02780,23,2,21
2017,Enlisted,02809,2,2,0
2017,Enlisted,02816,1,1,0
2017,Enlisted,02818,106,24,82
2017,Enlisted,02842,8,6,2
2017,Enlisted,02852,24,9,15
2017,Enlisted,02885,21,1,20
2017,Enlisted,02886,12,3,9
2017,Enlisted,02896,4,0,4
2017,Enlisted,02904,17,1,16
2017,Enlisted,02920,4,3,1
2017,Enlisted,03055,28,7,21
2017,Enlisted,03060,7,0,7
2017,Enlisted,03101,21,4,17
2017,Enlisted,03235,4,0,4
2017,Enlisted,03244,17,0,17
2017,Enlisted,03264,6,0,6
2017,Enlisted,03301,44,6,38
2017,Enlisted,03561,7,0,7
2017,Enlisted,03766,11,1,10
2017,Enlisted,03801,4,2,2
2017,Enlisted,03878,1,1,0
2017,Enlisted,04011,28,5,23
2017,Enlisted,04073,1,0,1
2017,Enlisted,04092,9,2,7
2017,Enlisted,04240,13,1,12
2017,Enlisted,04268,12,1,11
2017,Enlisted,04330,11,0,11
2017,Enlisted,04333,3,2,1
2017,Enlisted,04401,36,8,28
2017,Enlisted,04412,29,6,23
2017,Enlisted,04619,3,2,1
2017,Enlisted,04730,5,0,5
2017,Enlisted,04736,5,3,2
2017,Enlisted,04901,33,5,28
2017,Enlisted,04915,4,2,2
2017,Enlisted,04976,11,3,8
2017,Enlisted,05001,8,2,6
2017,Enlisted,05033,9,0,9
2017,Enlisted,05158,13,0,13
2017,Enlisted,05201,7,0,7
2017,Enlisted,05403,9,1,8
2017,Enlisted,05404,13,1,12
2017,Enlisted,05446,18,8,10
2017,Enlisted,05450,10,2,8
2017,Enlisted,05465,48,10,38
2017,Enlisted,05478,5,1,4
2017,Enlisted,05488,4,2,2
2017,Enlisted,05491,6,0,6
2017,Enlisted,05495,8,1,7
2017,Enlisted,05602,6,0,6
2017,Enlisted,05661,5,1,4
2017,Enlisted,05663,12,3,9
2017,Enlisted,05676,8,1,7
2017,Enlisted,05701,12,4,8
2017,Enlisted,05851,18,3,15
2017,Enlisted,05855,4,0,4
2017,Enlisted,06051,26,5,21
2017,Enlisted,06066,3,0,3
2017,Enlisted,06082,26,5,21
2017,Enlisted,06096,35,3,32
2017,Enlisted,06110,22,9,13
2017,Enlisted,06320,25,5,20
2017,Enlisted,06333,2,2,0
2017,Enlisted,06340,28,10,18
2017,Enlisted,06357,18,7,11
2017,Enlisted,06360,12,2,10
2017,Enlisted,06457,72,15,57
2017,Enlisted,06489,13,1,12
2017,Enlisted,06498,21,1,20
2017,Enlisted,06512,33,7,26
2017,Enlisted,06614,23,4,19
2017,Enlisted,06702,5,1,4
2017,Enlisted,06810,39,10,29
2017,Enlisted,07052,40,10,30
2017,Enlisted,07090,33,5,28
2017,Enlisted,07095,30,6,24
2017,Enlisted,07107,13,4,9
2017,Enlisted,07306,37,9,28
2017,Enlisted,07457,22,7,15
2017,Enlisted,07666,70,11,59
2017,Enlisted,07728,26,10,16
2017,Enlisted,07801,30,3,27
2017,Enlisted,07840,9,2,7
2017,Enlisted,07865,24,2,22
2017,Enlisted,07960,45,10,35
2017,Enlisted,08002,35,5,30
2017,Enlisted,08012,20,9,11
2017,Enlisted,08037,8,1,7
2017,Enlisted,08060,14,3,11
2017,Enlisted,08096,44,14,30
2017,Enlisted,08098,6,3,3
2017,Enlisted,08210,18,3,15
2017,Enlisted,08360,21,6,15
2017,Enlisted,08401,8,1,7
2017,Enlisted,08640,2,2,0
2017,Enlisted,08648,15,6,9
2017,Enlisted,08733,61,13,48
2017,Enlisted,08750,21,3,18
2017,Enlisted,08753,7,2,5
2017,Enlisted,08759,14,4,10
2017,Enlisted,08822,6,4,2
2017,Enlisted,08873,32,7,25
2017,Enlisted,09096,5,0,5
2017,Enlisted,10010,77,18,59
2017,Enlisted,10021,3,0,3
2017,Enlisted,10314,47,6,41
2017,Enlisted,10468,18,2,16
2017,Enlisted,10566,15,4,11
2017,Enlisted,10567,92,14,78
2017,Enlisted,10701,45,5,40
2017,Enlisted,10962,21,2,19
2017,Enlisted,11252,91,13,78
2017,Enlisted,11357,13,5,8
2017,Enlisted,11433,50,8,42
2017,Enlisted,11735,80,9,71
2017,Enlisted,11779,28,7,21
2017,Enlisted,12078,27,5,22
2017,Enlisted,12110,41,17,24
2017,Enlisted,12180,21,4,17
2017,Enlisted,12189,10,8,2
2017,Enlisted,12302,41,10,31
2017,Enlisted,12401,9,0,9
2017,Enlisted,12451,13,4,9
2017,Enlisted,12553,23,7,16
2017,Enlisted,12804,17,2,15
2017,Enlisted,12962,8,3,5
2017,Enlisted,12983,1,1,0
2017,Enlisted,13021,16,2,14
2017,Enlisted,13211,57,19,38
2017,Enlisted,13501,38,11,27
2017,Enlisted,13602,11,5,6
2017,Enlisted,13669,9,3,6
2017,Enlisted,13856,5,0,5
2017,Enlisted,13905,38,5,33
2017,Enlisted,14048,6,1,5
2017,Enlisted,14094,7,0,7
2017,Enlisted,14204,48,5,43
2017,Enlisted,14213,38,7,31
2017,Enlisted,14304,15,2,13
2017,Enlisted,14454,27,7,20
2017,Enlisted,14456,15,2,13
2017,Enlisted,14624,65,12,53
2017,Enlisted,14701,5,1,4
2017,Enlisted,14760,3,0,3
2017,Enlisted,14843,6,0,6
2017,Enlisted,14845,8,0,8
2017,Enlisted,14850,9,0,9
2017,Enlisted,15010,23,4,19
2017,Enlisted,15216,42,5,37
2017,Enlisted,15301,20,2,18
2017,Enlisted,15370,10,2,8
2017,Enlisted,15425,11,4,7
2017,Enlisted,15444,2,0,2
2017,Enlisted,15537,7,1,6
2017,Enlisted,15541,5,0,5
2017,Enlisted,15601,11,3,8
2017,Enlisted,15666,22,3,19
2017,Enlisted,15701,22,2,20
2017,Enlisted,15767,11,2,9
2017,Enlisted,15779,3,0,3
2017,Enlisted,15902,16,2,14
2017,Enlisted,15904,81,7,74
2017,Enlisted,16001,19,5,14
2017,Enlisted,16101,15,0,15
2017,Enlisted,16127,6,1,5
2017,Enlisted,16148,12,1,11
2017,Enlisted,16226,14,2,12
2017,Enlisted,16301,9,0,9
2017,Enlisted,16403,63,5,58
2017,Enlisted,16635,16,2,14
2017,Enlisted,16652,3,0,3
2017,Enlisted,16735,1,0,1
2017,Enlisted,16738,5,0,5
2017,Enlisted,16803,16,1,15
2017,Enlisted,16830,15,1,14
2017,Enlisted,16901,4,0,4
2017,Enlisted,17003,224,26,198
2017,Enlisted,17013,18,4,14
2017,Enlisted,17022,26,2,24
2017,Enlisted,17042,19,1,18
2017,Enlisted,17044,19,1,18
2017,Enlisted,17098,1,0,1
2017,Enlisted,17103,32,8,24
2017,Enlisted,17201,13,1,12
2017,Enlisted,17222,3,1,2
2017,Enlisted,17325,4,2,2
2017,Enlisted,17331,8,1,7
2017,Enlisted,17404,1,1,0
2017,Enlisted,17701,11,1,10
2017,Enlisted,17745,6,0,6
2017,Enlisted,17821,12,3,9
2017,Enlisted,17837,10,4,6
2017,Enlisted,18040,11,2,9
2017,Enlisted,18102,19,1,18
2017,Enlisted,18201,10,1,9
2017,Enlisted,18235,9,3,6
2017,Enlisted,18252,8,0,8
2017,Enlisted,18301,10,0,10
2017,Enlisted,18407,1,0,1
2017,Enlisted,18431,7,1,6
2017,Enlisted,18466,2,1,1
2017,Enlisted,18509,45,4,41
2017,Enlisted,18634,2,0,2
2017,Enlisted,18651,1,0,1
2017,Enlisted,18704,15,2,13
2017,Enlisted,18834,4,3,1
2017,Enlisted,18960,5,1,4
2017,Enlisted,19044,90,10,80
2017,Enlisted,19090,1,0,1
2017,Enlisted,19103,16,1,15
2017,Enlisted,19104,1,0,1
2017,Enlisted,19153,21,3,18
2017,Enlisted,19154,145,20,125
2017,Enlisted,19320,17,3,14
2017,Enlisted,19460,13,0,13
2017,Enlisted,19462,24,5,19
2017,Enlisted,19475,14,2,12
2017,Enlisted,19526,6,1,5
2017,Enlisted,19530,20,2,18
2017,Enlisted,19605,16,1,15
2017,Enlisted,19706,25,3,22
2017,Enlisted,19711,13,1,12
2017,Enlisted,19720,28,3,25
2017,Enlisted,19804,21,1,20
2017,Enlisted,19808,5,1,4
2017,Enlisted,19939,13,2,11
2017,Enlisted,19947,16,0,16
2017,Enlisted,19973,25,2,23
2017,Enlisted,19977,12,3,9
2017,Enlisted,20003,38,20,18
2017,Enlisted,20112,28,8,20
2017,Enlisted,20175,20,5,15
2017,Enlisted,20186,7,4,3
2017,Enlisted,20373,26,9,17
2017,Enlisted,20623,1,0,1
2017,Enlisted,20646,12,7,5
2017,Enlisted,20653,2,0,2
2017,Enlisted,20708,52,29,23
2017,Enlisted,20783,1,1,0
2017,Enlisted,20882,5,4,1
2017,Enlisted,20904,23,8,15
2017,Enlisted,21010,56,16,40
2017,Enlisted,21043,13,2,11
2017,Enlisted,21057,14,5,9
2017,Enlisted,21061,17,7,10
2017,Enlisted,21078,11,3,8
2017,Enlisted,21136,42,10,32
2017,Enlisted,21201,3,2,1
2017,Enlisted,21204,13,6,7
2017,Enlisted,21216,18,3,15
2017,Enlisted,21222,25,7,18
2017,Enlisted,21228,18,3,15
2017,Enlisted,21236,17,2,15
2017,Enlisted,21401,12,5,7
2017,Enlisted,21502,1,0,1
2017,Enlisted,21601,6,3,3
2017,Enlisted,21701,17,11,6
2017,Enlisted,21719,7,4,3
2017,Enlisted,21740,7,3,4
2017,Enlisted,21801,20,1,19
2017,Enlisted,21921,2,1,1
2017,Enlisted,22032,14,9,5
2017,Enlisted,22060,22,10,12
2017,Enlisted,22401,52,14,38
2017,Enlisted,22427,16,5,11
2017,Enlisted,22601,21,3,18
2017,Enlisted,22664,20,7,13
2017,Enlisted,22731,12,1,11
2017,Enlisted,22801,14,1,13
2017,Enlisted,22902,23,8,15
2017,Enlisted,23069,10,4,6
2017,Enlisted,23139,7,2,5
2017,Enlisted,23150,52,15,37
2017,Enlisted,23181,16,0,16
2017,Enlisted,23237,9,1,8
2017,Enlisted,23417,16,4,12
2017,Enlisted,23434,26,6,20
2017,Enlisted,23451,48,15,33
2017,Enlisted,23502,37,8,29
2017,Enlisted,23666,33,7,26
2017,Enlisted,23701,15,3,12
2017,Enlisted,23805,21,4,17
2017,Enlisted,23824,31,8,23
2017,Enlisted,23847,1,0,1
2017,Enlisted,23851,5,2,3
2017,Enlisted,23901,2,1,1
2017,Enlisted,24073,9,3,6
2017,Enlisted,24112,13,1,12
2017,Enlisted,24151,24,1,23
2017,Enlisted,24210,5,0,5
2017,Enlisted,24251,11,0,11
2017,Enlisted,24301,13,2,11
2017,Enlisted,24401,1,0,1
2017,Enlisted,24450,2,0,2
2017,Enlisted,24502,21,0,21
2017,Enlisted,24523,10,2,8
2017,Enlisted,24541,5,1,4
2017,Enlisted,24592,6,0,6
2017,Enlisted,24609,9,2,7
2017,Enlisted,24701,14,3,11
2017,Enlisted,24957,5,2,3
2017,Enlisted,25064,1,0,1
2017,Enlisted,25168,41,6,35
2017,Enlisted,25262,9,1,8
2017,Enlisted,25309,4,0,4
2017,Enlisted,25311,3,3,0
2017,Enlisted,25401,14,4,10
2017,Enlisted,25405,12,1,11
2017,Enlisted,25530,36,18,18
2017,Enlisted,25550,22,10,12
2017,Enlisted,25625,14,2,12
2017,Enlisted,25846,57,12,45
2017,Enlisted,26003,7,1,6
2017,Enlisted,26041,36,2,34
2017,Enlisted,26101,26,8,18
2017,Enlisted,26187,16,6,10
2017,Enlisted,26201,7,2,5
2017,Enlisted,26250,14,6,8
2017,Enlisted,26301,7,1,6
2017,Enlisted,26426,12,0,12
2017,Enlisted,26505,16,0,16
2017,Enlisted,26537,28,14,14
2017,Enlisted,26554,19,1,18
2017,Enlisted,26624,3,0,3
2017,Enlisted,26651,12,2,10
2017,Enlisted,26836,3,1,2
2017,Enlisted,27028,13,4,9
2017,Enlisted,27030,4,1,3
2017,Enlisted,27103,41,12,29
2017,Enlisted,27204,4,1,3
2017,Enlisted,27217,47,14,33
2017,Enlisted,27260,34,9,25
2017,Enlisted,27292,6,0,6
2017,Enlisted,27320,10,3,7
2017,Enlisted,27344,9,4,5
2017,Enlisted,27360,3,1,2
2017,Enlisted,27401,27,8,19
2017,Enlisted,27504,20,4,16
2017,Enlisted,27509,6,0,6
2017,Enlisted,27530,23,6,17
2017,Enlisted,27549,7,1,6
2017,Enlisted,27557,2,1,1
2017,Enlisted,27560,87,23,64
2017,Enlisted,27573,2,0,2
2017,Enlisted,27577,18,3,15
2017,Enlisted,27581,6,2,4
2017,Enlisted,27596,3,0,3
2017,Enlisted,27607,8,6,2
2017,Enlisted,27704,31,12,19
2017,Enlisted,27828,8,0,8
2017,Enlisted,27830,3,2,1
2017,Enlisted,27856,7,4,3
2017,Enlisted,27870,8,8,0
2017,Enlisted,27874,4,1,3
2017,Enlisted,27889,4,4,0
2017,Enlisted,27892,19,4,15
2017,Enlisted,27897,8,2,6
2017,Enlisted,27909,3,1,2
2017,Enlisted,27932,8,1,7
2017,Enlisted,28001,3,3,0
2017,Enlisted,28012,27,8,19
2017,Enlisted,28027,26,6,20
2017,Enlisted,28043,7,0,7
2017,Enlisted,28054,22,6,16
2017,Enlisted,28086,5,2,3
2017,Enlisted,28092,14,3,11
2017,Enlisted,28093,3,0,3
2017,Enlisted,28110,18,5,13
2017,Enlisted,28115,9,3,6
2017,Enlisted,28147,23,5,18
2017,Enlisted,28170,19,6,13
2017,Enlisted,28208,37,8,29
2017,Enlisted,28306,48,18,30
2017,Enlisted,28310,48,17,31
2017,Enlisted,28328,9,5,4
2017,Enlisted,28334,12,6,6
2017,Enlisted,28337,8,1,7
2017,Enlisted,28345,14,3,11
2017,Enlisted,28352,14,2,12
2017,Enlisted,28359,30,10,20
2017,Enlisted,28371,5,0,5
2017,Enlisted,28376,17,8,9
2017,Enlisted,28377,9,1,8
2017,Enlisted,28379,7,2,5
2017,Enlisted,28382,7,1,6
2017,Enlisted,28384,6,0,6
2017,Enlisted,28387,1,0,1
2017,Enlisted,28388,8,2,6
2017,Enlisted,28401,12,3,9
2017,Enlisted,28405,15,2,13
2017,Enlisted,28470,2,0,2
2017,Enlisted,28472,14,4,10
2017,Enlisted,28504,18,4,14
2017,Enlisted,28518,8,3,5
2017,Enlisted,28540,13,5,8
2017,Enlisted,28560,24,5,19
2017,Enlisted,28577,10,3,7
2017,Enlisted,28580,6,0,6
2017,Enlisted,28590,11,2,9
2017,Enlisted,28601,11,6,5
2017,Enlisted,28607,4,1,3
2017,Enlisted,28640,13,0,13
2017,Enlisted,28645,22,3,19
2017,Enlisted,28655,5,0,5
2017,Enlisted,28658,11,3,8
2017,Enlisted,28659,7,2,5
2017,Enlisted,28677,6,0,6
2017,Enlisted,28681,8,3,5
2017,Enlisted,28721,31,3,28
2017,Enlisted,28726,18,5,13
2017,Enlisted,28734,6,2,4
2017,Enlisted,28752,9,1,8
2017,Enlisted,28779,2,1,1
2017,Enlisted,28806,16,4,12
2017,Enlisted,28906,1,0,1
2017,Enlisted,29006,6,2,4
2017,Enlisted,29020,15,5,10
2017,Enlisted,29044,116,30,86
2017,Enlisted,29102,9,0,9
2017,Enlisted,29108,19,4,15
2017,Enlisted,29115,14,2,12
2017,Enlisted,29138,26,4,22
2017,Enlisted,29151,13,3,10
2017,Enlisted,29161,11,2,9
2017,Enlisted,29170,42,5,37
2017,Enlisted,29201,2,1,1
2017,Enlisted,29303,9,3,6
2017,Enlisted,29325,6,2,4
2017,Enlisted,29341,26,4,22
2017,Enlisted,29360,17,2,15
2017,Enlisted,29379,29,7,22
2017,Enlisted,29385,24,8,16
2017,Enlisted,29403,23,3,20
2017,Enlisted,29409,13,2,11
2017,Enlisted,29418,80,10,70
2017,Enlisted,29440,9,0,9
2017,Enlisted,29461,23,3,20
2017,Enlisted,29464,21,6,15
2017,Enlisted,29465,8,0,8
2017,Enlisted,29488,16,1,15
2017,Enlisted,29506,9,0,9
2017,Enlisted,29510,4,0,4
2017,Enlisted,29512,29,6,23
2017,Enlisted,29526,9,2,7
2017,Enlisted,29532,11,2,9
2017,Enlisted,29536,4,1,3
2017,Enlisted,29544,8,0,8
2017,Enlisted,29550,26,1,25
2017,Enlisted,29556,23,1,22
2017,Enlisted,29571,14,4,10
2017,Enlisted,29574,29,5,24
2017,Enlisted,29577,8,0,8
2017,Enlisted,29605,56,7,49
2017,Enlisted,29620,16,5,11
2017,Enlisted,29625,29,5,24
2017,Enlisted,29631,18,4,14
2017,Enlisted,29641,9,1,8
2017,Enlisted,29644,23,4,19
2017,Enlisted,29646,8,1,7
2017,Enlisted,29651,14,4,10
2017,Enlisted,29653,13,3,10
2017,Enlisted,29678,8,1,7
2017,Enlisted,29706,16,6,10
2017,Enlisted,29715,12,2,10
2017,Enlisted,29720,9,4,5
2017,Enlisted,29732,24,2,22
2017,Enlisted,29810,5,0,5
2017,Enlisted,29812,7,1,6
2017,Enlisted,29824,18,4,14
2017,Enlisted,29829,37,10,27
2017,Enlisted,29835,3,0,3
2017,Enlisted,29906,4,2,2
2017,Enlisted,29944,6,3,3
2017,Enlisted,30014,13,2,11
2017,Enlisted,30032,11,6,5
2017,Enlisted,30040,98,40,58
2017,Enlisted,30046,28,7,21
2017,Enlisted,30060,214,129,85
2017,Enlisted,30069,93,26,67
2017,Enlisted,30114,25,4,21
2017,Enlisted,30125,14,4,10
2017,Enlisted,30134,20,4,16
2017,Enlisted,30144,56,13,43
2017,Enlisted,30161,31,11,20
2017,Enlisted,30224,19,14,5
2017,Enlisted,30233,16,6,10
2017,Enlisted,30240,34,13,21
2017,Enlisted,30263,21,10,11
2017,Enlisted,30294,63,26,37
2017,Enlisted,30297,86,34,52
2017,Enlisted,30336,108,30,78
2017,Enlisted,30401,21,7,14
2017,Enlisted,30427,29,11,18
2017,Enlisted,30439,14,4,10
2017,Enlisted,30461,4,3,1
2017,Enlisted,30501,21,12,9
2017,Enlisted,30577,14,5,9
2017,Enlisted,30635,7,1,6
2017,Enlisted,30643,9,6,3
2017,Enlisted,30655,36,20,16
2017,Enlisted,30673,19,9,10
2017,Enlisted,30680,72,23,49
2017,Enlisted,30701,25,5,20
2017,Enlisted,30720,15,5,10
2017,Enlisted,30824,7,0,7
2017,Enlisted,30830,12,2,10
2017,Enlisted,30904,47,15,32
2017,Enlisted,30905,22,11,11
2017,Enlisted,30909,4,3,1
2017,Enlisted,31015,31,13,18
2017,Enlisted,31029,43,9,34
2017,Enlisted,31040,19,10,9
2017,Enlisted,31061,53,6,47
2017,Enlisted,31211,71,21,50
2017,Enlisted,31313,9,7,2
2017,Enlisted,31314,53,35,18
2017,Enlisted,31329,5,1,4
2017,Enlisted,31406,63,27,36
2017,Enlisted,31409,38,25,13
2017,Enlisted,31520,11,5,6
2017,Enlisted,31533,17,3,14
2017,Enlisted,31601,11,5,6
2017,Enlisted,31701,8,4,4
2017,Enlisted,31792,35,13,22
2017,Enlisted,31794,11,4,7
2017,Enlisted,31901,24,4,20
2017,Enlisted,31905,16,10,6
2017,Enlisted,32055,9,3,6
2017,Enlisted,32064,13,4,9
2017,Enlisted,32084,13,6,7
2017,Enlisted,32085,1,1,0
2017,Enlisted,32086,2,2,0
2017,Enlisted,32091,104,41,63
2017,Enlisted,32164,23,3,20
2017,Enlisted,32177,3,1,2
2017,Enlisted,32221,63,34,29
2017,Enlisted,32311,24,7,17
2017,Enlisted,32351,12,1,11
2017,Enlisted,32406,17,7,10
2017,Enlisted,32425,3,3,0
2017,Enlisted,32428,6,3,3
2017,Enlisted,32447,20,3,17
2017,Enlisted,32514,26,12,14
2017,Enlisted,32536,11,4,7
2017,Enlisted,32724,16,5,11
2017,Enlisted,32727,16,8,8
2017,Enlisted,32771,21,6,15
2017,Enlisted,32806,13,6,7
2017,Enlisted,32827,16,7,9
2017,Enlisted,32856,28,13,15
2017,Enlisted,32924,8,6,2
2017,Enlisted,32935,23,6,17
2017,Enlisted,33020,17,9,8
2017,Enlisted,33024,6,1,5
2017,Enlisted,33025,25,6,19
2017,Enlisted,33039,7,3,4
2017,Enlisted,33127,40,15,25
2017,Enlisted,33315,25,7,18
2017,Enlisted,33405,9,2,7
2017,Enlisted,33406,34,12,22
2017,Enlisted,33523,18,8,10
2017,Enlisted,33563,11,4,7
2017,Enlisted,33567,3,2,1
2017,Enlisted,33606,11,4,7
2017,Enlisted,33711,8,5,3
2017,Enlisted,33782,79,34,45
2017,Enlisted,33811,10,4,6
2017,Enlisted,33825,6,1,5
2017,Enlisted,33830,7,4,3
2017,Enlisted,33844,23,2,21
2017,Enlisted,33859,15,3,12
2017,Enlisted,33873,3,3,0
2017,Enlisted,33880,16,4,12
2017,Enlisted,33916,5,0,5
2017,Enlisted,34208,7,1,6
2017,Enlisted,34221,6,3,3
2017,Enlisted,34237,7,3,4
2017,Enlisted,34266,18,9,9
2017,Enlisted,34429,1,1,0
2017,Enlisted,34471,4,1,3
2017,Enlisted,34474,27,11,16
2017,Enlisted,34604,4,3,1
2017,Enlisted,34748,29,15,14
2017,Enlisted,34947,28,4,24
2017,Enlisted,35010,32,13,19
2017,Enlisted,35016,9,2,7
2017,Enlisted,35042,44,9,35
2017,Enlisted,35055,28,9,19
2017,Enlisted,35072,11,0,11
2017,Enlisted,35121,30,4,26
2017,Enlisted,35124,35,8,27
2017,Enlisted,35146,1,1,0
2017,Enlisted,35150,26,4,22
2017,Enlisted,35161,19,6,13
2017,Enlisted,35178,6,2,4
2017,Enlisted,35209,14,8,6
2017,Enlisted,35217,49,23,26
2017,Enlisted,35259,5,3,2
2017,Enlisted,35405,11,3,8
2017,Enlisted,35476,12,4,8
2017,Enlisted,35501,10,4,6
2017,Enlisted,35555,5,2,3
2017,Enlisted,35565,19,2,17
2017,Enlisted,35594,20,2,18
2017,Enlisted,35601,23,5,18
2017,Enlisted,35613,5,3,2
2017,Enlisted,35630,14,3,11
2017,Enlisted,35710,1,1,0
2017,Enlisted,35803,32,8,24
2017,Enlisted,35805,29,6,23
2017,Enlisted,35904,19,7,12
2017,Enlisted,35967,10,5,5
2017,Enlisted,36009,1,0,1
2017,Enlisted,36010,4,1,3
2017,Enlisted,36016,12,1,11
2017,Enlisted,36027,4,1,3
2017,Enlisted,36032,22,3,19
2017,Enlisted,36043,41,10,31
2017,Enlisted,36067,9,4,5
2017,Enlisted,36078,13,6,7
2017,Enlisted,36081,15,4,11
2017,Enlisted,36083,3,0,3
2017,Enlisted,36109,9,3,6
2017,Enlisted,36117,1,0,1
2017,Enlisted,36121,7,1,6
2017,Enlisted,36203,40,8,32
2017,Enlisted,36205,17,5,12
2017,Enlisted,36250,16,9,7
2017,Enlisted,36251,22,1,21
2017,Enlisted,36265,49,15,34
2017,Enlisted,36302,18,6,12
2017,Enlisted,36322,8,7,1
2017,Enlisted,36323,8,1,7
2017,Enlisted,36330,27,2,25
2017,Enlisted,36344,16,3,13
2017,Enlisted,36421,9,2,7
2017,Enlisted,36426,7,2,5
2017,Enlisted,36442,6,1,5
2017,Enlisted,36502,13,0,13
2017,Enlisted,36522,35,15,20
2017,Enlisted,36532,19,3,16
2017,Enlisted,36535,33,8,25
2017,Enlisted,36605,59,18,41
2017,Enlisted,36608,7,3,4
2017,Enlisted,36701,1,0,1
2017,Enlisted,36726,9,0,9
2017,Enlisted,36732,11,4,7
2017,Enlisted,36801,8,6,2
2017,Enlisted,36832,23,12,11
2017,Enlisted,36854,35,5,30
2017,Enlisted,36867,8,3,5
2017,Enlisted,37015,6,3,3
2017,Enlisted,37033,6,4,2
2017,Enlisted,37042,8,4,4
2017,Enlisted,37056,19,5,14
2017,Enlisted,37066,11,3,8
2017,Enlisted,37083,5,3,2
2017,Enlisted,37090,7,1,6
2017,Enlisted,37091,5,0,5
2017,Enlisted,37097,1,0,1
2017,Enlisted,37110,26,10,16
2017,Enlisted,37129,29,12,17
2017,Enlisted,37160,2,1,1
2017,Enlisted,37167,66,28,38
2017,Enlisted,37172,14,7,7
2017,Enlisted,37178,15,6,9
2017,Enlisted,37185,4,1,3
2017,Enlisted,37204,72,25,47
2017,Enlisted,37217,20,11,9
2017,Enlisted,37303,9,3,6
2017,Enlisted,37321,6,1,5
2017,Enlisted,37323,8,2,6
2017,Enlisted,37327,16,3,13
2017,Enlisted,37334,1,0,1
2017,Enlisted,37356,6,2,4
2017,Enlisted,37388,17,10,7
2017,Enlisted,37398,11,4,7
2017,Enlisted,37404,33,11,22
2017,Enlisted,37615,15,5,10
2017,Enlisted,37620,12,6,6
2017,Enlisted,37644,6,1,5
2017,Enlisted,37645,14,4,10
2017,Enlisted,37650,1,1,0
2017,Enlisted,37683,1,1,0
2017,Enlisted,37717,6,3,3
2017,Enlisted,37743,13,1,12
2017,Enlisted,37757,6,3,3
2017,Enlisted,37760,5,1,4
2017,Enlisted,37771,11,4,7
2017,Enlisted,37777,45,17,28
2017,Enlisted,37801,3,2,1
2017,Enlisted,37821,9,4,5
2017,Enlisted,37825,6,4,2
2017,Enlisted,37841,11,1,10
2017,Enlisted,37854,4,2,2
2017,Enlisted,37857,2,1,1
2017,Enlisted,37860,8,3,5
2017,Enlisted,37863,6,2,4
2017,Enlisted,37874,18,7,11
2017,Enlisted,37919,9,7,2
2017,Enlisted,37939,2,1,1
2017,Enlisted,38001,8,5,3
2017,Enlisted,38008,13,5,8
2017,Enlisted,38012,7,2,5
2017,Enlisted,38019,18,8,10
2017,Enlisted,38024,4,1,3
2017,Enlisted,38053,25,10,15
2017,Enlisted,38063,5,2,3
2017,Enlisted,38079,5,3,2
2017,Enlisted,38118,38,10,28
2017,Enlisted,38201,9,3,6
2017,Enlisted,38225,7,2,5
2017,Enlisted,38242,15,9,6
2017,Enlisted,38261,15,7,8
2017,Enlisted,38301,14,5,9
2017,Enlisted,38302,9,3,6
2017,Enlisted,38320,8,5,3
2017,Enlisted,38340,9,1,8
2017,Enlisted,38343,11,2,9
2017,Enlisted,38344,20,5,15
2017,Enlisted,38348,1,1,0
2017,Enlisted,38351,5,2,3
2017,Enlisted,38358,13,3,10
2017,Enlisted,38363,5,1,4
2017,Enlisted,38372,3,0,3
2017,Enlisted,38375,9,3,6
2017,Enlisted,38382,16,7,9
2017,Enlisted,38401,23,12,11
2017,Enlisted,38462,4,3,1
2017,Enlisted,38464,1,0,1
2017,Enlisted,38478,1,0,1
2017,Enlisted,38485,3,1,2
2017,Enlisted,38506,10,5,5
2017,Enlisted,38556,16,3,13
2017,Enlisted,38563,4,1,3
2017,Enlisted,38570,9,3,6
2017,Enlisted,38572,4,0,4
2017,Enlisted,38583,5,1,4
2017,Enlisted,38606,24,4,20
2017,Enlisted,38614,15,3,12
2017,Enlisted,38635,3,3,0
2017,Enlisted,38663,13,0,13
2017,Enlisted,38668,9,2,7
2017,Enlisted,38671,27,6,21
2017,Enlisted,38701,11,0,11
2017,Enlisted,38732,1,1,0
2017,Enlisted,38751,11,0,11
2017,Enlisted,38801,35,5,30
2017,Enlisted,38803,6,1,5
2017,Enlisted,38821,11,0,11
2017,Enlisted,38829,17,3,14
2017,Enlisted,38834,30,3,27
2017,Enlisted,38843,8,1,7
2017,Enlisted,38851,11,0,11
2017,Enlisted,38852,6,0,6
2017,Enlisted,38860,8,0,8
2017,Enlisted,38863,16,0,16
2017,Enlisted,38901,16,5,11
2017,Enlisted,38915,11,1,10
2017,Enlisted,38916,14,0,14
2017,Enlisted,38921,1,0,1
2017,Enlisted,38926,2,0,2
2017,Enlisted,38930,5,1,4
2017,Enlisted,38965,6,0,6
2017,Enlisted,38967,5,0,5
2017,Enlisted,39043,21,4,17
2017,Enlisted,39046,42,4,38
2017,Enlisted,39051,23,0,23
2017,Enlisted,39059,16,4,12
2017,Enlisted,39060,11,0,11
2017,Enlisted,39074,3,0,3
2017,Enlisted,39090,1,0,1
2017,Enlisted,39111,2,1,1
2017,Enlisted,39117,5,2,3
2017,Enlisted,39120,7,1,6
2017,Enlisted,39159,1,0,1
2017,Enlisted,39168,12,2,10
2017,Enlisted,39183,22,2,20
2017,Enlisted,39194,8,1,7
2017,Enlisted,39204,41,5,36
2017,Enlisted,39209,25,7,18
2017,Enlisted,39216,20,6,14
2017,Enlisted,39296,4,3,1
2017,Enlisted,39307,26,6,20
2017,Enlisted,39328,4,0,4
2017,Enlisted,39339,19,0,19
2017,Enlisted,39345,23,2,21
2017,Enlisted,39350,17,2,15
2017,Enlisted,39355,1,0,1
2017,Enlisted,39367,15,3,12
2017,Enlisted,39403,2,1,1
2017,Enlisted,39407,69,12,57
2017,Enlisted,39422,8,2,6
2017,Enlisted,39429,11,0,11
2017,Enlisted,39440,3,0,3
2017,Enlisted,39452,10,0,10
2017,Enlisted,39455,4,0,4
2017,Enlisted,39466,9,0,9
2017,Enlisted,39470,12,1,11
2017,Enlisted,39476,7,1,6
2017,Enlisted,39501,9,1,8
2017,Enlisted,39505,14,5,9
2017,Enlisted,39507,11,2,9
2017,Enlisted,39532,15,4,11
2017,Enlisted,39556,13,5,8
2017,Enlisted,39567,13,2,11
2017,Enlisted,39577,8,0,8
2017,Enlisted,39601,4,0,4
2017,Enlisted,39638,1,0,1
2017,Enlisted,39648,1,0,1
2017,Enlisted,39654,5,0,5
2017,Enlisted,39667,8,1,7
2017,Enlisted,39704,19,5,14
2017,Enlisted,39730,6,1,5
2017,Enlisted,39735,8,1,7
2017,Enlisted,39744,3,0,3
2017,Enlisted,39760,26,2,24
2017,Enlisted,39773,6,0,6
2017,Enlisted,40004,24,2,22
2017,Enlisted,40065,5,0,5
2017,Enlisted,40069,5,0,5
2017,Enlisted,40108,10,0,10
2017,Enlisted,40121,4,0,4
2017,Enlisted,40205,33,9,24
2017,Enlisted,40218,60,6,54
2017,Enlisted,40311,11,1,10
2017,Enlisted,40330,16,3,13
2017,Enlisted,40351,28,1,27
2017,Enlisted,40422,13,0,13
2017,Enlisted,40472,30,4,26
2017,Enlisted,40475,131,21,110
2017,Enlisted,40510,34,7,27
2017,Enlisted,40601,65,19,46
2017,Enlisted,40741,3,1,2
2017,Enlisted,40769,7,1,6
2017,Enlisted,40831,8,0,8
2017,Enlisted,40906,18,6,12
2017,Enlisted,40965,14,2,12
2017,Enlisted,41005,55,5,50
2017,Enlisted,41008,9,0,9
2017,Enlisted,41031,10,1,9
2017,Enlisted,41056,4,0,4
2017,Enlisted,41094,26,2,24
2017,Enlisted,41101,16,2,14
2017,Enlisted,41164,15,3,12
2017,Enlisted,41339,9,1,8
2017,Enlisted,41653,13,0,13
2017,Enlisted,41701,8,0,8
2017,Enlisted,42025,13,3,10
2017,Enlisted,42064,6,0,6
2017,Enlisted,42071,21,4,17
2017,Enlisted,42086,15,3,12
2017,Enlisted,42101,21,2,19
2017,Enlisted,42104,21,4,17
2017,Enlisted,42141,20,3,17
2017,Enlisted,42167,14,0,14
2017,Enlisted,42240,6,1,5
2017,Enlisted,42276,8,0,8
2017,Enlisted,42301,23,4,19
2017,Enlisted,42330,7,1,6
2017,Enlisted,42345,30,12,18
2017,Enlisted,42431,29,8,21
2017,Enlisted,42501,31,5,26
2017,Enlisted,42633,11,0,11
2017,Enlisted,42701,10,2,8
2017,Enlisted,42718,16,2,14
2017,Enlisted,42754,16,2,14
2017,Enlisted,43015,42,4,38
2017,Enlisted,43040,46,9,37
2017,Enlisted,43055,31,2,29
2017,Enlisted,43102,20,0,20
2017,Enlisted,43213,87,18,69
2017,Enlisted,43217,75,14,61
2017,Enlisted,43235,9,5,4
2017,Enlisted,43402,17,2,15
2017,Enlisted,43465,76,5,71
2017,Enlisted,43614,14,1,13
2017,Enlisted,43756,48,0,48
2017,Enlisted,43812,18,3,15
2017,Enlisted,44023,32,1,31
2017,Enlisted,44055,13,0,13
2017,Enlisted,44128,45,3,42
2017,Enlisted,44142,19,1,18
2017,Enlisted,44224,58,3,55
2017,Enlisted,44256,23,3,20
2017,Enlisted,44313,14,3,11
2017,Enlisted,44444,58,6,52
2017,Enlisted,44515,68,4,64
2017,Enlisted,44601,7,4,3
2017,Enlisted,44622,6,0,6
2017,Enlisted,44720,103,9,94
2017,Enlisted,44857,45,2,43
2017,Enlisted,44870,15,7,8
2017,Enlisted,44883,47,7,40
2017,Enlisted,44903,40,3,37
2017,Enlisted,45015,48,4,44
2017,Enlisted,45036,24,4,20
2017,Enlisted,45044,26,1,25
2017,Enlisted,45215,111,5,106
2017,Enlisted,45331,24,2,22
2017,Enlisted,45346,1,0,1
2017,Enlisted,45356,52,7,45
2017,Enlisted,45385,12,2,10
2017,Enlisted,45430,33,4,29
2017,Enlisted,45502,26,2,24
2017,Enlisted,45505,18,0,18
2017,Enlisted,45601,31,1,30
2017,Enlisted,45662,30,4,26
2017,Enlisted,45804,27,2,25
2017,Enlisted,45885,14,1,13
2017,Enlisted,46012,10,2,8
2017,Enlisted,46036,6,0,6
2017,Enlisted,46041,14,2,12
2017,Enlisted,46052,12,2,10
2017,Enlisted,46122,22,3,19
2017,Enlisted,46124,54,13,41
2017,Enlisted,46131,88,12,76
2017,Enlisted,46135,5,0,5
2017,Enlisted,46140,43,9,34
2017,Enlisted,46151,19,4,15
2017,Enlisted,46176,46,10,36
2017,Enlisted,46208,13,1,12
2017,Enlisted,46216,63,15,48
2017,Enlisted,46241,222,42,180
2017,Enlisted,46323,11,1,10
2017,Enlisted,46350,18,0,18
2017,Enlisted,46360,3,0,3
2017,Enlisted,46383,27,2,25
2017,Enlisted,46402,12,1,11
2017,Enlisted,46406,40,7,33
2017,Enlisted,46517,5,0,5
2017,Enlisted,46563,31,4,27
2017,Enlisted,46580,12,4,8
2017,Enlisted,46613,40,3,37
2017,Enlisted,46703,19,3,16
2017,Enlisted,46714,15,3,12
2017,Enlisted,46750,16,2,14
2017,Enlisted,46825,41,8,33
2017,Enlisted,46901,10,1,9
2017,Enlisted,46947,28,3,25
2017,Enlisted,46953,8,0,8
2017,Enlisted,46970,10,1,9
2017,Enlisted,47150,9,0,9
2017,Enlisted,47167,10,2,8
2017,Enlisted,47170,4,1,3
2017,Enlisted,47203,59,12,47
2017,Enlisted,47223,4,2,2
2017,Enlisted,47250,8,3,5
2017,Enlisted,47265,11,0,11
2017,Enlisted,47274,10,3,7
2017,Enlisted,47303,30,3,27
2017,Enlisted,47331,18,2,16
2017,Enlisted,47348,31,3,28
2017,Enlisted,47374,19,5,14
2017,Enlisted,47394,22,2,20
2017,Enlisted,47401,18,3,15
2017,Enlisted,47421,8,1,7
2017,Enlisted,47441,22,3,19
2017,Enlisted,47501,23,2,21
2017,Enlisted,47546,35,7,28
2017,Enlisted,47591,9,1,8
2017,Enlisted,47715,60,5,55
2017,Enlisted,47804,18,4,14
2017,Enlisted,47834,23,2,21
2017,Enlisted,47872,15,2,13
2017,Enlisted,47905,51,6,45
2017,Enlisted,47933,25,2,23
2017,Enlisted,47960,31,2,29
2017,Enlisted,47977,13,2,11
2017,Enlisted,48060,11,2,9
2017,Enlisted,48180,90,5,85
2017,Enlisted,48197,31,4,27
2017,Enlisted,48208,52,4,48
2017,Enlisted,48234,156,29,127
2017,Enlisted,48341,40,2,38
2017,Enlisted,48446,18,1,17
2017,Enlisted,48601,73,19,54
2017,Enlisted,48642,22,1,21
2017,Enlisted,48706,37,5,32
2017,Enlisted,48801,15,2,13
2017,Enlisted,48817,45,5,40
2017,Enlisted,48837,66,12,54
2017,Enlisted,48838,18,4,14
2017,Enlisted,48843,23,5,18
2017,Enlisted,48906,48,9,39
2017,Enlisted,48912,13,0,13
2017,Enlisted,49009,54,11,43
2017,Enlisted,49012,73,10,63
2017,Enlisted,49047,21,6,15
2017,Enlisted,49201,15,1,14
2017,Enlisted,49224,16,3,13
2017,Enlisted,49306,3,1,2
2017,Enlisted,49307,14,4,10
2017,Enlisted,49437,23,4,19
2017,Enlisted,49509,132,32,100
2017,Enlisted,49601,19,4,15
2017,Enlisted,49739,100,20,80
2017,Enlisted,49783,27,4,23
2017,Enlisted,49801,2,0,2
2017,Enlisted,49802,5,2,3
2017,Enlisted,49837,10,0,10
2017,Enlisted,49849,9,2,7
2017,Enlisted,49855,9,1,8
2017,Enlisted,49908,12,0,12
2017,Enlisted,49913,9,1,8
2017,Enlisted,49935,4,1,3
2017,Enlisted,50025,2,0,2
2017,Enlisted,50036,27,7,20
2017,Enlisted,50126,10,3,7
2017,Enlisted,50131,233,24,209
2017,Enlisted,50138,7,0,7
2017,Enlisted,50158,5,1,4
2017,Enlisted,50220,3,1,2
2017,Enlisted,50401,10,1,9
2017,Enlisted,50501,11,0,11
2017,Enlisted,50511,1,0,1
2017,Enlisted,50588,14,0,14
2017,Enlisted,50616,9,1,8
2017,Enlisted,50662,13,1,12
2017,Enlisted,50703,43,10,33
2017,Enlisted,51031,10,3,7
2017,Enlisted,51111,23,2,21
2017,Enlisted,51201,20,1,19
2017,Enlisted,51301,5,1,4
2017,Enlisted,51334,8,1,7
2017,Enlisted,51401,12,0,12
2017,Enlisted,51442,11,3,8
2017,Enlisted,51503,11,4,7
2017,Enlisted,51566,4,1,3
2017,Enlisted,51601,7,1,6
2017,Enlisted,52002,37,3,34
2017,Enlisted,52246,77,8,69
2017,Enlisted,52353,5,1,4
2017,Enlisted,52404,41,4,37
2017,Enlisted,52501,7,0,7
2017,Enlisted,52556,15,5,10
2017,Enlisted,52577,8,1,7
2017,Enlisted,52632,7,1,6
2017,Enlisted,52638,11,2,9
2017,Enlisted,52641,4,2,2
2017,Enlisted,52732,23,0,23
2017,Enlisted,52761,7,2,5
2017,Enlisted,52806,32,3,29
2017,Enlisted,53027,5,1,4
2017,Enlisted,53066,7,0,7
2017,Enlisted,53073,12,2,10
2017,Enlisted,53089,29,1,28
2017,Enlisted,53094,1,0,1
2017,Enlisted,53095,7,1,6
2017,Enlisted,53105,6,2,4
2017,Enlisted,53121,17,1,16
2017,Enlisted,53144,5,1,4
2017,Enlisted,53154,8,2,6
2017,Enlisted,53186,10,0,10
2017,Enlisted,53190,27,2,25
2017,Enlisted,53212,41,9,32
2017,Enlisted,53403,7,1,6
2017,Enlisted,53511,29,2,27
2017,Enlisted,53538,1,0,1
2017,Enlisted,53545,1,0,1
2017,Enlisted,53704,70,13,57
2017,Enlisted,53818,8,0,8
2017,Enlisted,53821,22,1,21
2017,Enlisted,53901,3,1,2
2017,Enlisted,53948,13,0,13
2017,Enlisted,53959,8,1,7
2017,Enlisted,53963,7,3,4
2017,Enlisted,54017,6,2,4
2017,Enlisted,54022,6,1,5
2017,Enlisted,54241,7,0,7
2017,Enlisted,54303,19,2,17
2017,Enlisted,54401,11,1,10
2017,Enlisted,54405,4,0,4
2017,Enlisted,54409,10,1,9
2017,Enlisted,54449,15,3,12
2017,Enlisted,54451,4,0,4
2017,Enlisted,54455,7,0,7
2017,Enlisted,54456,7,0,7
2017,Enlisted,54481,13,1,12
2017,Enlisted,54487,2,0,2
2017,Enlisted,54495,11,2,9
2017,Enlisted,54501,10,2,8
2017,Enlisted,54612,9,1,8
2017,Enlisted,54615,21,0,21
2017,Enlisted,54618,35,4,31
2017,Enlisted,54650,16,0,16
2017,Enlisted,54656,9,1,8
2017,Enlisted,54660,11,1,10
2017,Enlisted,54665,2,0,2
2017,Enlisted,54703,12,3,9
2017,Enlisted,54729,8,1,7
2017,Enlisted,54751,12,4,8
2017,Enlisted,54801,9,0,9
2017,Enlisted,54806,18,1,17
2017,Enlisted,54843,4,0,4
2017,Enlisted,54868,3,0,3
2017,Enlisted,54880,27,2,25
2017,Enlisted,54902,29,0,29
2017,Enlisted,54914,18,1,17
2017,Enlisted,54923,12,0,12
2017,Enlisted,54929,13,0,13
2017,Enlisted,54935,25,2,23
2017,Enlisted,54971,10,2,8
2017,Enlisted,54981,6,0,6
2017,Enlisted,55008,33,1,32
2017,Enlisted,55016,29,2,27
2017,Enlisted,55021,34,2,32
2017,Enlisted,55033,11,0,11
2017,Enlisted,55060,9,1,8
2017,Enlisted,55063,21,1,20
2017,Enlisted,55066,21,2,19
2017,Enlisted,55068,51,8,43
2017,Enlisted,55077,28,3,25
2017,Enlisted,55082,31,2,29
2017,Enlisted,55101,1,1,0
2017,Enlisted,55106,15,1,14
2017,Enlisted,55107,46,4,42
2017,Enlisted,55112,102,7,95
2017,Enlisted,55118,33,4,29
2017,Enlisted,55303,11,3,8
2017,Enlisted,55350,7,1,6
2017,Enlisted,55355,19,2,17
2017,Enlisted,55362,7,0,7
2017,Enlisted,55413,2,1,1
2017,Enlisted,55431,30,6,24
2017,Enlisted,55443,12,0,12
2017,Enlisted,55719,13,1,12
2017,Enlisted,55720,15,0,15
2017,Enlisted,55744,15,1,14
2017,Enlisted,55746,19,0,19
2017,Enlisted,55811,47,1,46
2017,Enlisted,55904,24,3,21
2017,Enlisted,55912,37,1,36
2017,Enlisted,55987,21,0,21
2017,Enlisted,56001,32,0,32
2017,Enlisted,56007,17,2,15
2017,Enlisted,56031,21,0,21
2017,Enlisted,56073,7,0,7
2017,Enlisted,56081,12,1,11
2017,Enlisted,56082,11,1,10
2017,Enlisted,56143,18,0,18
2017,Enlisted,56156,10,0,10
2017,Enlisted,56164,6,2,4
2017,Enlisted,56201,18,1,17
2017,Enlisted,56208,11,0,11
2017,Enlisted,56256,20,0,20
2017,Enlisted,56258,18,1,17
2017,Enlisted,56265,12,0,12
2017,Enlisted,56267,24,0,24
2017,Enlisted,56277,7,1,6
2017,Enlisted,56278,13,0,13
2017,Enlisted,56283,11,1,10
2017,Enlisted,56303,45,2,43
2017,Enlisted,56308,30,1,29
2017,Enlisted,56345,109,7,102
2017,Enlisted,56378,10,1,9
2017,Enlisted,56401,11,1,10
2017,Enlisted,56482,8,1,7
2017,Enlisted,56501,7,1,6
2017,Enlisted,56537,14,2,12
2017,Enlisted,56560,32,4,28
2017,Enlisted,56601,7,1,6
2017,Enlisted,56701,11,0,11
2017,Enlisted,56716,7,0,7
2017,Enlisted,57006,7,1,6
2017,Enlisted,57028,9,1,8
2017,Enlisted,57042,17,0,17
2017,Enlisted,57069,19,2,17
2017,Enlisted,57078,8,0,8
2017,Enlisted,57104,40,3,37
2017,Enlisted,57201,29,4,25
2017,Enlisted,57231,2,0,2
2017,Enlisted,57252,7,2,5
2017,Enlisted,57301,5,0,5
2017,Enlisted,57325,8,0,8
2017,Enlisted,57350,5,0,5
2017,Enlisted,57366,3,1,2
2017,Enlisted,57380,9,1,8
2017,Enlisted,57401,18,2,16
2017,Enlisted,57501,14,5,9
2017,Enlisted,57601,10,0,10
2017,Enlisted,57702,38,9,29
2017,Enlisted,57703,10,2,8
2017,Enlisted,57717,13,2,11
2017,Enlisted,57783,7,1,6
2017,Enlisted,57785,7,2,5
2017,Enlisted,58054,3,0,3
2017,Enlisted,58072,8,2,6
2017,Enlisted,58075,19,1,18
2017,Enlisted,58102,54,5,49
2017,Enlisted,58201,34,2,32
2017,Enlisted,58257,5,0,5
2017,Enlisted,58301,26,0,26
2017,Enlisted,58402,13,1,12
2017,Enlisted,58421,3,0,3
2017,Enlisted,58433,7,1,6
2017,Enlisted,58495,5,0,5
2017,Enlisted,58506,60,5,55
2017,Enlisted,58601,22,0,22
2017,Enlisted,58646,7,0,7
2017,Enlisted,58703,19,3,16
2017,Enlisted,58801,8,1,7
2017,Enlisted,59047,6,2,4
2017,Enlisted,59102,57,8,49
2017,Enlisted,59218,2,0,2
2017,Enlisted,59230,3,2,1
2017,Enlisted,59301,6,1,5
2017,Enlisted,59405,6,0,6
2017,Enlisted,59457,6,0,6
2017,Enlisted,59501,7,1,6
2017,Enlisted,59538,6,0,6
2017,Enlisted,59602,50,5,45
2017,Enlisted,59636,25,11,14
2017,Enlisted,59701,10,1,9
2017,Enlisted,59711,8,0,8
2017,Enlisted,59714,51,8,43
2017,Enlisted,59725,9,1,8
2017,Enlisted,59808,47,9,38
2017,Enlisted,59901,17,1,16
2017,Enlisted,59923,1,0,1
2017,Enlisted,60037,20,0,20
2017,Enlisted,60098,19,4,15
2017,Enlisted,60120,26,4,22
2017,Enlisted,60178,18,2,16
2017,Enlisted,60435,26,5,21
2017,Enlisted,60472,60,6,54
2017,Enlisted,60505,21,5,16
2017,Enlisted,60546,184,17,167
2017,Enlisted,60615,70,11,59
2017,Enlisted,60616,17,6,11
2017,Enlisted,60638,19,4,15
2017,Enlisted,60651,20,4,16
2017,Enlisted,60901,25,5,20
2017,Enlisted,61021,15,0,15
2017,Enlisted,61032,25,1,24
2017,Enlisted,61071,26,4,22
2017,Enlisted,61115,52,8,44
2017,Enlisted,61264,25,1,24
2017,Enlisted,61341,15,3,12
2017,Enlisted,61401,11,2,9
2017,Enlisted,61434,10,0,10
2017,Enlisted,61443,13,0,13
2017,Enlisted,61455,20,4,16
2017,Enlisted,61607,83,11,72
2017,Enlisted,61701,35,6,29
2017,Enlisted,61761,21,3,18
2017,Enlisted,61764,15,5,10
2017,Enlisted,61801,24,4,20
2017,Enlisted,61820,10,0,10
2017,Enlisted,61834,17,1,16
2017,Enlisted,61938,14,2,12
2017,Enlisted,61944,17,0,17
2017,Enlisted,61951,7,0,7
2017,Enlisted,62056,27,8,19
2017,Enlisted,62205,20,3,17
2017,Enlisted,62269,21,0,21
2017,Enlisted,62286,28,3,25
2017,Enlisted,62301,12,2,10
2017,Enlisted,62401,19,2,17
2017,Enlisted,62439,10,0,10
2017,Enlisted,62521,45,9,36
2017,Enlisted,62702,76,9,67
2017,Enlisted,62864,32,2,30
2017,Enlisted,62896,22,5,17
2017,Enlisted,62959,47,11,36
2017,Enlisted,62966,30,3,27
2017,Enlisted,63020,6,0,6
2017,Enlisted,63028,18,1,17
2017,Enlisted,63044,61,8,53
2017,Enlisted,63077,14,3,11
2017,Enlisted,63109,13,1,12
2017,Enlisted,63125,49,7,42
2017,Enlisted,63383,16,2,14
2017,Enlisted,63401,14,2,12
2017,Enlisted,63501,7,1,6
2017,Enlisted,63552,18,1,17
2017,Enlisted,63640,22,5,17
2017,Enlisted,63645,2,0,2
2017,Enlisted,63703,26,7,19
2017,Enlisted,63755,2,1,1
2017,Enlisted,63775,4,1,3
2017,Enlisted,63801,4,0,4
2017,Enlisted,63841,9,1,8
2017,Enlisted,63857,11,1,10
2017,Enlisted,63873,8,0,8
2017,Enlisted,63901,10,1,9
2017,Enlisted,63935,2,1,1
2017,Enlisted,64052,14,0,14
2017,Enlisted,64067,14,5,9
2017,Enlisted,64085,22,0,22
2017,Enlisted,64093,6,1,5
2017,Enlisted,64129,91,9,82
2017,Enlisted,64402,10,0,10
2017,Enlisted,64468,13,2,11
2017,Enlisted,64506,23,6,17
2017,Enlisted,64601,10,0,10
2017,Enlisted,64683,15,2,13
2017,Enlisted,64701,38,1,37
2017,Enlisted,64735,5,0,5
2017,Enlisted,64759,16,4,12
2017,Enlisted,64772,15,2,13
2017,Enlisted,64804,13,3,10
2017,Enlisted,64831,10,2,8
2017,Enlisted,64836,11,1,10
2017,Enlisted,64850,4,1,3
2017,Enlisted,65101,17,6,11
2017,Enlisted,65109,29,6,23
2017,Enlisted,65202,20,3,17
2017,Enlisted,65233,7,2,5
2017,Enlisted,65251,8,0,8
2017,Enlisted,65265,15,0,15
2017,Enlisted,65270,6,1,5
2017,Enlisted,65301,9,3,6
2017,Enlisted,65305,21,6,15
2017,Enlisted,65340,30,2,28
2017,Enlisted,65401,33,3,30
2017,Enlisted,65473,26,2,24
2017,Enlisted,65536,15,2,13
2017,Enlisted,65605,12,1,11
2017,Enlisted,65708,49,8,41
2017,Enlisted,65723,13,2,11
2017,Enlisted,65775,11,1,10
2017,Enlisted,65802,47,6,41
2017,Enlisted,65803,44,10,34
2017,Enlisted,66027,8,0,8
2017,Enlisted,66044,2,2,0
2017,Enlisted,66061,19,2,17
2017,Enlisted,66067,2,1,1
2017,Enlisted,66071,4,1,3
2017,Enlisted,66102,22,12,10
2017,Enlisted,66219,18,6,12
2017,Enlisted,66434,1,0,1
2017,Enlisted,66441,19,7,12
2017,Enlisted,66502,24,13,11
2017,Enlisted,66508,2,2,0
2017,Enlisted,66611,2,0,2
2017,Enlisted,66619,56,15,41
2017,Enlisted,66749,2,1,1
2017,Enlisted,66762,21,2,19
2017,Enlisted,66801,2,2,0
2017,Enlisted,66901,1,0,1
2017,Enlisted,66967,2,1,1
2017,Enlisted,67010,9,1,8
2017,Enlisted,67114,9,2,7
2017,Enlisted,67124,1,0,1
2017,Enlisted,67217,21,11,10
2017,Enlisted,67219,24,4,20
2017,Enlisted,67337,4,1,3
2017,Enlisted,67401,14,5,9
2017,Enlisted,67410,6,0,6
2017,Enlisted,67432,2,0,2
2017,Enlisted,67501,11,0,11
2017,Enlisted,67530,5,1,4
2017,Enlisted,67601,9,4,5
2017,Enlisted,67701,1,1,0
2017,Enlisted,67846,4,2,2
2017,Enlisted,68003,2,2,0
2017,Enlisted,68066,5,0,5
2017,Enlisted,68073,39,11,28
2017,Enlisted,68106,17,6,11
2017,Enlisted,68142,14,4,10
2017,Enlisted,68310,28,12,16
2017,Enlisted,68410,4,2,2
2017,Enlisted,68467,4,1,3
2017,Enlisted,68508,21,2,19
2017,Enlisted,68524,38,7,31
2017,Enlisted,68601,16,1,15
2017,Enlisted,68701,9,4,5
2017,Enlisted,68763,2,0,2
2017,Enlisted,68787,1,0,1
2017,Enlisted,68801,17,3,14
2017,Enlisted,68822,1,0,1
2017,Enlisted,68847,4,0,4
2017,Enlisted,68901,20,0,20
2017,Enlisted,69001,3,0,3
2017,Enlisted,69101,4,0,4
2017,Enlisted,69337,7,3,4
2017,Enlisted,69361,11,3,8
2017,Enlisted,70072,13,0,13
2017,Enlisted,70084,33,0,33
2017,Enlisted,70117,135,13,122
2017,Enlisted,70364,20,0,20
2017,Enlisted,70390,2,0,2
2017,Enlisted,70401,98,12,86
2017,Enlisted,70403,8,1,7
2017,Enlisted,70427,10,1,9
2017,Enlisted,70433,25,1,24
2017,Enlisted,70438,8,0,8
2017,Enlisted,70460,37,3,34
2017,Enlisted,70508,45,9,36
2017,Enlisted,70510,34,3,31
2017,Enlisted,70517,27,7,20
2017,Enlisted,70526,12,2,10
2017,Enlisted,70544,12,4,8
2017,Enlisted,70563,23,1,22
2017,Enlisted,70570,13,0,13
2017,Enlisted,70582,18,4,14
2017,Enlisted,70586,10,1,9
2017,Enlisted,70601,50,5,45
2017,Enlisted,70633,10,3,7
2017,Enlisted,70634,3,0,3
2017,Enlisted,70701,4,0,4
2017,Enlisted,70714,31,1,30
2017,Enlisted,70721,74,5,69
2017,Enlisted,70737,25,1,24
2017,Enlisted,70760,23,2,21
2017,Enlisted,70764,10,0,10
2017,Enlisted,70820,59,9,50
2017,Enlisted,71019,18,4,14
2017,Enlisted,71055,53,7,46
2017,Enlisted,71101,39,6,33
2017,Enlisted,71111,17,2,15
2017,Enlisted,71203,42,3,39
2017,Enlisted,71220,2,0,2
2017,Enlisted,71232,10,0,10
2017,Enlisted,71241,12,0,12
2017,Enlisted,71251,2,1,1
2017,Enlisted,71263,4,0,4
2017,Enlisted,71270,39,2,37
2017,Enlisted,71292,25,1,24
2017,Enlisted,71295,8,0,8
2017,Enlisted,71303,18,2,16
2017,Enlisted,71322,14,1,13
2017,Enlisted,71342,11,1,10
2017,Enlisted,71351,15,2,13
2017,Enlisted,71360,116,11,105
2017,Enlisted,71373,1,0,1
2017,Enlisted,71415,6,0,6
2017,Enlisted,71417,8,0,8
2017,Enlisted,71457,10,2,8
2017,Enlisted,71459,14,2,12
2017,Enlisted,71601,6,1,5
2017,Enlisted,71602,7,0,7
2017,Enlisted,71701,5,0,5
2017,Enlisted,71730,5,0,5
2017,Enlisted,71761,6,1,5
2017,Enlisted,71801,3,0,3
2017,Enlisted,71854,13,2,11
2017,Enlisted,71857,1,0,1
2017,Enlisted,71913,14,0,14
2017,Enlisted,71923,2,0,2
2017,Enlisted,71953,14,0,14
2017,Enlisted,72007,15,1,14
2017,Enlisted,72012,24,1,23
2017,Enlisted,72015,10,1,9
2017,Enlisted,72023,19,1,18
2017,Enlisted,72032,1,1,0
2017,Enlisted,72034,5,0,5
2017,Enlisted,72064,13,1,12
2017,Enlisted,72086,15,1,14
2017,Enlisted,72104,12,1,11
2017,Enlisted,72110,8,0,8
2017,Enlisted,72114,55,9,46
2017,Enlisted,72119,1,1,0
2017,Enlisted,72143,30,3,27
2017,Enlisted,72150,1,0,1
2017,Enlisted,72160,14,0,14
2017,Enlisted,72199,200,37,163
2017,Enlisted,72335,18,2,16
2017,Enlisted,72401,37,5,32
2017,Enlisted,72432,15,1,14
2017,Enlisted,72450,19,4,15
2017,Enlisted,72476,12,2,10
2017,Enlisted,72501,15,1,14
2017,Enlisted,72543,21,2,19
2017,Enlisted,72650,7,1,6
2017,Enlisted,72653,8,0,8
2017,Enlisted,72701,20,5,15
2017,Enlisted,72712,55,6,49
2017,Enlisted,72744,10,1,9
2017,Enlisted,72756,27,1,26
2017,Enlisted,72761,9,0,9
2017,Enlisted,72802,20,2,18
2017,Enlisted,72830,14,3,11
2017,Enlisted,72834,5,1,4
2017,Enlisted,72905,22,9,13
2017,Enlisted,72923,64,9,55
2017,Enlisted,72927,2,0,2
2017,Enlisted,72949,4,0,4
2017,Enlisted,73034,23,2,21
2017,Enlisted,73036,37,5,32
2017,Enlisted,73051,24,4,20
2017,Enlisted,73064,37,5,32
2017,Enlisted,73069,143,19,124
2017,Enlisted,73111,16,7,9
2017,Enlisted,73179,17,2,15
2017,Enlisted,73401,16,4,12
2017,Enlisted,73503,26,5,21
2017,Enlisted,73521,10,1,9
2017,Enlisted,73705,25,2,23
2017,Enlisted,74003,22,0,22
2017,Enlisted,74012,21,2,19
2017,Enlisted,74014,65,10,55
2017,Enlisted,74017,6,2,4
2017,Enlisted,74075,77,13,64
2017,Enlisted,74107,60,13,47
2017,Enlisted,74116,27,9,18
2017,Enlisted,74158,3,1,2
2017,Enlisted,74301,11,4,7
2017,Enlisted,74403,32,2,30
2017,Enlisted,74423,15,4,11
2017,Enlisted,74447,11,0,11
2017,Enlisted,74501,22,2,20
2017,Enlisted,74601,13,4,9
2017,Enlisted,74701,15,1,14
2017,Enlisted,74804,19,1,18
2017,Enlisted,74820,19,3,16
2017,Enlisted,74834,39,5,34
2017,Enlisted,74848,8,2,6
2017,Enlisted,74953,4,1,3
2017,Enlisted,75051,133,63,70
2017,Enlisted,75077,7,2,5
2017,Enlisted,75098,3,3,0
2017,Enlisted,75110,5,5,0
2017,Enlisted,75159,48,27,21
2017,Enlisted,75160,48,29,19
2017,Enlisted,75165,6,2,4
2017,Enlisted,75220,14,3,11
2017,Enlisted,75237,42,23,19
2017,Enlisted,75402,19,9,10
2017,Enlisted,75570,9,6,3
2017,Enlisted,75662,7,5,2
2017,Enlisted,75672,10,4,6
2017,Enlisted,75709,19,8,11
2017,Enlisted,75801,1,1,0
2017,Enlisted,75803,19,4,15
2017,Enlisted,75901,17,9,8
2017,Enlisted,76067,1,1,0
2017,Enlisted,76086,14,7,7
2017,Enlisted,76105,45,28,17
2017,Enlisted,76108,74,35,39
2017,Enlisted,76115,22,16,6
2017,Enlisted,76207,11,3,8
2017,Enlisted,76234,9,2,7
2017,Enlisted,76302,16,6,10
2017,Enlisted,76401,11,7,4
2017,Enlisted,76502,34,23,11
2017,Enlisted,76528,8,3,5
2017,Enlisted,76542,47,35,12
2017,Enlisted,76544,9,2,7
2017,Enlisted,76574,7,5,2
2017,Enlisted,76705,3,1,2
2017,Enlisted,76707,57,34,23
2017,Enlisted,76801,20,8,12
2017,Enlisted,76905,16,9,7
2017,Enlisted,77034,132,60,72
2017,Enlisted,77067,77,31,46
2017,Enlisted,77082,75,39,36
2017,Enlisted,77340,32,14,18
2017,Enlisted,77437,13,3,10
2017,Enlisted,77471,8,4,4
2017,Enlisted,77515,13,5,8
2017,Enlisted,77568,10,5,5
2017,Enlisted,77802,21,8,13
2017,Enlisted,77833,6,0,6
2017,Enlisted,77904,10,5,5
2017,Enlisted,78041,27,12,15
2017,Enlisted,78130,7,4,3
2017,Enlisted,78155,6,3,3
2017,Enlisted,78218,43,21,22
2017,Enlisted,78219,25,17,8
2017,Enlisted,78257,159,96,63
2017,Enlisted,78363,7,3,4
2017,Enlisted,78416,27,12,15
2017,Enlisted,78520,10,4,6
2017,Enlisted,78596,61,12,49
2017,Enlisted,78602,81,41,40
2017,Enlisted,78617,93,51,42
2017,Enlisted,78624,23,14,9
2017,Enlisted,78665,53,25,28
2017,Enlisted,78666,87,33,54
2017,Enlisted,78703,66,34,32
2017,Enlisted,78731,19,10,9
2017,Enlisted,78746,5,3,2
2017,Enlisted,79107,17,9,8
2017,Enlisted,79403,39,20,19
2017,Enlisted,79607,31,12,19
2017,Enlisted,79706,16,9,7
2017,Enlisted,79924,11,2,9
2017,Enlisted,79936,104,28,76
2017,Enlisted,79963,25,10,15
2017,Enlisted,80011,77,45,32
2017,Enlisted,80012,17,11,6
2017,Enlisted,80112,2,1,1
2017,Enlisted,80137,36,15,21
2017,Enlisted,80216,89,31,58
2017,Enlisted,80501,6,1,5
2017,Enlisted,80504,27,17,10
2017,Enlisted,80521,44,25,19
2017,Enlisted,80550,10,5,5
2017,Enlisted,80621,13,6,7
2017,Enlisted,80751,6,2,4
2017,Enlisted,80907,15,8,7
2017,Enlisted,80913,24,12,12
2017,Enlisted,80916,17,12,5
2017,Enlisted,80920,58,33,25
2017,Enlisted,81004,12,5,7
2017,Enlisted,81050,10,4,6
2017,Enlisted,81101,8,0,8
2017,Enlisted,81303,8,5,3
2017,Enlisted,81401,13,4,9
2017,Enlisted,81501,25,9,16
2017,Enlisted,81637,1,1,0
2017,Enlisted,82005,14,3,11
2017,Enlisted,82009,28,9,19
2017,Enlisted,82072,11,1,10
2017,Enlisted,82201,1,1,0
2017,Enlisted,82214,14,5,9
2017,Enlisted,82240,11,3,8
2017,Enlisted,82401,5,0,5
2017,Enlisted,82435,6,0,6
2017,Enlisted,82520,7,2,5
2017,Enlisted,82604,9,3,6
2017,Enlisted,82633,7,0,7
2017,Enlisted,82716,7,1,6
2017,Enlisted,82801,12,2,10
2017,Enlisted,82901,9,0,9
2017,Enlisted,82930,17,2,15
2017,Enlisted,83110,6,3,3
2017,Enlisted,83202,23,3,20
2017,Enlisted,83221,18,0,18
2017,Enlisted,83263,6,2,4
2017,Enlisted,83301,14,1,13
2017,Enlisted,83318,4,1,3
2017,Enlisted,83330,3,1,2
2017,Enlisted,83338,12,2,10
2017,Enlisted,83402,18,1,17
2017,Enlisted,83440,7,1,6
2017,Enlisted,83442,2,0,2
2017,Enlisted,83445,3,0,3
2017,Enlisted,83501,13,0,13
2017,Enlisted,83530,5,0,5
2017,Enlisted,83544,4,2,2
2017,Enlisted,83605,33,7,26
2017,Enlisted,83617,2,1,1
2017,Enlisted,83647,14,4,10
2017,Enlisted,83676,1,1,0
2017,Enlisted,83687,8,3,5
2017,Enlisted,83705,157,34,123
2017,Enlisted,83716,1,1,0
2017,Enlisted,83843,8,4,4
2017,Enlisted,83854,17,2,15
2017,Enlisted,84003,13,3,10
2017,Enlisted,84020,27,12,15
2017,Enlisted,84043,59,20,39
2017,Enlisted,84058,22,9,13
2017,Enlisted,84065,112,33,79
2017,Enlisted,84074,20,3,17
2017,Enlisted,84078,3,1,2
2017,Enlisted,84083,5,1,4
2017,Enlisted,84084,110,25,85
2017,Enlisted,84116,14,6,8
2017,Enlisted,84302,3,0,3
2017,Enlisted,84321,9,1,8
2017,Enlisted,84323,5,1,4
2017,Enlisted,84405,23,6,17
2017,Enlisted,84501,8,2,6
2017,Enlisted,84511,1,1,0
2017,Enlisted,84642,7,0,7
2017,Enlisted,84647,1,1,0
2017,Enlisted,84660,28,9,19
2017,Enlisted,84663,2,0,2
2017,Enlisted,84701,12,1,11
2017,Enlisted,84713,3,0,3
2017,Enlisted,84720,9,2,7
2017,Enlisted,84770,7,2,5
2017,Enlisted,84790,27,4,23
2017,Enlisted,85008,205,70,135
2017,Enlisted,85015,4,2,2
2017,Enlisted,85020,24,6,18
2017,Enlisted,85122,21,2,19
2017,Enlisted,85128,2,2,0
2017,Enlisted,85132,113,30,83
2017,Enlisted,85281,15,4,11
2017,Enlisted,85286,3,1,2
2017,Enlisted,85301,5,1,4
2017,Enlisted,85312,21,4,17
2017,Enlisted,85365,11,2,9
2017,Enlisted,85396,26,6,20
2017,Enlisted,85546,10,4,6
2017,Enlisted,85607,7,0,7
2017,Enlisted,85653,46,15,31
2017,Enlisted,85706,52,10,42
2017,Enlisted,85713,37,14,23
2017,Enlisted,85901,5,2,3
2017,Enlisted,86015,68,13,55
2017,Enlisted,86301,43,16,27
2017,Enlisted,87002,25,5,20
2017,Enlisted,87123,49,5,44
2017,Enlisted,87144,79,24,55
2017,Enlisted,87305,1,1,0
2017,Enlisted,87401,18,3,15
2017,Enlisted,87508,14,6,8
2017,Enlisted,87532,1,0,1
2017,Enlisted,87557,1,0,1
2017,Enlisted,87701,3,2,1
2017,Enlisted,87747,6,1,5
2017,Enlisted,88001,2,1,1
2017,Enlisted,88007,97,24,73
2017,Enlisted,88101,8,1,7
2017,Enlisted,88203,23,6,17
2017,Enlisted,88240,5,1,4
2017,Enlisted,88310,14,6,8
2017,Enlisted,88435,6,1,5
2017,Enlisted,89002,13,2,11
2017,Enlisted,89032,8,1,7
2017,Enlisted,89115,101,17,84
2017,Enlisted,89139,47,10,37
2017,Enlisted,89165,85,16,69
2017,Enlisted,89406,12,3,9
2017,Enlisted,89445,1,0,1
2017,Enlisted,89506,71,14,57
2017,Enlisted,89509,1,0,1
2017,Enlisted,89701,42,15,27
2017,Enlisted,89801,2,1,1
2017,Enlisted,90025,11,9,2
2017,Enlisted,90201,52,17,35
2017,Enlisted,90249,19,6,13
2017,Enlisted,90266,3,0,3
2017,Enlisted,90302,30,11,19
2017,Enlisted,90501,10,5,5
2017,Enlisted,90720,169,67,102
2017,Enlisted,90731,9,5,4
2017,Enlisted,90813,5,0,5
2017,Enlisted,90822,47,27,20
2017,Enlisted,91205,40,22,18
2017,Enlisted,91406,26,1,25
2017,Enlisted,91505,23,10,13
2017,Enlisted,91702,49,13,36
2017,Enlisted,91764,31,10,21
2017,Enlisted,91766,23,6,17
2017,Enlisted,91950,36,15,21
2017,Enlisted,92020,23,9,14
2017,Enlisted,92025,10,4,6
2017,Enlisted,92111,63,27,36
2017,Enlisted,92227,1,1,0
2017,Enlisted,92243,8,2,6
2017,Enlisted,92307,7,6,1
2017,Enlisted,92311,3,1,2
2017,Enlisted,92324,10,3,7
2017,Enlisted,92410,7,5,2
2017,Enlisted,92501,33,17,16
2017,Enlisted,92518,40,15,25
2017,Enlisted,92707,12,4,8
2017,Enlisted,92833,31,14,17
2017,Enlisted,92866,19,12,7
2017,Enlisted,93003,6,0,6
2017,Enlisted,93030,1,0,1
2017,Enlisted,93103,4,1,3
2017,Enlisted,93257,8,5,3
2017,Enlisted,93291,30,9,21
2017,Enlisted,93307,40,11,29
2017,Enlisted,93405,6,3,3
2017,Enlisted,93422,1,0,1
2017,Enlisted,93451,30,15,15
2017,Enlisted,93454,1,0,1
2017,Enlisted,93536,45,13,32
2017,Enlisted,93550,7,6,1
2017,Enlisted,93638,2,1,1
2017,Enlisted,93702,8,3,5
2017,Enlisted,93727,64,28,36
2017,Enlisted,93955,2,2,0
2017,Enlisted,94043,5,4,1
2017,Enlisted,94066,6,2,4
2017,Enlisted,94132,9,2,7
2017,Enlisted,94401,13,3,10
2017,Enlisted,94510,2,0,2
2017,Enlisted,94519,6,1,5
2017,Enlisted,94533,3,0,3
2017,Enlisted,94565,35,14,21
2017,Enlisted,94568,26,12,14
2017,Enlisted,94590,29,6,23
2017,Enlisted,94596,4,2,2
2017,Enlisted,94804,20,8,12
2017,Enlisted,94903,4,2,2
2017,Enlisted,94952,18,8,10
2017,Enlisted,95020,2,0,2
2017,Enlisted,95023,13,8,5
2017,Enlisted,95110,19,4,15
2017,Enlisted,95206,47,11,36
2017,Enlisted,95240,11,2,9
2017,Enlisted,95341,15,8,7
2017,Enlisted,95351,30,15,15
2017,Enlisted,95361,19,14,5
2017,Enlisted,95380,9,3,6
2017,Enlisted,95401,17,5,12
2017,Enlisted,95503,6,3,3
2017,Enlisted,95603,21,11,10
2017,Enlisted,95655,3,3,0
2017,Enlisted,95667,7,3,4
2017,Enlisted,95678,13,5,8
2017,Enlisted,95815,6,0,6
2017,Enlisted,95826,17,3,14
2017,Enlisted,95828,54,19,35
2017,Enlisted,95832,14,1,13
2017,Enlisted,95926,3,1,2
2017,Enlisted,95965,6,2,4
2017,Enlisted,96001,9,1,8
2017,Enlisted,96080,2,1,1
2017,Enlisted,96130,2,2,0
2017,Enlisted,96707,139,70,69
2017,Enlisted,96716,8,2,6
2017,Enlisted,96720,18,8,10
2017,Enlisted,96732,6,2,4
2017,Enlisted,96748,1,1,0
2017,Enlisted,96750,8,0,8
2017,Enlisted,96782,54,27,27
2017,Enlisted,96786,23,10,13
2017,Enlisted,96789,22,13,9
2017,Enlisted,96795,1,1,0
2017,Enlisted,96816,3,2,1
2017,Enlisted,96857,23,13,10
2017,Enlisted,96913,117,15,102
2017,Enlisted,97015,78,22,56
2017,Enlisted,97030,19,5,14
2017,Enlisted,97031,4,1,3
2017,Enlisted,97051,7,2,5
2017,Enlisted,97058,4,4,0
2017,Enlisted,97071,19,13,6
2017,Enlisted,97116,31,10,21
2017,Enlisted,97124,13,7,6
2017,Enlisted,97128,10,2,8
2017,Enlisted,97146,9,4,5
2017,Enlisted,97211,33,18,15
2017,Enlisted,97217,12,7,5
2017,Enlisted,97218,26,9,17
2017,Enlisted,97301,14,5,9
2017,Enlisted,97302,17,7,10
2017,Enlisted,97303,17,3,14
2017,Enlisted,97309,28,11,17
2017,Enlisted,97321,10,6,4
2017,Enlisted,97330,18,10,8
2017,Enlisted,97338,5,1,4
2017,Enlisted,97355,17,1,16
2017,Enlisted,97361,1,1,0
2017,Enlisted,97365,2,1,1
2017,Enlisted,97420,7,5,2
2017,Enlisted,97470,10,4,6
2017,Enlisted,97477,39,11,28
2017,Enlisted,97501,37,18,19
2017,Enlisted,97520,17,3,14
2017,Enlisted,97526,15,5,10
2017,Enlisted,97603,13,7,6
2017,Enlisted,97702,16,5,11
2017,Enlisted,97754,6,3,3
2017,Enlisted,97756,18,7,11
2017,Enlisted,97801,21,11,10
2017,Enlisted,97814,6,2,4
2017,Enlisted,97838,6,3,3
2017,Enlisted,97850,15,2,13
2017,Enlisted,97862,13,1,12
2017,Enlisted,97914,1,1,0
2017,Enlisted,98032,104,58,46
2017,Enlisted,98052,26,15,11
2017,Enlisted,98108,38,12,26
2017,Enlisted,98119,64,46,18
2017,Enlisted,98201,8,6,2
2017,Enlisted,98221,18,7,11
2017,Enlisted,98271,16,5,11
2017,Enlisted,98290,18,10,8
2017,Enlisted,98312,24,18,6
2017,Enlisted,98321,6,6,0
2017,Enlisted,98372,16,8,8
2017,Enlisted,98430,38,28,10
2017,Enlisted,98433,137,84,53
2017,Enlisted,98501,33,17,16
2017,Enlisted,98516,1,1,0
2017,Enlisted,98531,18,10,8
2017,Enlisted,98563,2,1,1
2017,Enlisted,98632,10,5,5
2017,Enlisted,98682,20,9,11
2017,Enlisted,98801,6,5,1
2017,Enlisted,98823,9,2,7
2017,Enlisted,98837,18,8,10
2017,Enlisted,98901,42,17,25
2017,Enlisted,98903,17,8,9
2017,Enlisted,98930,8,2,6
2017,Enlisted,99011,34,18,16
2017,Enlisted,99217,30,10,20
2017,Enlisted,99219,9,3,6
2017,Enlisted,99224,2,2,0
2017,Enlisted,99301,11,0,11
2017,Enlisted,99362,2,0,2
2017,Enlisted,99505,132,76,56
2017,Enlisted,99559,3,1,2
2017,Enlisted,99604,2,0,2
2017,Enlisted,99614,3,0,3
2017,Enlisted,99615,2,0,2
2017,Enlisted,99621,1,0,1
2017,Enlisted,99654,11,6,5
2017,Enlisted,99655,2,0,2
2017,Enlisted,99686,1,1,0
2017,Enlisted,99687,23,9,14
2017,Enlisted,99701,23,13,10
2017,Enlisted,99821,5,2,3
2017,Enlisted,99835,3,1,2
2017,Enlisted,99901,4,1,3
2017,Enlisted,99925,2,0,2
2017,Officer,00604,1,1,0
2017,Officer,00623,1,1,0
2017,Officer,00641,2,2,0
2017,Officer,00693,2,1,1
2017,Officer,00733,1,1,0
2017,Officer,00735,5,5,0
2017,Officer,00736,1,1,0
2017,Officer,00751,3,3,0
2017,Officer,00769,2,1,1
2017,Officer,00795,3,3,0
2017,Officer,00850,2,2,0
2017,Officer,00901,6,2,4
2017,Officer,00934,1,1,0
2017,Officer,01082,1,1,0
2017,Officer,01085,2,2,0
2017,Officer,01434,1,1,0
2017,Officer,01605,2,2,0
2017,Officer,01731,2,2,0
2017,Officer,01760,6,6,0
2017,Officer,01844,3,3,0
2017,Officer,01867,1,1,0
2017,Officer,02184,1,1,0
2017,Officer,02301,3,3,0
2017,Officer,02420,1,1,0
2017,Officer,02542,3,3,0
2017,Officer,02769,1,1,0
2017,Officer,02818,7,7,0
2017,Officer,02842,2,2,0
2017,Officer,02852,3,1,2
2017,Officer,02882,1,1,0
2017,Officer,02886,4,4,0
2017,Officer,02896,1,1,0
2017,Officer,02904,4,4,0
2017,Officer,02906,2,0,2
2017,Officer,02920,1,1,0
2017,Officer,03060,1,1,0
2017,Officer,03101,3,3,0
2017,Officer,03301,6,4,2
2017,Officer,03570,1,1,0
2017,Officer,04011,5,5,0
2017,Officer,04073,1,1,0
2017,Officer,04333,6,4,2
2017,Officer,04401,4,3,1
2017,Officer,04619,1,1,0
2017,Officer,05001,1,1,0
2017,Officer,05033,1,1,0
2017,Officer,05158,2,2,0
2017,Officer,05201,6,6,0
2017,Officer,05403,2,2,0
2017,Officer,05446,1,1,0
2017,Officer,05465,9,9,0
2017,Officer,05478,6,6,0
2017,Officer,05495,2,2,0
2017,Officer,05602,1,1,0
2017,Officer,05661,1,1,0
2017,Officer,05663,5,5,0
2017,Officer,05676,1,1,0
2017,Officer,05701,3,3,0
2017,Officer,05851,1,1,0
2017,Officer,05855,1,1,0
2017,Officer,06082,1,1,0
2017,Officer,06096,5,5,0
2017,Officer,06105,1,1,0
2017,Officer,06340,1,1,0
2017,Officer,06357,4,3,1
2017,Officer,06360,2,0,2
2017,Officer,06457,4,4,0
2017,Officer,06489,1,1,0
2017,Officer,06498,2,2,0
2017,Officer,06512,6,6,0
2017,Officer,06614,5,3,2
2017,Officer,06810,7,4,3
2017,Officer,07090,1,1,0
2017,Officer,07095,5,5,0
2017,Officer,07107,1,1,0
2017,Officer,07306,2,2,0
2017,Officer,07457,4,4,0
2017,Officer,07666,5,5,0
2017,Officer,07728,8,8,0
2017,Officer,07801,3,3,0
2017,Officer,07865,2,2,0
2017,Officer,07960,3,2,1
2017,Officer,08002,2,2,0
2017,Officer,08012,1,1,0
2017,Officer,08037,4,4,0
2017,Officer,08060,2,2,0
2017,Officer,08096,3,3,0
2017,Officer,08098,1,1,0
2017,Officer,08210,3,3,0
2017,Officer,08360,2,2,0
2017,Officer,08640,2,0,2
2017,Officer,08648,3,3,0
2017,Officer,08733,3,3,0
2017,Officer,08750,13,12,1
2017,Officer,08759,1,1,0
2017,Officer,08873,5,5,0
2017,Officer,09096,1,0,1
2017,Officer,10010,11,10,1
2017,Officer,10314,2,2,0
2017,Officer,10567,7,6,1
2017,Officer,10701,2,2,0
2017,Officer,11252,4,4,0
2017,Officer,11357,4,4,0
2017,Officer,11433,4,4,0
2017,Officer,11735,5,5,0
2017,Officer,12078,3,3,0
2017,Officer,12110,3,3,0
2017,Officer,12180,3,3,0
2017,Officer,12189,3,2,1
2017,Officer,12302,5,5,0
2017,Officer,12451,1,1,0
2017,Officer,12553,3,3,0
2017,Officer,12962,2,2,0
2017,Officer,13211,5,5,0
2017,Officer,13501,5,5,0
2017,Officer,13602,2,2,0
2017,Officer,13905,2,2,0
2017,Officer,14048,2,1,1
2017,Officer,14204,2,2,0
2017,Officer,14213,6,5,1
2017,Officer,14454,1,1,0
2017,Officer,14456,3,2,1
2017,Officer,14624,5,5,0
2017,Officer,14760,1,1,0
2017,Officer,14843,1,1,0
2017,Officer,14845,2,2,0
2017,Officer,15010,1,1,0
2017,Officer,15216,4,4,0
2017,Officer,15301,4,4,0
2017,Officer,15370,1,1,0
2017,Officer,15425,2,2,0
2017,Officer,15601,1,1,0
2017,Officer,15666,3,3,0
2017,Officer,15767,1,1,0
2017,Officer,15779,2,2,0
2017,Officer,15902,1,1,0
2017,Officer,15904,7,7,0
2017,Officer,16101,2,2,0
2017,Officer,16148,2,2,0
2017,Officer,16635,2,2,0
2017,Officer,16652,1,1,0
2017,Officer,16738,2,2,0
2017,Officer,17003,34,33,1
2017,Officer,17013,1,1,0
2017,Officer,17022,4,3,1
2017,Officer,17042,2,2,0
2017,Officer,17044,2,2,0
2017,Officer,17098,1,1,0
2017,Officer,17103,7,7,0
2017,Officer,17201,2,2,0
2017,Officer,17222,2,2,0
2017,Officer,17404,1,1,0
2017,Officer,17701,2,2,0
2017,Officer,17745,2,2,0
2017,Officer,17821,1,1,0
2017,Officer,18040,2,2,0
2017,Officer,18102,4,4,0
2017,Officer,18252,1,1,0
2017,Officer,18431,1,1,0
2017,Officer,18466,1,1,0
2017,Officer,18509,12,12,0
2017,Officer,18634,2,2,0
2017,Officer,18834,2,2,0
2017,Officer,19044,6,6,0
2017,Officer,19153,5,5,0
2017,Officer,19154,12,11,1
2017,Officer,19320,2,2,0
2017,Officer,19462,1,1,0
2017,Officer,19475,3,3,0
2017,Officer,19605,2,2,0
2017,Officer,19706,2,2,0
2017,Officer,19720,1,1,0
2017,Officer,19804,4,4,0
2017,Officer,19808,1,1,0
2017,Officer,19947,1,1,0
2017,Officer,19977,2,2,0
2017,Officer,20003,24,23,1
2017,Officer,20112,2,2,0
2017,Officer,20175,2,2,0
2017,Officer,20186,3,3,0
2017,Officer,20373,3,3,0
2017,Officer,20708,3,3,0
2017,Officer,20755,1,1,0
2017,Officer,20904,1,1,0
2017,Officer,21010,8,8,0
2017,Officer,21043,2,2,0
2017,Officer,21057,1,1,0
2017,Officer,21061,1,1,0
2017,Officer,21078,1,1,0
2017,Officer,21136,2,2,0
2017,Officer,21201,7,7,0
2017,Officer,21204,3,3,0
2017,Officer,21216,2,2,0
2017,Officer,21222,3,3,0
2017,Officer,21236,1,1,0
2017,Officer,21401,3,3,0
2017,Officer,21701,1,1,0
2017,Officer,21719,1,1,0
2017,Officer,21740,1,1,0
2017,Officer,22032,15,11,4
2017,Officer,22060,5,5,0
2017,Officer,22401,10,8,2
2017,Officer,22427,2,1,1
2017,Officer,22601,5,5,0
2017,Officer,22664,1,1,0
2017,Officer,22731,1,1,0
2017,Officer,22902,1,1,0
2017,Officer,23150,3,3,0
2017,Officer,23181,4,3,1
2017,Officer,23237,3,1,2
2017,Officer,23451,5,5,0
2017,Officer,23502,6,5,1
2017,Officer,23666,5,5,0
2017,Officer,23701,3,2,1
2017,Officer,23805,3,2,1
2017,Officer,23824,13,12,1
2017,Officer,23847,1,1,0
2017,Officer,23851,1,1,0
2017,Officer,24112,3,3,0
2017,Officer,24151,3,3,0
2017,Officer,24210,1,1,0
2017,Officer,24301,1,1,0
2017,Officer,24401,2,1,1
2017,Officer,24450,2,2,0
2017,Officer,24502,5,3,2
2017,Officer,24523,1,1,0
2017,Officer,24541,1,1,0
2017,Officer,24592,1,1,0
2017,Officer,24609,2,1,1
2017,Officer,24957,1,1,0
2017,Officer,25064,2,2,0
2017,Officer,25168,2,2,0
2017,Officer,25177,1,1,0
2017,Officer,25309,7,7,0
2017,Officer,25311,4,4,0
2017,Officer,25401,3,3,0
2017,Officer,25530,3,3,0
2017,Officer,25550,3,3,0
2017,Officer,25625,3,3,0
2017,Officer,25846,1,1,0
2017,Officer,26003,1,1,0
2017,Officer,26041,1,1,0
2017,Officer,26101,2,2,0
2017,Officer,26187,2,2,0
2017,Officer,26250,1,1,0
2017,Officer,26301,1,1,0
2017,Officer,26505,1,1,0
2017,Officer,26537,2,2,0
2017,Officer,26554,2,2,0
2017,Officer,26651,1,1,0
2017,Officer,27103,3,3,0
2017,Officer,27217,2,2,0
2017,Officer,27260,5,4,1
2017,Officer,27344,2,2,0
2017,Officer,27401,4,4,0
2017,Officer,27530,2,2,0
2017,Officer,27549,1,1,0
2017,Officer,27560,5,5,0
2017,Officer,27581,4,4,0
2017,Officer,27607,8,8,0
2017,Officer,27704,1,1,0
2017,Officer,27870,1,1,0
2017,Officer,27892,1,1,0
2017,Officer,28012,5,5,0
2017,Officer,28043,1,1,0
2017,Officer,28054,2,2,0
2017,Officer,28110,2,2,0
2017,Officer,28115,1,1,0
2017,Officer,28208,5,5,0
2017,Officer,28306,4,4,0
2017,Officer,28310,4,4,0
2017,Officer,28328,6,6,0
2017,Officer,28337,2,2,0
2017,Officer,28345,3,1,2
2017,Officer,28371,2,2,0
2017,Officer,28376,3,3,0
2017,Officer,28388,3,3,0
2017,Officer,28405,1,1,0
2017,Officer,28472,3,3,0
2017,Officer,28504,3,3,0
2017,Officer,28518,1,1,0
2017,Officer,28560,1,1,0
2017,Officer,28577,1,1,0
2017,Officer,28601,4,4,0
2017,Officer,28659,1,1,0
2017,Officer,28681,1,1,0
2017,Officer,29020,2,2,0
2017,Officer,29044,13,13,0
2017,Officer,29108,4,4,0
2017,Officer,29138,2,2,0
2017,Officer,29151,4,4,0
2017,Officer,29161,1,1,0
2017,Officer,29172,1,1,0
2017,Officer,29201,5,5,0
2017,Officer,29303,1,1,0
2017,Officer,29325,1,1,0
2017,Officer,29379,2,2,0
2017,Officer,29403,2,2,0
2017,Officer,29418,4,4,0
2017,Officer,29440,4,4,0
2017,Officer,29461,1,1,0
2017,Officer,29464,1,1,0
2017,Officer,29488,1,1,0
2017,Officer,29506,4,4,0
2017,Officer,29510,1,1,0
2017,Officer,29526,2,2,0
2017,Officer,29532,1,1,0
2017,Officer,29536,1,1,0
2017,Officer,29556,1,1,0
2017,Officer,29571,1,1,0
2017,Officer,29574,1,1,0
2017,Officer,29605,1,1,0
2017,Officer,29620,2,2,0
2017,Officer,29625,2,2,0
2017,Officer,29631,3,3,0
2017,Officer,29646,1,1,0
2017,Officer,29653,2,2,0
2017,Officer,29678,1,1,0
2017,Officer,29715,1,1,0
2017,Officer,29720,1,1,0
2017,Officer,29829,4,4,0
2017,Officer,30014,3,3,0
2017,Officer,30032,2,2,0
2017,Officer,30040,6,6,0
2017,Officer,30060,39,32,7
2017,Officer,30069,6,5,1
2017,Officer,30114,1,0,1
2017,Officer,30125,1,1,0
2017,Officer,30134,1,1,0
2017,Officer,30144,3,1,2
2017,Officer,30161,4,3,1
2017,Officer,30224,1,1,0
2017,Officer,30240,2,2,0
2017,Officer,30263,2,2,0
2017,Officer,30294,9,8,1
2017,Officer,30297,10,10,0
2017,Officer,30336,3,2,1
2017,Officer,30401,1,1,0
2017,Officer,30427,2,2,0
2017,Officer,30439,1,1,0
2017,Officer,30461,1,1,0
2017,Officer,30501,2,2,0
2017,Officer,30597,12,11,1
2017,Officer,30635,3,3,0
2017,Officer,30643,1,1,0
2017,Officer,30673,1,1,0
2017,Officer,30680,6,5,1
2017,Officer,30701,4,4,0
2017,Officer,30720,3,3,0
2017,Officer,30824,1,1,0
2017,Officer,30904,5,4,1
2017,Officer,30905,1,1,0
2017,Officer,31015,1,1,0
2017,Officer,31029,3,3,0
2017,Officer,31040,1,1,0
2017,Officer,31061,1,1,0
2017,Officer,31211,9,8,1
2017,Officer,31314,3,3,0
2017,Officer,31329,1,1,0
2017,Officer,31406,6,4,2
2017,Officer,31409,2,2,0
2017,Officer,31520,1,1,0
2017,Officer,31533,1,1,0
2017,Officer,31601,1,0,1
2017,Officer,31792,2,1,1
2017,Officer,32055,1,1,0
2017,Officer,32084,1,1,0
2017,Officer,32086,5,2,3
2017,Officer,32091,11,10,1
2017,Officer,32164,2,2,0
2017,Officer,32177,1,1,0
2017,Officer,32221,7,7,0
2017,Officer,32311,3,3,0
2017,Officer,32406,3,3,0
2017,Officer,32425,1,1,0
2017,Officer,32447,1,1,0
2017,Officer,32514,1,1,0
2017,Officer,32536,1,1,0
2017,Officer,32724,1,1,0
2017,Officer,32727,2,2,0
2017,Officer,32771,2,2,0
2017,Officer,32827,3,3,0
2017,Officer,32856,3,3,0
2017,Officer,32924,1,1,0
2017,Officer,32935,1,1,0
2017,Officer,33025,4,4,0
2017,Officer,33039,1,1,0
2017,Officer,33127,3,3,0
2017,Officer,33315,1,1,0
2017,Officer,33405,3,3,0
2017,Officer,33406,2,2,0
2017,Officer,33523,1,1,0
2017,Officer,33563,2,2,0
2017,Officer,33606,1,1,0
2017,Officer,33711,1,1,0
2017,Officer,33762,1,1,0
2017,Officer,33782,6,5,1
2017,Officer,33811,4,4,0
2017,Officer,33825,2,2,0
2017,Officer,33830,2,2,0
2017,Officer,33844,2,2,0
2017,Officer,33859,2,2,0
2017,Officer,33880,2,2,0
2017,Officer,34208,2,2,0
2017,Officer,34429,1,1,0
2017,Officer,34474,2,2,0
2017,Officer,34604,1,1,0
2017,Officer,34748,1,1,0
2017,Officer,34947,1,1,0
2017,Officer,35016,4,4,0
2017,Officer,35042,10,10,0
2017,Officer,35055,1,1,0
2017,Officer,35121,4,4,0
2017,Officer,35124,1,1,0
2017,Officer,35150,2,2,0
2017,Officer,35161,3,3,0
2017,Officer,35209,2,2,0
2017,Officer,35217,10,10,0
2017,Officer,35405,2,2,0
2017,Officer,35476,3,3,0
2017,Officer,35555,1,1,0
2017,Officer,35565,4,4,0
2017,Officer,35594,2,2,0
2017,Officer,35601,3,3,0
2017,Officer,35613,1,1,0
2017,Officer,35710,1,1,0
2017,Officer,35805,1,1,0
2017,Officer,35904,3,3,0
2017,Officer,35967,1,1,0
2017,Officer,36010,4,4,0
2017,Officer,36032,1,1,0
2017,Officer,36043,5,5,0
2017,Officer,36067,4,4,0
2017,Officer,36078,1,1,0
2017,Officer,36081,3,3,0
2017,Officer,36083,1,1,0
2017,Officer,36109,8,8,0
2017,Officer,36117,2,2,0
2017,Officer,36203,3,3,0
2017,Officer,36205,6,6,0
2017,Officer,36251,2,2,0
2017,Officer,36265,2,2,0
2017,Officer,36323,1,1,0
2017,Officer,36330,3,3,0
2017,Officer,36344,2,2,0
2017,Officer,36421,1,1,0
2017,Officer,36532,1,1,0
2017,Officer,36535,1,1,0
2017,Officer,36605,6,6,0
2017,Officer,36608,3,3,0
2017,Officer,36701,1,1,0
2017,Officer,36801,1,1,0
2017,Officer,36832,1,1,0
2017,Officer,36854,2,2,0
2017,Officer,36867,1,1,0
2017,Officer,37033,1,1,0
2017,Officer,37066,1,1,0
2017,Officer,37090,3,3,0
2017,Officer,37110,1,1,0
2017,Officer,37167,13,12,1
2017,Officer,37178,3,2,1
2017,Officer,37185,1,1,0
2017,Officer,37204,13,10,3
2017,Officer,37217,3,3,0
2017,Officer,37327,1,1,0
2017,Officer,37356,3,3,0
2017,Officer,37398,3,3,0
2017,Officer,37404,1,0,1
2017,Officer,37645,6,5,1
2017,Officer,37650,1,1,0
2017,Officer,37717,1,1,0
2017,Officer,37743,1,1,0
2017,Officer,37760,1,1,0
2017,Officer,37771,1,1,0
2017,Officer,37777,5,5,0
2017,Officer,37801,1,1,0
2017,Officer,37841,2,2,0
2017,Officer,37854,1,0,1
2017,Officer,37860,1,1,0
2017,Officer,37919,6,6,0
2017,Officer,38024,1,1,0
2017,Officer,38053,1,1,0
2017,Officer,38301,1,1,0
2017,Officer,38302,3,3,0
2017,Officer,38340,1,1,0
2017,Officer,38344,3,3,0
2017,Officer,38351,1,1,0
2017,Officer,38358,1,1,0
2017,Officer,38375,2,1,1
2017,Officer,38382,3,3,0
2017,Officer,38401,2,2,0
2017,Officer,38485,1,1,0
2017,Officer,38506,6,6,0
2017,Officer,38606,2,2,0
2017,Officer,38632,1,0,1
2017,Officer,38663,1,1,0
2017,Officer,38668,2,2,0
2017,Officer,38671,1,1,0
2017,Officer,38701,1,1,0
2017,Officer,38751,3,3,0
2017,Officer,38801,1,1,0
2017,Officer,38803,1,1,0
2017,Officer,38821,3,3,0
2017,Officer,38834,1,1,0
2017,Officer,38843,1,1,0
2017,Officer,38863,2,2,0
2017,Officer,38901,1,1,0
2017,Officer,38916,1,1,0
2017,Officer,38926,1,1,0
2017,Officer,38965,1,1,0
2017,Officer,39046,3,3,0
2017,Officer,39060,1,1,0
2017,Officer,39074,1,1,0
2017,Officer,39111,2,2,0
2017,Officer,39117,1,1,0
2017,Officer,39159,1,1,0
2017,Officer,39202,1,1,0
2017,Officer,39204,8,8,0
2017,Officer,39209,2,2,0
2017,Officer,39216,2,2,0
2017,Officer,39296,3,2,1
2017,Officer,39328,2,2,0
2017,Officer,39339,1,1,0
2017,Officer,39345,3,3,0
2017,Officer,39350,3,3,0
2017,Officer,39367,1,1,0
2017,Officer,39403,2,2,0
2017,Officer,39407,7,7,0
2017,Officer,39422,1,1,0
2017,Officer,39452,1,1,0
2017,Officer,39501,1,1,0
2017,Officer,39507,3,3,0
2017,Officer,39567,1,1,0
2017,Officer,39638,2,2,0
2017,Officer,39648,1,1,0
2017,Officer,39654,1,1,0
2017,Officer,39704,2,2,0
2017,Officer,39730,1,1,0
2017,Officer,39760,6,6,0
2017,Officer,39773,4,4,0
2017,Officer,40065,1,1,0
2017,Officer,40205,4,3,1
2017,Officer,40218,2,1,1
2017,Officer,40330,1,1,0
2017,Officer,40351,2,2,0
2017,Officer,40472,2,2,0
2017,Officer,40475,3,3,0
2017,Officer,40510,3,3,0
2017,Officer,40601,10,8,2
2017,Officer,40831,1,1,0
2017,Officer,40906,1,1,0
2017,Officer,41005,1,1,0
2017,Officer,41056,1,1,0
2017,Officer,41101,3,3,0
2017,Officer,41653,1,1,0
2017,Officer,41701,1,1,0
2017,Officer,42086,1,1,0
2017,Officer,42101,1,1,0
2017,Officer,42141,3,3,0
2017,Officer,42167,1,1,0
2017,Officer,42240,1,1,0
2017,Officer,42501,1,1,0
2017,Officer,43015,4,2,2
2017,Officer,43040,2,2,0
2017,Officer,43055,1,1,0
2017,Officer,43213,6,5,1
2017,Officer,43217,8,4,4
2017,Officer,43235,4,3,1
2017,Officer,43465,4,4,0
2017,Officer,43614,1,0,1
2017,Officer,43756,4,4,0
2017,Officer,43812,1,1,0
2017,Officer,44023,1,1,0
2017,Officer,44055,2,1,1
2017,Officer,44128,1,1,0
2017,Officer,44142,1,1,0
2017,Officer,44224,4,3,1
2017,Officer,44313,4,4,0
2017,Officer,44444,3,2,1
2017,Officer,44720,4,4,0
2017,Officer,44857,1,0,1
2017,Officer,44870,2,2,0
2017,Officer,44883,1,1,0
2017,Officer,45015,2,2,0
2017,Officer,45044,1,1,0
2017,Officer,45215,8,7,1
2017,Officer,45356,1,1,0
2017,Officer,45385,1,1,0
2017,Officer,45430,2,2,0
2017,Officer,45502,3,2,1
2017,Officer,45505,1,1,0
2017,Officer,45601,1,0,1
2017,Officer,45662,1,1,0
2017,Officer,45804,1,0,1
2017,Officer,45885,2,2,0
2017,Officer,46012,1,1,0
2017,Officer,46036,2,2,0
2017,Officer,46041,1,1,0
2017,Officer,46124,3,3,0
2017,Officer,46131,16,15,1
2017,Officer,46140,2,2,0
2017,Officer,46151,3,3,0
2017,Officer,46176,10,10,0
2017,Officer,46216,4,4,0
2017,Officer,46241,19,17,2
2017,Officer,46323,1,1,0
2017,Officer,46383,1,1,0
2017,Officer,46402,2,2,0
2017,Officer,46406,1,1,0
2017,Officer,46517,3,3,0
2017,Officer,46563,1,1,0
2017,Officer,46613,1,1,0
2017,Officer,46825,2,2,0
2017,Officer,46901,4,4,0
2017,Officer,46953,1,1,0
2017,Officer,47167,1,1,0
2017,Officer,47203,4,4,0
2017,Officer,47274,1,1,0
2017,Officer,47303,2,1,1
2017,Officer,47348,3,2,1
2017,Officer,47394,2,2,0
2017,Officer,47401,3,3,0
2017,Officer,47421,2,2,0
2017,Officer,47441,2,2,0
2017,Officer,47501,1,1,0
2017,Officer,47546,1,1,0
2017,Officer,47591,2,2,0
2017,Officer,47715,3,3,0
2017,Officer,47804,2,2,0
2017,Officer,47834,2,2,0
2017,Officer,47905,4,3,1
2017,Officer,47933,6,6,0
2017,Officer,48045,1,1,0
2017,Officer,48060,2,2,0
2017,Officer,48180,4,4,0
2017,Officer,48197,5,5,0
2017,Officer,48208,3,3,0
2017,Officer,48234,9,9,0
2017,Officer,48446,1,1,0
2017,Officer,48601,3,3,0
2017,Officer,48642,2,2,0
2017,Officer,48706,1,1,0
2017,Officer,48817,1,1,0
2017,Officer,48837,5,5,0
2017,Officer,48838,1,1,0
2017,Officer,48906,12,11,1
2017,Officer,48912,5,5,0
2017,Officer,49009,2,2,0
2017,Officer,49012,7,7,0
2017,Officer,49201,2,2,0
2017,Officer,49224,2,2,0
2017,Officer,49437,1,1,0
2017,Officer,49509,6,6,0
2017,Officer,49601,1,1,0
2017,Officer,49739,2,2,0
2017,Officer,49849,1,1,0
2017,Officer,50025,1,1,0
2017,Officer,50036,4,4,0
2017,Officer,50131,25,21,4
2017,Officer,50158,1,1,0
2017,Officer,50321,1,1,0
2017,Officer,50616,1,1,0
2017,Officer,50703,3,3,0
2017,Officer,51031,2,1,1
2017,Officer,51111,2,2,0
2017,Officer,51201,1,1,0
2017,Officer,51401,2,2,0
2017,Officer,51503,1,1,0
2017,Officer,51601,1,1,0
2017,Officer,52002,3,3,0
2017,Officer,52246,3,3,0
2017,Officer,52404,4,4,0
2017,Officer,52556,1,1,0
2017,Officer,52632,1,1,0
2017,Officer,52732,2,2,0
2017,Officer,52806,5,5,0
2017,Officer,53089,1,1,0
2017,Officer,53095,1,1,0
2017,Officer,53186,1,1,0
2017,Officer,53212,6,5,1
2017,Officer,53403,2,2,0
2017,Officer,53704,7,6,1
2017,Officer,53821,1,1,0
2017,Officer,54143,1,1,0
2017,Officer,54241,3,3,0
2017,Officer,54409,1,1,0
2017,Officer,54451,1,1,0
2017,Officer,54455,1,1,0
2017,Officer,54481,1,1,0
2017,Officer,54501,1,1,0
2017,Officer,54615,1,1,0
2017,Officer,54618,7,7,0
2017,Officer,54650,1,1,0
2017,Officer,54703,1,1,0
2017,Officer,54751,2,2,0
2017,Officer,54801,1,1,0
2017,Officer,54806,1,1,0
2017,Officer,54868,2,2,0
2017,Officer,54902,2,2,0
2017,Officer,54914,2,2,0
2017,Officer,54929,1,1,0
2017,Officer,54981,2,1,1
2017,Officer,55008,1,1,0
2017,Officer,55016,4,2,2
2017,Officer,55021,4,4,0
2017,Officer,55063,1,1,0
2017,Officer,55066,1,1,0
2017,Officer,55068,7,7,0
2017,Officer,55077,1,1,0
2017,Officer,55082,2,2,0
2017,Officer,55101,3,2,1
2017,Officer,55107,7,6,1
2017,Officer,55112,9,9,0
2017,Officer,55118,1,1,0
2017,Officer,55303,5,3,2
2017,Officer,55350,1,0,1
2017,Officer,55355,3,3,0
2017,Officer,55431,5,5,0
2017,Officer,55443,1,0,1
2017,Officer,55720,1,1,0
2017,Officer,55746,1,0,1
2017,Officer,55811,3,2,1
2017,Officer,55904,2,1,1
2017,Officer,55912,1,1,0
2017,Officer,55987,1,1,0
2017,Officer,56001,1,1,0
2017,Officer,56073,2,2,0
2017,Officer,56143,1,1,0
2017,Officer,56265,2,2,0
2017,Officer,56303,4,4,0
2017,Officer,56308,2,2,0
2017,Officer,56345,4,2,2
2017,Officer,56378,2,1,1
2017,Officer,56401,2,1,1
2017,Officer,56560,2,2,0
2017,Officer,56601,2,2,0
2017,Officer,57006,3,3,0
2017,Officer,57042,1,1,0
2017,Officer,57069,1,1,0
2017,Officer,57078,1,1,0
2017,Officer,57104,4,4,0
2017,Officer,57201,1,1,0
2017,Officer,57252,1,1,0
2017,Officer,57366,1,1,0
2017,Officer,57601,1,1,0
2017,Officer,57702,1,1,0
2017,Officer,57706,1,1,0
2017,Officer,57717,1,1,0
2017,Officer,57783,1,1,0
2017,Officer,57785,1,1,0
2017,Officer,58072,1,1,0
2017,Officer,58102,3,3,0
2017,Officer,58201,2,2,0
2017,Officer,58368,1,1,0
2017,Officer,58433,1,1,0
2017,Officer,58495,1,1,0
2017,Officer,58506,5,5,0
2017,Officer,58703,5,5,0
2017,Officer,59102,1,1,0
2017,Officer,59501,1,1,0
2017,Officer,59538,1,1,0
2017,Officer,59602,5,5,0
2017,Officer,59636,6,6,0
2017,Officer,59701,2,2,0
2017,Officer,59714,2,2,0
2017,Officer,59808,1,1,0
2017,Officer,60037,1,1,0
2017,Officer,60098,2,2,0
2017,Officer,60120,2,2,0
2017,Officer,60435,1,1,0
2017,Officer,60472,4,4,0
2017,Officer,60505,1,1,0
2017,Officer,60546,6,6,0
2017,Officer,60615,8,7,1
2017,Officer,60616,3,3,0
2017,Officer,60651,4,4,0
2017,Officer,60901,1,1,0
2017,Officer,61032,1,1,0
2017,Officer,61071,1,1,0
2017,Officer,61115,3,3,0
2017,Officer,61341,5,5,0
2017,Officer,61401,2,1,1
2017,Officer,61443,4,4,0
2017,Officer,61607,8,8,0
2017,Officer,61701,2,2,0
2017,Officer,61761,4,4,0
2017,Officer,61764,1,1,0
2017,Officer,61801,2,2,0
2017,Officer,61951,1,1,0
2017,Officer,62205,1,1,0
2017,Officer,62269,1,1,0
2017,Officer,62286,2,2,0
2017,Officer,62301,1,1,0
2017,Officer,62401,1,1,0
2017,Officer,62439,1,1,0
2017,Officer,62521,3,3,0
2017,Officer,62702,10,8,2
2017,Officer,62864,1,1,0
2017,Officer,62959,2,2,0
2017,Officer,62966,1,1,0
2017,Officer,63028,2,2,0
2017,Officer,63044,5,5,0
2017,Officer,63077,2,2,0
2017,Officer,63125,5,4,1
2017,Officer,63383,1,1,0
2017,Officer,63401,1,1,0
2017,Officer,63640,2,2,0
2017,Officer,63645,2,2,0
2017,Officer,63703,2,2,0
2017,Officer,63901,1,1,0
2017,Officer,64052,3,3,0
2017,Officer,64085,1,1,0
2017,Officer,64129,6,6,0
2017,Officer,64402,1,1,0
2017,Officer,64468,1,1,0
2017,Officer,64506,4,4,0
2017,Officer,64601,1,1,0
2017,Officer,64701,2,2,0
2017,Officer,64759,3,3,0
2017,Officer,64772,3,2,1
2017,Officer,64831,1,0,1
2017,Officer,64836,2,1,1
2017,Officer,64850,1,1,0
2017,Officer,65101,5,5,0
2017,Officer,65109,3,3,0
2017,Officer,65202,1,1,0
2017,Officer,65233,1,1,0
2017,Officer,65251,4,3,1
2017,Officer,65301,3,3,0
2017,Officer,65305,4,4,0
2017,Officer,65340,1,0,1
2017,Officer,65473,2,2,0
2017,Officer,65536,1,0,1
2017,Officer,65708,2,2,0
2017,Officer,65723,2,2,0
2017,Officer,65775,1,1,0
2017,Officer,65802,3,3,0
2017,Officer,65803,3,3,0
2017,Officer,66027,3,3,0
2017,Officer,66061,1,1,0
2017,Officer,66102,5,5,0
2017,Officer,66219,10,7,3
2017,Officer,66434,1,1,0
2017,Officer,66502,5,5,0
2017,Officer,66611,1,1,0
2017,Officer,66619,8,8,0
2017,Officer,66749,4,4,0
2017,Officer,66801,1,1,0
2017,Officer,67114,2,2,0
2017,Officer,67217,2,2,0
2017,Officer,67219,4,4,0
2017,Officer,67337,1,1,0
2017,Officer,67410,2,2,0
2017,Officer,67501,1,1,0
2017,Officer,67601,2,1,1
2017,Officer,68003,1,1,0
2017,Officer,68073,1,1,0
2017,Officer,68106,1,1,0
2017,Officer,68142,1,1,0
2017,Officer,68310,1,1,0
2017,Officer,68410,1,1,0
2017,Officer,68508,11,10,1
2017,Officer,68524,9,9,0
2017,Officer,68601,3,3,0
2017,Officer,68801,3,3,0
2017,Officer,68847,1,1,0
2017,Officer,68901,1,0,1
2017,Officer,69337,1,1,0
2017,Officer,70084,1,1,0
2017,Officer,70117,12,9,3
2017,Officer,70364,4,3,1
2017,Officer,70390,1,1,0
2017,Officer,70401,4,4,0
2017,Officer,70403,1,1,0
2017,Officer,70427,1,0,1
2017,Officer,70433,1,1,0
2017,Officer,70508,3,3,0
2017,Officer,70510,2,1,1
2017,Officer,70544,1,1,0
2017,Officer,70570,1,0,1
2017,Officer,70582,4,4,0
2017,Officer,70601,1,1,0
2017,Officer,70721,2,1,1
2017,Officer,70737,1,1,0
2017,Officer,70760,1,1,0
2017,Officer,70820,4,2,2
2017,Officer,71055,1,0,1
2017,Officer,71101,2,1,1
2017,Officer,71203,2,2,0
2017,Officer,71270,1,0,1
2017,Officer,71292,1,1,0
2017,Officer,71303,1,1,0
2017,Officer,71360,6,5,1
2017,Officer,71417,1,1,0
2017,Officer,71459,1,1,0
2017,Officer,72007,1,1,0
2017,Officer,72034,1,0,1
2017,Officer,72086,1,1,0
2017,Officer,72114,3,3,0
2017,Officer,72143,1,1,0
2017,Officer,72199,9,6,3
2017,Officer,72335,1,1,0
2017,Officer,72401,3,3,0
2017,Officer,72432,1,1,0
2017,Officer,72450,2,0,2
2017,Officer,72476,1,1,0
2017,Officer,72543,2,2,0
2017,Officer,72653,1,1,0
2017,Officer,72701,3,3,0
2017,Officer,72712,5,5,0
2017,Officer,72756,1,1,0
2017,Officer,72761,1,1,0
2017,Officer,72830,1,1,0
2017,Officer,73034,3,3,0
2017,Officer,73036,2,2,0
2017,Officer,73051,1,1,0
2017,Officer,73064,4,4,0
2017,Officer,73069,11,10,1
2017,Officer,73111,7,6,1
2017,Officer,73503,3,2,1
2017,Officer,74014,4,4,0
2017,Officer,74017,1,1,0
2017,Officer,74075,2,2,0
2017,Officer,74107,6,5,1
2017,Officer,74116,1,1,0
2017,Officer,74301,1,1,0
2017,Officer,74403,1,1,0
2017,Officer,74501,2,1,1
2017,Officer,74701,3,3,0
2017,Officer,74820,1,1,0
2017,Officer,74834,1,1,0
2017,Officer,74848,2,2,0
2017,Officer,75051,13,13,0
2017,Officer,75098,2,2,0
2017,Officer,75110,1,1,0
2017,Officer,75159,3,3,0
2017,Officer,75160,1,1,0
2017,Officer,75165,1,1,0
2017,Officer,75237,1,1,0
2017,Officer,75672,2,2,0
2017,Officer,75709,3,3,0
2017,Officer,75901,2,2,0
2017,Officer,76105,4,4,0
2017,Officer,76108,3,3,0
2017,Officer,76115,4,4,0
2017,Officer,76207,3,3,0
2017,Officer,76234,1,1,0
2017,Officer,76302,2,2,0
2017,Officer,76502,3,3,0
2017,Officer,76528,2,2,0
2017,Officer,76542,2,2,0
2017,Officer,76707,8,8,0
2017,Officer,76801,1,1,0
2017,Officer,76905,1,1,0
2017,Officer,77034,5,5,0
2017,Officer,77067,5,5,0
2017,Officer,77082,9,9,0
2017,Officer,77340,1,1,0
2017,Officer,77437,1,1,0
2017,Officer,77515,1,1,0
2017,Officer,77802,3,2,1
2017,Officer,78041,2,2,0
2017,Officer,78130,3,3,0
2017,Officer,78155,1,1,0
2017,Officer,78218,10,10,0
2017,Officer,78219,7,7,0
2017,Officer,78257,11,11,0
2017,Officer,78363,1,1,0
2017,Officer,78416,6,6,0
2017,Officer,78520,1,1,0
2017,Officer,78596,6,6,0
2017,Officer,78602,8,7,1
2017,Officer,78617,6,6,0
2017,Officer,78624,1,1,0
2017,Officer,78665,7,7,0
2017,Officer,78666,13,13,0
2017,Officer,78703,20,20,0
2017,Officer,78731,2,2,0
2017,Officer,78746,4,4,0
2017,Officer,79403,4,3,1
2017,Officer,79607,7,7,0
2017,Officer,79936,1,1,0
2017,Officer,79963,2,2,0
2017,Officer,80011,12,11,1
2017,Officer,80012,1,1,0
2017,Officer,80112,3,3,0
2017,Officer,80137,4,3,1
2017,Officer,80216,5,4,1
2017,Officer,80504,3,3,0
2017,Officer,80521,4,4,0
2017,Officer,80751,1,1,0
2017,Officer,80907,1,1,0
2017,Officer,80913,2,2,0
2017,Officer,80916,2,2,0
2017,Officer,80920,5,5,0
2017,Officer,81004,1,1,0
2017,Officer,81401,2,2,0
2017,Officer,82005,2,2,0
2017,Officer,82009,11,9,2
2017,Officer,82072,1,1,0
2017,Officer,82240,2,2,0
2017,Officer,82401,2,1,1
2017,Officer,82604,6,4,2
2017,Officer,82633,2,2,0
2017,Officer,82801,1,1,0
2017,Officer,82930,1,0,1
2017,Officer,83110,1,1,0
2017,Officer,83221,1,1,0
2017,Officer,83263,1,1,0
2017,Officer,83338,2,2,0
2017,Officer,83440,2,2,0
2017,Officer,83501,1,1,0
2017,Officer,83617,1,1,0
2017,Officer,83647,1,1,0
2017,Officer,83705,16,16,0
2017,Officer,84003,2,2,0
2017,Officer,84020,10,8,2
2017,Officer,84043,2,2,0
2017,Officer,84058,3,3,0
2017,Officer,84065,21,15,6
2017,Officer,84084,5,5,0
2017,Officer,84405,1,1,0
2017,Officer,84631,1,1,0
2017,Officer,84660,1,1,0
2017,Officer,84663,2,2,0
2017,Officer,84701,1,1,0
2017,Officer,84713,1,0,1
2017,Officer,84720,2,2,0
2017,Officer,84770,2,2,0
2017,Officer,84790,1,1,0
2017,Officer,85008,27,24,3
2017,Officer,85122,1,0,1
2017,Officer,85128,1,1,0
2017,Officer,85132,3,3,0
2017,Officer,85281,1,0,1
2017,Officer,85301,1,1,0
2017,Officer,85396,1,1,0
2017,Officer,85607,1,1,0
2017,Officer,85653,5,5,0
2017,Officer,85706,1,0,1
2017,Officer,85713,1,1,0
2017,Officer,85901,1,1,0
2017,Officer,86015,2,2,0
2017,Officer,86301,1,1,0
2017,Officer,87002,1,1,0
2017,Officer,87123,4,3,1
2017,Officer,87144,9,9,0
2017,Officer,87401,2,2,0
2017,Officer,87508,7,5,2
2017,Officer,88007,5,5,0
2017,Officer,88101,1,1,0
2017,Officer,88203,2,2,0
2017,Officer,89115,6,6,0
2017,Officer,89139,2,2,0
2017,Officer,89165,2,2,0
2017,Officer,89406,1,1,0
2017,Officer,89506,3,3,0
2017,Officer,89509,3,3,0
2017,Officer,89701,1,1,0
2017,Officer,90025,1,1,0
2017,Officer,90201,3,3,0
2017,Officer,90266,2,2,0
2017,Officer,90501,1,1,0
2017,Officer,90720,16,16,0
2017,Officer,90731,2,2,0
2017,Officer,90813,1,1,0
2017,Officer,90822,6,6,0
2017,Officer,91205,5,5,0
2017,Officer,91406,3,3,0
2017,Officer,91505,3,3,0
2017,Officer,91702,7,7,0
2017,Officer,91764,3,2,1
2017,Officer,91766,1,1,0
2017,Officer,91950,3,3,0
2017,Officer,92025,2,2,0
2017,Officer,92111,5,5,0
2017,Officer,92243,1,1,0
2017,Officer,92518,1,1,0
2017,Officer,92707,1,1,0
2017,Officer,92833,1,1,0
2017,Officer,92866,1,1,0
2017,Officer,93257,1,1,0
2017,Officer,93291,1,1,0
2017,Officer,93307,2,2,0
2017,Officer,93405,1,1,0
2017,Officer,93451,1,1,0
2017,Officer,93550,1,1,0
2017,Officer,93638,1,1,0
2017,Officer,93727,1,1,0
2017,Officer,94132,2,2,0
2017,Officer,94401,3,3,0
2017,Officer,94533,2,2,0
2017,Officer,94565,4,4,0
2017,Officer,94568,2,2,0
2017,Officer,94804,1,1,0
2017,Officer,94903,1,1,0
2017,Officer,95110,1,1,0
2017,Officer,95206,1,1,0
2017,Officer,95240,1,1,0
2017,Officer,95351,1,1,0
2017,Officer,95361,1,1,0
2017,Officer,95401,2,2,0
2017,Officer,95503,1,1,0
2017,Officer,95655,2,2,0
2017,Officer,95678,2,2,0
2017,Officer,95826,6,6,0
2017,Officer,95828,5,5,0
2017,Officer,95832,1,1,0
2017,Officer,96707,16,16,0
2017,Officer,96716,1,1,0
2017,Officer,96720,1,1,0
2017,Officer,96732,1,1,0
2017,Officer,96750,1,1,0
2017,Officer,96782,4,4,0
2017,Officer,96786,3,3,0
2017,Officer,96789,3,3,0
2017,Officer,96816,6,6,0
2017,Officer,96820,3,3,0
2017,Officer,96913,11,6,5
2017,Officer,97015,8,6,2
2017,Officer,97051,1,0,1
2017,Officer,97058,5,5,0
2017,Officer,97071,3,3,0
2017,Officer,97116,1,0,1
2017,Officer,97211,2,1,1
2017,Officer,97217,1,0,1
2017,Officer,97301,5,4,1
2017,Officer,97303,2,1,1
2017,Officer,97309,8,5,3
2017,Officer,97330,1,1,0
2017,Officer,97338,2,1,1
2017,Officer,97355,1,0,1
2017,Officer,97470,2,2,0
2017,Officer,97477,3,3,0
2017,Officer,97520,5,5,0
2017,Officer,97526,1,1,0
2017,Officer,97603,1,1,0
2017,Officer,97702,1,1,0
2017,Officer,97838,1,1,0
2017,Officer,97862,1,1,0
2017,Officer,97914,2,2,0
2017,Officer,98032,9,9,0
2017,Officer,98108,3,3,0
2017,Officer,98119,8,8,0
2017,Officer,98201,1,1,0
2017,Officer,98271,1,1,0
2017,Officer,98290,2,2,0
2017,Officer,98321,2,2,0
2017,Officer,98372,1,1,0
2017,Officer,98430,5,5,0
2017,Officer,98433,12,12,0
2017,Officer,98501,4,4,0
2017,Officer,98531,2,2,0
2017,Officer,98682,4,4,0
2017,Officer,98823,1,1,0
2017,Officer,98901,2,2,0
2017,Officer,98903,1,1,0
2017,Officer,99011,3,3,0
2017,Officer,99217,9,9,0
2017,Officer,99301,2,2,0
2017,Officer,99505,13,13,0
2017,Officer,99701,2,2,0
2017,Officer,99731,3,3,0
2017,Warrant Officer,00735,2,2,0
2017,Warrant Officer,00901,3,3,0
2017,Warrant Officer,00951,1,1,0
2017,Warrant Officer,01013,1,1,0
2017,Warrant Officer,01434,1,1,0
2017,Warrant Officer,01731,3,3,0
2017,Warrant Officer,01867,2,2,0
2017,Warrant Officer,02542,3,3,0
2017,Warrant Officer,02852,2,2,0
2017,Warrant Officer,03301,2,2,0
2017,Warrant Officer,04401,1,1,0
2017,Warrant Officer,05403,1,1,0
2017,Warrant Officer,05446,1,1,0
2017,Warrant Officer,05465,1,1,0
2017,Warrant Officer,06096,1,1,0
2017,Warrant Officer,06105,3,3,0
2017,Warrant Officer,06340,3,3,0
2017,Warrant Officer,06357,1,1,0
2017,Warrant Officer,07095,1,1,0
2017,Warrant Officer,07666,1,1,0
2017,Warrant Officer,08648,1,1,0
2017,Warrant Officer,08733,7,7,0
2017,Warrant Officer,08873,1,1,0
2017,Warrant Officer,11779,1,1,0
2017,Warrant Officer,12110,6,6,0
2017,Warrant Officer,12180,3,3,0
2017,Warrant Officer,12302,2,2,0
2017,Warrant Officer,13602,1,1,0
2017,Warrant Officer,14048,1,1,0
2017,Warrant Officer,14624,3,3,0
2017,Warrant Officer,15010,1,1,0
2017,Warrant Officer,15216,1,1,0
2017,Warrant Officer,15301,1,1,0
2017,Warrant Officer,17003,8,8,0
2017,Warrant Officer,17022,1,1,0
2017,Warrant Officer,17042,1,1,0
2017,Warrant Officer,17103,6,6,0
2017,Warrant Officer,18235,1,1,0
2017,Warrant Officer,19044,2,2,0
2017,Warrant Officer,19154,2,2,0
2017,Warrant Officer,19475,1,1,0
2017,Warrant Officer,19720,5,5,0
2017,Warrant Officer,19804,1,1,0
2017,Warrant Officer,19977,5,5,0
2017,Warrant Officer,20003,4,4,0
2017,Warrant Officer,20708,1,1,0
2017,Warrant Officer,20783,2,2,0
2017,Warrant Officer,21010,5,5,0
2017,Warrant Officer,21057,1,1,0
2017,Warrant Officer,21204,1,1,0
2017,Warrant Officer,21401,1,1,0
2017,Warrant Officer,22060,3,3,0
2017,Warrant Officer,23150,9,9,0
2017,Warrant Officer,23451,2,2,0
2017,Warrant Officer,23824,2,2,0
2017,Warrant Officer,23847,1,1,0
2017,Warrant Officer,24251,1,1,0
2017,Warrant Officer,24401,1,1,0
2017,Warrant Officer,25168,1,1,0
2017,Warrant Officer,25530,1,1,0
2017,Warrant Officer,26003,2,2,0
2017,Warrant Officer,26187,1,1,0
2017,Warrant Officer,26330,1,1,0
2017,Warrant Officer,26505,1,1,0
2017,Warrant Officer,26537,2,2,0
2017,Warrant Officer,27401,2,2,0
2017,Warrant Officer,27560,4,4,0
2017,Warrant Officer,27870,2,2,0
2017,Warrant Officer,28147,3,3,0
2017,Warrant Officer,28310,2,2,0
2017,Warrant Officer,28328,1,1,0
2017,Warrant Officer,28658,1,1,0
2017,Warrant Officer,29044,8,8,0
2017,Warrant Officer,29201,1,1,0
2017,Warrant Officer,29303,2,2,0
2017,Warrant Officer,29403,1,1,0
2017,Warrant Officer,29440,1,1,0
2017,Warrant Officer,29605,2,2,0
2017,Warrant Officer,29732,1,1,0
2017,Warrant Officer,29824,1,1,0
2017,Warrant Officer,30060,9,9,0
2017,Warrant Officer,30069,1,1,0
2017,Warrant Officer,30144,1,1,0
2017,Warrant Officer,30297,2,2,0
2017,Warrant Officer,30680,1,1,0
2017,Warrant Officer,31211,1,1,0
2017,Warrant Officer,31313,2,2,0
2017,Warrant Officer,31409,4,4,0
2017,Warrant Officer,31901,1,1,0
2017,Warrant Officer,32086,1,1,0
2017,Warrant Officer,32091,2,2,0
2017,Warrant Officer,32164,2,2,0
2017,Warrant Officer,33127,1,1,0
2017,Warrant Officer,33315,1,1,0
2017,Warrant Officer,33782,3,3,0
2017,Warrant Officer,34604,3,3,0
2017,Warrant Officer,35042,1,1,0
2017,Warrant Officer,35072,1,1,0
2017,Warrant Officer,35178,1,1,0
2017,Warrant Officer,35209,1,1,0
2017,Warrant Officer,35217,7,7,0
2017,Warrant Officer,35405,1,1,0
2017,Warrant Officer,35476,1,1,0
2017,Warrant Officer,36043,3,3,0
2017,Warrant Officer,36117,1,1,0
2017,Warrant Officer,36203,2,2,0
2017,Warrant Officer,36250,1,1,0
2017,Warrant Officer,36608,1,1,0
2017,Warrant Officer,36801,1,1,0
2017,Warrant Officer,36832,2,2,0
2017,Warrant Officer,37204,2,2,0
2017,Warrant Officer,37217,1,1,0
2017,Warrant Officer,37303,1,1,0
2017,Warrant Officer,37388,1,1,0
2017,Warrant Officer,37398,1,1,0
2017,Warrant Officer,37650,1,1,0
2017,Warrant Officer,37777,3,3,0
2017,Warrant Officer,37919,2,2,0
2017,Warrant Officer,38118,1,1,0
2017,Warrant Officer,38242,1,1,0
2017,Warrant Officer,38301,6,6,0
2017,Warrant Officer,38401,2,2,0
2017,Warrant Officer,38801,2,2,0
2017,Warrant Officer,38803,1,1,0
2017,Warrant Officer,38901,1,1,0
2017,Warrant Officer,38915,1,1,0
2017,Warrant Officer,39209,1,1,0
2017,Warrant Officer,39216,1,1,0
2017,Warrant Officer,39296,2,2,0
2017,Warrant Officer,39307,1,1,0
2017,Warrant Officer,39345,1,1,0
2017,Warrant Officer,39407,4,4,0
2017,Warrant Officer,39505,1,1,0
2017,Warrant Officer,39507,1,1,0
2017,Warrant Officer,39773,1,1,0
2017,Warrant Officer,40205,1,1,0
2017,Warrant Officer,40330,1,1,0
2017,Warrant Officer,40422,1,1,0
2017,Warrant Officer,40475,2,2,0
2017,Warrant Officer,40510,4,4,0
2017,Warrant Officer,40601,14,14,0
2017,Warrant Officer,43213,2,2,0
2017,Warrant Officer,43217,3,3,0
2017,Warrant Officer,43235,1,1,0
2017,Warrant Officer,43756,1,1,0
2017,Warrant Officer,44128,1,1,0
2017,Warrant Officer,44256,1,1,0
2017,Warrant Officer,44720,2,2,0
2017,Warrant Officer,44903,1,1,0
2017,Warrant Officer,45215,1,1,0
2017,Warrant Officer,45502,1,1,0
2017,Warrant Officer,46176,7,7,0
2017,Warrant Officer,46216,2,2,0
2017,Warrant Officer,46241,5,5,0
2017,Warrant Officer,46360,1,1,0
2017,Warrant Officer,46406,1,1,0
2017,Warrant Officer,46901,1,1,0
2017,Warrant Officer,47203,1,1,0
2017,Warrant Officer,48045,3,3,0
2017,Warrant Officer,48180,1,1,0
2017,Warrant Officer,48197,1,1,0
2017,Warrant Officer,48837,3,3,0
2017,Warrant Officer,48906,1,1,0
2017,Warrant Officer,49012,1,1,0
2017,Warrant Officer,50036,2,2,0
2017,Warrant Officer,50131,3,3,0
2017,Warrant Officer,50703,2,2,0
2017,Warrant Officer,52246,1,1,0
2017,Warrant Officer,52577,1,1,0
2017,Warrant Officer,53121,1,1,0
2017,Warrant Officer,53144,1,1,0
2017,Warrant Officer,53704,11,11,0
2017,Warrant Officer,54618,2,2,0
2017,Warrant Officer,54656,1,1,0
2017,Warrant Officer,54981,1,1,0
2017,Warrant Officer,55068,2,2,0
2017,Warrant Officer,55107,3,3,0
2017,Warrant Officer,55112,2,2,0
2017,Warrant Officer,55443,1,1,0
2017,Warrant Officer,56303,2,2,0
2017,Warrant Officer,56345,4,4,0
2017,Warrant Officer,57201,2,2,0
2017,Warrant Officer,57702,2,2,0
2017,Warrant Officer,57703,2,2,0
2017,Warrant Officer,58102,1,1,0
2017,Warrant Officer,58421,1,1,0
2017,Warrant Officer,58506,6,6,0
2017,Warrant Officer,59102,4,4,0
2017,Warrant Officer,59602,4,4,0
2017,Warrant Officer,59636,1,1,0
2017,Warrant Officer,59701,1,1,0
2017,Warrant Officer,59711,2,2,0
2017,Warrant Officer,59808,1,1,0
2017,Warrant Officer,59901,1,1,0
2017,Warrant Officer,60616,1,1,0
2017,Warrant Officer,60638,4,4,0
2017,Warrant Officer,60651,2,2,0
2017,Warrant Officer,61701,1,1,0
2017,Warrant Officer,61761,2,2,0
2017,Warrant Officer,61801,2,2,0
2017,Warrant Officer,61938,1,1,0
2017,Warrant Officer,62521,1,1,0
2017,Warrant Officer,63552,1,1,0
2017,Warrant Officer,63645,1,1,0
2017,Warrant Officer,63901,1,1,0
2017,Warrant Officer,64129,1,1,0
2017,Warrant Officer,64506,1,1,0
2017,Warrant Officer,64804,1,1,0
2017,Warrant Officer,65101,1,1,0
2017,Warrant Officer,65301,3,3,0
2017,Warrant Officer,65305,5,5,0
2017,Warrant Officer,65473,3,3,0
2017,Warrant Officer,65723,2,2,0
2017,Warrant Officer,65803,1,1,0
2017,Warrant Officer,66061,1,1,0
2017,Warrant Officer,66067,1,1,0
2017,Warrant Officer,66502,3,3,0
2017,Warrant Officer,66611,1,1,0
2017,Warrant Officer,66619,4,4,0
2017,Warrant Officer,66762,1,1,0
2017,Warrant Officer,68066,1,1,0
2017,Warrant Officer,68142,1,1,0
2017,Warrant Officer,68508,1,1,0
2017,Warrant Officer,68524,4,4,0
2017,Warrant Officer,68601,1,1,0
2017,Warrant Officer,68801,2,2,0
2017,Warrant Officer,68847,1,1,0
2017,Warrant Officer,68901,1,1,0
2017,Warrant Officer,70117,3,3,0
2017,Warrant Officer,70401,6,6,0
2017,Warrant Officer,70403,1,1,0
2017,Warrant Officer,70508,1,1,0
2017,Warrant Officer,71111,1,1,0
2017,Warrant Officer,71360,10,10,0
2017,Warrant Officer,71417,1,1,0
2017,Warrant Officer,72199,11,11,0
2017,Warrant Officer,72653,1,1,0
2017,Warrant Officer,72701,1,1,0
2017,Warrant Officer,72905,1,1,0
2017,Warrant Officer,73051,2,2,0
2017,Warrant Officer,73064,4,4,0
2017,Warrant Officer,73069,2,2,0
2017,Warrant Officer,73111,2,2,0
2017,Warrant Officer,73179,1,1,0
2017,Warrant Officer,74014,1,1,0
2017,Warrant Officer,74116,1,1,0
2017,Warrant Officer,74158,1,1,0
2017,Warrant Officer,74423,2,2,0
2017,Warrant Officer,75051,1,1,0
2017,Warrant Officer,76067,1,1,0
2017,Warrant Officer,76502,1,1,0
2017,Warrant Officer,77034,5,5,0
2017,Warrant Officer,77082,1,1,0
2017,Warrant Officer,78155,1,1,0
2017,Warrant Officer,78218,3,3,0
2017,Warrant Officer,78219,2,2,0
2017,Warrant Officer,78257,1,1,0
2017,Warrant Officer,78596,1,1,0
2017,Warrant Officer,78602,1,1,0
2017,Warrant Officer,78617,1,1,0
2017,Warrant Officer,78665,2,2,0
2017,Warrant Officer,78703,3,3,0
2017,Warrant Officer,79607,1,1,0
2017,Warrant Officer,79936,1,1,0
2017,Warrant Officer,80011,7,7,0
2017,Warrant Officer,80112,6,6,0
2017,Warrant Officer,80216,2,2,0
2017,Warrant Officer,80913,2,2,0
2017,Warrant Officer,82005,2,2,0
2017,Warrant Officer,82604,1,1,0
2017,Warrant Officer,83676,1,1,0
2017,Warrant Officer,83705,6,6,0
2017,Warrant Officer,84020,1,1,0
2017,Warrant Officer,84058,1,1,0
2017,Warrant Officer,84065,7,7,0
2017,Warrant Officer,84084,16,16,0
2017,Warrant Officer,84770,2,2,0
2017,Warrant Officer,85008,3,3,0
2017,Warrant Officer,85132,1,1,0
2017,Warrant Officer,85653,5,5,0
2017,Warrant Officer,87144,2,2,0
2017,Warrant Officer,87508,2,2,0
2017,Warrant Officer,87701,1,1,0
2017,Warrant Officer,88007,1,1,0
2017,Warrant Officer,88203,2,2,0
2017,Warrant Officer,89032,3,3,0
2017,Warrant Officer,89139,2,2,0
2017,Warrant Officer,89506,1,1,0
2017,Warrant Officer,89701,1,1,0
2017,Warrant Officer,90720,10,10,0
2017,Warrant Officer,90822,3,3,0
2017,Warrant Officer,92111,2,2,0
2017,Warrant Officer,93405,1,1,0
2017,Warrant Officer,93727,1,1,0
2017,Warrant Officer,94132,1,1,0
2017,Warrant Officer,94510,1,1,0
2017,Warrant Officer,95206,3,3,0
2017,Warrant Officer,95655,2,2,0
2017,Warrant Officer,95678,1,1,0
2017,Warrant Officer,95826,1,1,0
2017,Warrant Officer,96707,3,3,0
2017,Warrant Officer,96720,1,1,0
2017,Warrant Officer,96816,1,1,0
2017,Warrant Officer,96857,1,1,0
2017,Warrant Officer,97015,3,3,0
2017,Warrant Officer,97211,1,1,0
2017,Warrant Officer,97217,1,1,0
2017,Warrant Officer,97302,2,2,0
2017,Warrant Officer,97309,2,2,0
2017,Warrant Officer,98119,1,1,0
2017,Warrant Officer,98290,2,2,0
2017,Warrant Officer,98321,1,1,0
2017,Warrant Officer,98430,1,1,0
2017,Warrant Officer,98433,5,5,0
2017,Warrant Officer,98501,1,1,0
2017,Warrant Officer,98901,2,2,0
2017,Warrant Officer,98903,1,1,0
2017,Warrant Officer,99011,1,1,0
2017,Warrant Officer,99505,8,8,0
2017,Warrant Officer,99731,1,1,0
2017,Warrant Officer,99762,1,1,0
2018,Enlisted,00604,20,5,15
2018,Enlisted,00612,2,1,1
2018,Enlisted,00623,9,5,4
2018,Enlisted,00624,6,0,6
2018,Enlisted,00641,19,9,10
2018,Enlisted,00682,22,3,19
2018,Enlisted,00683,8,1,7
2018,Enlisted,00693,32,1,31
2018,Enlisted,00705,14,2,12
2018,Enlisted,00714,16,1,15
2018,Enlisted,00725,20,2,18
2018,Enlisted,00733,4,2,2
2018,Enlisted,00735,17,1,16
2018,Enlisted,00736,38,5,33
2018,Enlisted,00751,49,8,41
2018,Enlisted,00769,8,3,5
2018,Enlisted,00785,2,0,2
2018,Enlisted,00792,14,0,14
2018,Enlisted,00795,148,8,140
2018,Enlisted,00802,5,3,2
2018,Enlisted,00850,33,13,20
2018,Enlisted,00901,12,2,10
2018,Enlisted,00907,1,0,1
2018,Enlisted,00934,81,6,75
2018,Enlisted,00951,2,0,2
2018,Enlisted,01013,11,7,4
2018,Enlisted,01022,2,2,0
2018,Enlisted,01030,9,4,5
2018,Enlisted,01062,1,1,0
2018,Enlisted,01082,20,5,15
2018,Enlisted,01085,13,3,10
2018,Enlisted,01109,25,6,19
2018,Enlisted,01201,8,2,6
2018,Enlisted,01301,7,1,6
2018,Enlisted,01434,46,12,34
2018,Enlisted,01440,3,1,2
2018,Enlisted,01453,12,0,12
2018,Enlisted,01588,8,5,3
2018,Enlisted,01605,67,11,56
2018,Enlisted,01702,42,3,39
2018,Enlisted,01731,6,0,6
2018,Enlisted,01760,11,2,9
2018,Enlisted,01844,30,7,23
2018,Enlisted,01867,34,5,29
2018,Enlisted,01923,13,2,11
2018,Enlisted,01950,9,1,8
2018,Enlisted,02043,31,7,24
2018,Enlisted,02122,20,6,14
2018,Enlisted,02138,17,6,11
2018,Enlisted,02169,3,1,2
2018,Enlisted,02176,31,11,20
2018,Enlisted,02184,24,4,20
2018,Enlisted,02301,18,6,12
2018,Enlisted,02324,2,0,2
2018,Enlisted,02346,6,3,3
2018,Enlisted,02420,5,2,3
2018,Enlisted,02465,2,2,0
2018,Enlisted,02532,24,4,20
2018,Enlisted,02542,53,10,43
2018,Enlisted,02724,10,4,6
2018,Enlisted,02769,15,1,14
2018,Enlisted,02780,16,2,14
2018,Enlisted,02809,9,2,7
2018,Enlisted,02818,133,45,88
2018,Enlisted,02842,14,10,4
2018,Enlisted,02852,18,4,14
2018,Enlisted,02885,15,1,14
2018,Enlisted,02886,18,6,12
2018,Enlisted,02896,4,1,3
2018,Enlisted,02904,17,2,15
2018,Enlisted,02906,1,0,1
2018,Enlisted,03055,42,12,30
2018,Enlisted,03060,20,0,20
2018,Enlisted,03101,29,11,18
2018,Enlisted,03235,13,3,10
2018,Enlisted,03244,17,0,17
2018,Enlisted,03264,15,3,12
2018,Enlisted,03301,40,19,21
2018,Enlisted,03561,4,0,4
2018,Enlisted,03570,7,1,6
2018,Enlisted,03766,11,5,6
2018,Enlisted,03801,9,3,6
2018,Enlisted,03878,7,2,5
2018,Enlisted,04011,28,10,18
2018,Enlisted,04073,5,3,2
2018,Enlisted,04092,14,3,11
2018,Enlisted,04240,24,3,21
2018,Enlisted,04268,29,3,26
2018,Enlisted,04330,20,6,14
2018,Enlisted,04333,6,2,4
2018,Enlisted,04401,35,8,27
2018,Enlisted,04412,19,7,12
2018,Enlisted,04619,1,0,1
2018,Enlisted,04730,4,1,3
2018,Enlisted,04736,7,1,6
2018,Enlisted,04901,36,8,28
2018,Enlisted,04915,5,4,1
2018,Enlisted,04976,15,4,11
2018,Enlisted,05001,7,3,4
2018,Enlisted,05033,6,0,6
2018,Enlisted,05158,21,2,19
2018,Enlisted,05201,13,5,8
2018,Enlisted,05403,5,2,3
2018,Enlisted,05404,5,2,3
2018,Enlisted,05446,15,10,5
2018,Enlisted,05450,2,2,0
2018,Enlisted,05465,40,17,23
2018,Enlisted,05478,6,4,2
2018,Enlisted,05488,10,2,8
2018,Enlisted,05491,15,5,10
2018,Enlisted,05495,15,6,9
2018,Enlisted,05602,6,2,4
2018,Enlisted,05661,7,2,5
2018,Enlisted,05663,30,7,23
2018,Enlisted,05676,15,3,12
2018,Enlisted,05701,12,4,8
2018,Enlisted,05851,26,4,22
2018,Enlisted,05855,6,0,6
2018,Enlisted,06051,42,21,21
2018,Enlisted,06066,2,2,0
2018,Enlisted,06082,26,9,17
2018,Enlisted,06096,48,6,42
2018,Enlisted,06110,29,6,23
2018,Enlisted,06320,42,9,33
2018,Enlisted,06333,2,2,0
2018,Enlisted,06340,21,10,11
2018,Enlisted,06357,35,6,29
2018,Enlisted,06360,20,6,14
2018,Enlisted,06457,92,30,62
2018,Enlisted,06489,15,5,10
2018,Enlisted,06498,17,4,13
2018,Enlisted,06512,30,11,19
2018,Enlisted,06614,20,4,16
2018,Enlisted,06702,1,0,1
2018,Enlisted,06810,41,14,27
2018,Enlisted,07052,40,11,29
2018,Enlisted,07090,12,2,10
2018,Enlisted,07095,36,15,21
2018,Enlisted,07107,21,8,13
2018,Enlisted,07306,53,21,32
2018,Enlisted,07457,39,9,30
2018,Enlisted,07666,72,16,56
2018,Enlisted,07728,31,8,23
2018,Enlisted,07801,31,14,17
2018,Enlisted,07840,8,1,7
2018,Enlisted,07865,25,6,19
2018,Enlisted,07960,48,8,40
2018,Enlisted,08002,54,8,46
2018,Enlisted,08012,23,4,19
2018,Enlisted,08037,8,2,6
2018,Enlisted,08060,17,8,9
2018,Enlisted,08096,22,7,15
2018,Enlisted,08098,15,5,10
2018,Enlisted,08210,22,1,21
2018,Enlisted,08360,23,4,19
2018,Enlisted,08401,9,0,9
2018,Enlisted,08533,2,0,2
2018,Enlisted,08640,3,3,0
2018,Enlisted,08648,14,9,5
2018,Enlisted,08733,52,13,39
2018,Enlisted,08750,11,5,6
2018,Enlisted,08753,15,4,11
2018,Enlisted,08759,11,3,8
2018,Enlisted,08822,3,2,1
2018,Enlisted,08873,61,12,49
2018,Enlisted,09096,1,0,1
2018,Enlisted,10010,143,40,103
2018,Enlisted,10021,2,1,1
2018,Enlisted,10314,45,17,28
2018,Enlisted,10468,15,1,14
2018,Enlisted,10566,18,4,14
2018,Enlisted,10567,89,19,70
2018,Enlisted,10701,38,7,31
2018,Enlisted,10962,14,5,9
2018,Enlisted,11252,58,8,50
2018,Enlisted,11357,10,2,8
2018,Enlisted,11433,78,17,61
2018,Enlisted,11735,49,22,27
2018,Enlisted,11779,24,4,20
2018,Enlisted,12078,14,4,10
2018,Enlisted,12110,50,12,38
2018,Enlisted,12180,36,12,24
2018,Enlisted,12189,17,10,7
2018,Enlisted,12302,31,6,25
2018,Enlisted,12401,5,1,4
2018,Enlisted,12451,8,4,4
2018,Enlisted,12553,23,13,10
2018,Enlisted,12804,32,6,26
2018,Enlisted,12962,4,2,2
2018,Enlisted,13021,17,3,14
2018,Enlisted,13211,40,8,32
2018,Enlisted,13501,37,10,27
2018,Enlisted,13602,15,6,9
2018,Enlisted,13669,5,2,3
2018,Enlisted,13856,5,0,5
2018,Enlisted,13905,27,6,21
2018,Enlisted,14048,8,0,8
2018,Enlisted,14094,24,2,22
2018,Enlisted,14204,41,12,29
2018,Enlisted,14213,56,7,49
2018,Enlisted,14304,13,4,9
2018,Enlisted,14454,17,5,12
2018,Enlisted,14456,28,2,26
2018,Enlisted,14624,64,16,48
2018,Enlisted,14701,13,0,13
2018,Enlisted,14760,2,1,1
2018,Enlisted,14843,14,2,12
2018,Enlisted,14845,14,0,14
2018,Enlisted,14850,13,4,9
2018,Enlisted,15010,29,1,28
2018,Enlisted,15216,35,5,30
2018,Enlisted,15301,15,2,13
2018,Enlisted,15370,18,3,15
2018,Enlisted,15425,6,4,2
2018,Enlisted,15444,19,2,17
2018,Enlisted,15537,1,0,1
2018,Enlisted,15541,11,3,8
2018,Enlisted,15601,6,2,4
2018,Enlisted,15666,18,1,17
2018,Enlisted,15701,13,2,11
2018,Enlisted,15767,7,3,4
2018,Enlisted,15779,4,2,2
2018,Enlisted,15902,11,4,7
2018,Enlisted,15904,92,9,83
2018,Enlisted,16001,29,7,22
2018,Enlisted,16101,26,5,21
2018,Enlisted,16127,27,2,25
2018,Enlisted,16148,11,2,9
2018,Enlisted,16226,4,2,2
2018,Enlisted,16403,45,6,39
2018,Enlisted,16635,23,2,21
2018,Enlisted,16652,4,0,4
2018,Enlisted,16738,7,0,7
2018,Enlisted,16803,32,8,24
2018,Enlisted,16830,3,1,2
2018,Enlisted,16901,2,1,1
2018,Enlisted,17003,198,40,158
2018,Enlisted,17013,29,3,26
2018,Enlisted,17022,24,4,20
2018,Enlisted,17033,2,2,0
2018,Enlisted,17042,13,3,10
2018,Enlisted,17044,27,4,23
2018,Enlisted,17098,4,1,3
2018,Enlisted,17103,30,6,24
2018,Enlisted,17201,11,0,11
2018,Enlisted,17222,4,2,2
2018,Enlisted,17325,8,1,7
2018,Enlisted,17331,9,1,8
2018,Enlisted,17701,19,2,17
2018,Enlisted,17745,8,0,8
2018,Enlisted,17821,6,2,4
2018,Enlisted,17837,6,5,1
2018,Enlisted,18040,34,4,30
2018,Enlisted,18102,16,0,16
2018,Enlisted,18201,5,0,5
2018,Enlisted,18235,14,1,13
2018,Enlisted,18252,12,1,11
2018,Enlisted,18301,11,0,11
2018,Enlisted,18407,6,1,5
2018,Enlisted,18431,15,3,12
2018,Enlisted,18466,6,1,5
2018,Enlisted,18509,33,6,27
2018,Enlisted,18634,2,1,1
2018,Enlisted,18651,1,0,1
2018,Enlisted,18704,12,0,12
2018,Enlisted,18834,4,2,2
2018,Enlisted,18960,7,3,4
2018,Enlisted,19044,64,22,42
2018,Enlisted,19103,14,5,9
2018,Enlisted,19153,36,4,32
2018,Enlisted,19154,104,29,75
2018,Enlisted,19320,30,5,25
2018,Enlisted,19460,5,0,5
2018,Enlisted,19462,37,7,30
2018,Enlisted,19475,16,3,13
2018,Enlisted,19526,8,3,5
2018,Enlisted,19530,30,17,13
2018,Enlisted,19605,23,3,20
2018,Enlisted,19706,28,6,22
2018,Enlisted,19711,26,6,20
2018,Enlisted,19720,17,3,14
2018,Enlisted,19804,25,3,22
2018,Enlisted,19808,8,3,5
2018,Enlisted,19939,20,1,19
2018,Enlisted,19947,18,5,13
2018,Enlisted,19973,30,7,23
2018,Enlisted,19977,9,5,4
2018,Enlisted,20003,22,14,8
2018,Enlisted,20112,39,9,30
2018,Enlisted,20175,16,6,10
2018,Enlisted,20186,7,1,6
2018,Enlisted,20373,35,19,16
2018,Enlisted,20623,3,1,2
2018,Enlisted,20646,13,1,12
2018,Enlisted,20653,5,3,2
2018,Enlisted,20708,35,22,13
2018,Enlisted,20783,3,0,3
2018,Enlisted,20882,7,5,2
2018,Enlisted,20904,8,2,6
2018,Enlisted,21010,51,21,30
2018,Enlisted,21043,21,3,18
2018,Enlisted,21057,17,6,11
2018,Enlisted,21061,17,13,4
2018,Enlisted,21078,5,2,3
2018,Enlisted,21136,35,18,17
2018,Enlisted,21157,8,1,7
2018,Enlisted,21201,3,2,1
2018,Enlisted,21204,6,5,1
2018,Enlisted,21216,16,2,14
2018,Enlisted,21222,17,7,10
2018,Enlisted,21228,32,7,25
2018,Enlisted,21236,13,3,10
2018,Enlisted,21401,26,12,14
2018,Enlisted,21601,5,3,2
2018,Enlisted,21657,4,1,3
2018,Enlisted,21701,16,7,9
2018,Enlisted,21719,2,0,2
2018,Enlisted,21740,6,2,4
2018,Enlisted,21801,16,3,13
2018,Enlisted,21921,5,3,2
2018,Enlisted,22032,5,2,3
2018,Enlisted,22060,47,23,24
2018,Enlisted,22401,55,4,51
2018,Enlisted,22427,11,4,7
2018,Enlisted,22601,4,0,4
2018,Enlisted,22602,11,5,6
2018,Enlisted,22664,15,2,13
2018,Enlisted,22801,8,1,7
2018,Enlisted,22902,21,5,16
2018,Enlisted,23069,6,1,5
2018,Enlisted,23139,18,8,10
2018,Enlisted,23150,40,7,33
2018,Enlisted,23181,13,0,13
2018,Enlisted,23237,9,2,7
2018,Enlisted,23417,6,2,4
2018,Enlisted,23434,6,1,5
2018,Enlisted,23451,97,24,73
2018,Enlisted,23502,35,5,30
2018,Enlisted,23666,23,4,19
2018,Enlisted,23701,16,4,12
2018,Enlisted,23805,22,9,13
2018,Enlisted,23824,32,9,23
2018,Enlisted,23847,9,4,5
2018,Enlisted,23851,2,2,0
2018,Enlisted,23901,2,0,2
2018,Enlisted,24073,23,6,17
2018,Enlisted,24112,5,0,5
2018,Enlisted,24151,25,8,17
2018,Enlisted,24175,3,0,3
2018,Enlisted,24210,3,0,3
2018,Enlisted,24212,3,0,3
2018,Enlisted,24251,21,5,16
2018,Enlisted,24301,3,0,3
2018,Enlisted,24401,11,5,6
2018,Enlisted,24450,24,2,22
2018,Enlisted,24502,19,6,13
2018,Enlisted,24523,24,1,23
2018,Enlisted,24540,11,5,6
2018,Enlisted,24541,2,0,2
2018,Enlisted,24609,10,2,8
2018,Enlisted,24701,7,2,5
2018,Enlisted,24957,7,3,4
2018,Enlisted,25168,39,9,30
2018,Enlisted,25177,2,2,0
2018,Enlisted,25262,7,2,5
2018,Enlisted,25309,1,1,0
2018,Enlisted,25311,3,1,2
2018,Enlisted,25401,7,3,4
2018,Enlisted,25405,15,5,10
2018,Enlisted,25530,40,22,18
2018,Enlisted,25550,33,4,29
2018,Enlisted,25625,22,2,20
2018,Enlisted,25846,64,6,58
2018,Enlisted,26003,5,1,4
2018,Enlisted,26041,39,2,37
2018,Enlisted,26101,35,8,27
2018,Enlisted,26187,7,4,3
2018,Enlisted,26201,7,1,6
2018,Enlisted,26250,12,2,10
2018,Enlisted,26301,19,2,17
2018,Enlisted,26426,9,1,8
2018,Enlisted,26505,5,1,4
2018,Enlisted,26508,7,1,6
2018,Enlisted,26537,28,14,14
2018,Enlisted,26554,11,1,10
2018,Enlisted,26624,11,0,11
2018,Enlisted,26651,11,2,9
2018,Enlisted,26836,4,1,3
2018,Enlisted,27028,3,1,2
2018,Enlisted,27030,8,0,8
2018,Enlisted,27103,44,5,39
2018,Enlisted,27204,5,1,4
2018,Enlisted,27217,33,9,24
2018,Enlisted,27260,15,4,11
2018,Enlisted,27264,26,6,20
2018,Enlisted,27292,10,0,10
2018,Enlisted,27320,17,4,13
2018,Enlisted,27344,5,2,3
2018,Enlisted,27360,2,1,1
2018,Enlisted,27401,27,11,16
2018,Enlisted,27504,28,11,17
2018,Enlisted,27509,11,2,9
2018,Enlisted,27530,28,16,12
2018,Enlisted,27549,4,0,4
2018,Enlisted,27557,10,7,3
2018,Enlisted,27560,71,24,47
2018,Enlisted,27573,2,0,2
2018,Enlisted,27577,1,0,1
2018,Enlisted,27581,2,0,2
2018,Enlisted,27596,20,1,19
2018,Enlisted,27607,44,16,28
2018,Enlisted,27704,36,11,25
2018,Enlisted,27828,4,1,3
2018,Enlisted,27830,2,1,1
2018,Enlisted,27870,9,9,0
2018,Enlisted,27874,1,0,1
2018,Enlisted,27886,1,1,0
2018,Enlisted,27889,1,1,0
2018,Enlisted,27892,2,0,2
2018,Enlisted,27897,1,1,0
2018,Enlisted,27932,4,1,3
2018,Enlisted,28001,16,14,2
2018,Enlisted,28012,9,3,6
2018,Enlisted,28027,26,7,19
2018,Enlisted,28043,2,0,2
2018,Enlisted,28054,6,2,4
2018,Enlisted,28086,9,1,8
2018,Enlisted,28092,21,1,20
2018,Enlisted,28110,22,1,21
2018,Enlisted,28115,4,0,4
2018,Enlisted,28147,16,10,6
2018,Enlisted,28170,19,4,15
2018,Enlisted,28208,47,13,34
2018,Enlisted,28306,17,10,7
2018,Enlisted,28310,27,14,13
2018,Enlisted,28328,6,4,2
2018,Enlisted,28334,26,14,12
2018,Enlisted,28337,8,0,8
2018,Enlisted,28345,23,1,22
2018,Enlisted,28352,31,5,26
2018,Enlisted,28359,33,20,13
2018,Enlisted,28371,3,1,2
2018,Enlisted,28376,34,8,26
2018,Enlisted,28377,13,2,11
2018,Enlisted,28379,13,5,8
2018,Enlisted,28382,10,1,9
2018,Enlisted,28384,13,3,10
2018,Enlisted,28387,2,1,1
2018,Enlisted,28388,11,3,8
2018,Enlisted,28401,3,2,1
2018,Enlisted,28405,15,5,10
2018,Enlisted,28470,7,2,5
2018,Enlisted,28472,9,4,5
2018,Enlisted,28504,9,0,9
2018,Enlisted,28518,5,2,3
2018,Enlisted,28540,15,5,10
2018,Enlisted,28560,15,2,13
2018,Enlisted,28577,11,3,8
2018,Enlisted,28590,18,5,13
2018,Enlisted,28601,4,0,4
2018,Enlisted,28607,14,4,10
2018,Enlisted,28621,5,0,5
2018,Enlisted,28640,2,2,0
2018,Enlisted,28645,27,7,20
2018,Enlisted,28655,6,5,1
2018,Enlisted,28658,10,1,9
2018,Enlisted,28659,7,3,4
2018,Enlisted,28681,9,3,6
2018,Enlisted,28726,22,15,7
2018,Enlisted,28734,27,6,21
2018,Enlisted,28752,7,4,3
2018,Enlisted,28806,17,8,9
2018,Enlisted,29006,34,4,30
2018,Enlisted,29020,20,3,17
2018,Enlisted,29044,135,54,81
2018,Enlisted,29102,13,2,11
2018,Enlisted,29108,33,4,29
2018,Enlisted,29115,17,1,16
2018,Enlisted,29138,25,8,17
2018,Enlisted,29151,14,6,8
2018,Enlisted,29161,7,2,5
2018,Enlisted,29170,10,4,6
2018,Enlisted,29201,6,2,4
2018,Enlisted,29303,20,7,13
2018,Enlisted,29325,7,1,6
2018,Enlisted,29341,7,1,6
2018,Enlisted,29360,19,5,14
2018,Enlisted,29379,25,13,12
2018,Enlisted,29385,29,4,25
2018,Enlisted,29403,17,2,15
2018,Enlisted,29409,4,2,2
2018,Enlisted,29418,79,16,63
2018,Enlisted,29440,12,2,10
2018,Enlisted,29461,37,6,31
2018,Enlisted,29464,27,12,15
2018,Enlisted,29488,36,20,16
2018,Enlisted,29506,3,2,1
2018,Enlisted,29510,23,3,20
2018,Enlisted,29512,14,3,11
2018,Enlisted,29526,3,0,3
2018,Enlisted,29532,13,2,11
2018,Enlisted,29536,3,3,0
2018,Enlisted,29544,13,1,12
2018,Enlisted,29550,17,5,12
2018,Enlisted,29556,21,3,18
2018,Enlisted,29571,7,2,5
2018,Enlisted,29574,40,0,40
2018,Enlisted,29577,4,1,3
2018,Enlisted,29605,45,11,34
2018,Enlisted,29620,23,1,22
2018,Enlisted,29625,16,6,10
2018,Enlisted,29641,4,3,1
2018,Enlisted,29644,24,4,20
2018,Enlisted,29646,26,6,20
2018,Enlisted,29651,14,1,13
2018,Enlisted,29653,5,1,4
2018,Enlisted,29678,40,8,32
2018,Enlisted,29706,30,1,29
2018,Enlisted,29715,30,18,12
2018,Enlisted,29720,18,3,15
2018,Enlisted,29732,29,5,24
2018,Enlisted,29810,4,1,3
2018,Enlisted,29812,6,0,6
2018,Enlisted,29824,22,2,20
2018,Enlisted,29829,28,0,28
2018,Enlisted,29835,14,0,14
2018,Enlisted,29906,31,4,27
2018,Enlisted,29944,14,2,12
2018,Enlisted,30014,12,7,5
2018,Enlisted,30032,15,5,10
2018,Enlisted,30040,86,20,66
2018,Enlisted,30046,32,6,26
2018,Enlisted,30060,144,54,90
2018,Enlisted,30069,90,27,63
2018,Enlisted,30114,14,7,7
2018,Enlisted,30125,12,3,9
2018,Enlisted,30134,22,5,17
2018,Enlisted,30144,87,22,65
2018,Enlisted,30161,41,15,26
2018,Enlisted,30224,27,15,12
2018,Enlisted,30233,21,11,10
2018,Enlisted,30240,55,14,41
2018,Enlisted,30263,33,16,17
2018,Enlisted,30294,44,20,24
2018,Enlisted,30297,69,31,38
2018,Enlisted,30336,92,33,59
2018,Enlisted,30401,23,2,21
2018,Enlisted,30427,33,11,22
2018,Enlisted,30439,25,10,15
2018,Enlisted,30460,4,0,4
2018,Enlisted,30461,7,3,4
2018,Enlisted,30501,16,8,8
2018,Enlisted,30577,17,1,16
2018,Enlisted,30597,1,0,1
2018,Enlisted,30635,11,2,9
2018,Enlisted,30643,7,1,6
2018,Enlisted,30655,48,22,26
2018,Enlisted,30673,39,12,27
2018,Enlisted,30680,77,23,54
2018,Enlisted,30701,32,11,21
2018,Enlisted,30720,18,8,10
2018,Enlisted,30824,6,3,3
2018,Enlisted,30830,8,4,4
2018,Enlisted,30904,63,34,29
2018,Enlisted,30905,44,10,34
2018,Enlisted,31015,18,6,12
2018,Enlisted,31029,45,14,31
2018,Enlisted,31040,24,12,12
2018,Enlisted,31061,39,7,32
2018,Enlisted,31211,51,25,26
2018,Enlisted,31313,14,7,7
2018,Enlisted,31314,63,19,44
2018,Enlisted,31329,15,3,12
2018,Enlisted,31406,68,28,40
2018,Enlisted,31409,28,14,14
2018,Enlisted,31520,9,5,4
2018,Enlisted,31533,25,4,21
2018,Enlisted,31601,20,7,13
2018,Enlisted,31701,2,0,2
2018,Enlisted,31704,5,3,2
2018,Enlisted,31792,48,13,35
2018,Enlisted,31794,12,10,2
2018,Enlisted,31901,6,4,2
2018,Enlisted,31905,28,16,12
2018,Enlisted,32055,21,9,12
2018,Enlisted,32064,10,3,7
2018,Enlisted,32084,17,5,12
2018,Enlisted,32086,38,6,32
2018,Enlisted,32091,75,49,26
2018,Enlisted,32164,18,5,13
2018,Enlisted,32177,6,1,5
2018,Enlisted,32221,77,39,38
2018,Enlisted,32311,19,9,10
2018,Enlisted,32351,18,4,14
2018,Enlisted,32406,12,6,6
2018,Enlisted,32425,9,4,5
2018,Enlisted,32428,5,2,3
2018,Enlisted,32447,32,8,24
2018,Enlisted,32514,32,20,12
2018,Enlisted,32536,8,3,5
2018,Enlisted,32724,17,5,12
2018,Enlisted,32727,10,5,5
2018,Enlisted,32771,28,13,15
2018,Enlisted,32806,36,16,20
2018,Enlisted,32827,7,5,2
2018,Enlisted,32922,9,4,5
2018,Enlisted,32935,24,8,16
2018,Enlisted,33020,2,0,2
2018,Enlisted,33024,1,0,1
2018,Enlisted,33025,26,13,13
2018,Enlisted,33027,38,20,18
2018,Enlisted,33039,16,6,10
2018,Enlisted,33127,25,7,18
2018,Enlisted,33315,19,8,11
2018,Enlisted,33405,20,8,12
2018,Enlisted,33406,34,6,28
2018,Enlisted,33523,16,5,11
2018,Enlisted,33563,13,5,8
2018,Enlisted,33606,10,6,4
2018,Enlisted,33711,17,6,11
2018,Enlisted,33782,58,26,32
2018,Enlisted,33811,37,8,29
2018,Enlisted,33825,3,0,3
2018,Enlisted,33830,16,8,8
2018,Enlisted,33844,6,5,1
2018,Enlisted,33859,24,6,18
2018,Enlisted,33873,2,2,0
2018,Enlisted,33880,14,5,9
2018,Enlisted,33916,10,2,8
2018,Enlisted,34208,14,2,12
2018,Enlisted,34221,9,3,6
2018,Enlisted,34237,21,9,12
2018,Enlisted,34266,17,6,11
2018,Enlisted,34429,27,14,13
2018,Enlisted,34471,5,0,5
2018,Enlisted,34474,23,13,10
2018,Enlisted,34604,4,3,1
2018,Enlisted,34748,33,14,19
2018,Enlisted,35010,31,3,28
2018,Enlisted,35016,20,6,14
2018,Enlisted,35040,2,2,0
2018,Enlisted,35042,47,13,34
2018,Enlisted,35055,52,20,32
2018,Enlisted,35072,6,2,4
2018,Enlisted,35121,44,14,30
2018,Enlisted,35124,23,3,20
2018,Enlisted,35146,2,0,2
2018,Enlisted,35150,15,0,15
2018,Enlisted,35161,28,5,23
2018,Enlisted,35178,9,4,5
2018,Enlisted,35209,5,4,1
2018,Enlisted,35217,57,23,34
2018,Enlisted,35259,2,2,0
2018,Enlisted,35405,14,4,10
2018,Enlisted,35501,15,4,11
2018,Enlisted,35555,8,2,6
2018,Enlisted,35565,28,9,19
2018,Enlisted,35601,26,8,18
2018,Enlisted,35613,7,2,5
2018,Enlisted,35630,9,3,6
2018,Enlisted,35803,41,8,33
2018,Enlisted,35805,29,4,25
2018,Enlisted,35904,26,5,21
2018,Enlisted,35967,11,7,4
2018,Enlisted,36009,4,1,3
2018,Enlisted,36016,1,1,0
2018,Enlisted,36027,3,0,3
2018,Enlisted,36032,27,3,24
2018,Enlisted,36043,46,10,36
2018,Enlisted,36067,12,4,8
2018,Enlisted,36078,17,4,13
2018,Enlisted,36081,17,1,16
2018,Enlisted,36083,4,2,2
2018,Enlisted,36108,1,1,0
2018,Enlisted,36109,21,6,15
2018,Enlisted,36117,3,1,2
2018,Enlisted,36121,9,1,8
2018,Enlisted,36203,21,9,12
2018,Enlisted,36205,38,2,36
2018,Enlisted,36250,7,1,6
2018,Enlisted,36251,13,0,13
2018,Enlisted,36265,29,12,17
2018,Enlisted,36302,19,3,16
2018,Enlisted,36322,5,4,1
2018,Enlisted,36323,14,3,11
2018,Enlisted,36330,47,12,35
2018,Enlisted,36344,12,2,10
2018,Enlisted,36420,1,1,0
2018,Enlisted,36421,7,3,4
2018,Enlisted,36426,10,4,6
2018,Enlisted,36442,3,0,3
2018,Enlisted,36502,13,4,9
2018,Enlisted,36522,43,6,37
2018,Enlisted,36532,21,4,17
2018,Enlisted,36535,26,9,17
2018,Enlisted,36605,52,19,33
2018,Enlisted,36608,4,3,1
2018,Enlisted,36701,3,0,3
2018,Enlisted,36732,12,5,7
2018,Enlisted,36801,6,3,3
2018,Enlisted,36832,9,6,3
2018,Enlisted,36854,34,12,22
2018,Enlisted,36867,6,2,4
2018,Enlisted,37015,4,1,3
2018,Enlisted,37042,23,15,8
2018,Enlisted,37056,20,4,16
2018,Enlisted,37066,20,5,15
2018,Enlisted,37083,1,1,0
2018,Enlisted,37090,4,0,4
2018,Enlisted,37091,3,0,3
2018,Enlisted,37110,24,8,16
2018,Enlisted,37129,50,6,44
2018,Enlisted,37160,3,1,2
2018,Enlisted,37167,89,29,60
2018,Enlisted,37172,18,13,5
2018,Enlisted,37178,12,6,6
2018,Enlisted,37185,10,4,6
2018,Enlisted,37204,64,31,33
2018,Enlisted,37217,40,16,24
2018,Enlisted,37303,7,2,5
2018,Enlisted,37321,7,1,6
2018,Enlisted,37323,20,9,11
2018,Enlisted,37327,9,1,8
2018,Enlisted,37334,1,0,1
2018,Enlisted,37356,9,1,8
2018,Enlisted,37388,16,6,10
2018,Enlisted,37398,10,5,5
2018,Enlisted,37404,28,12,16
2018,Enlisted,37615,4,2,2
2018,Enlisted,37620,14,5,9
2018,Enlisted,37644,7,2,5
2018,Enlisted,37645,11,3,8
2018,Enlisted,37650,4,4,0
2018,Enlisted,37683,3,1,2
2018,Enlisted,37717,12,6,6
2018,Enlisted,37743,7,4,3
2018,Enlisted,37757,4,1,3
2018,Enlisted,37760,6,1,5
2018,Enlisted,37771,23,7,16
2018,Enlisted,37777,52,18,34
2018,Enlisted,37801,4,0,4
2018,Enlisted,37821,15,4,11
2018,Enlisted,37825,4,4,0
2018,Enlisted,37841,9,4,5
2018,Enlisted,37854,10,3,7
2018,Enlisted,37857,2,1,1
2018,Enlisted,37860,9,4,5
2018,Enlisted,37863,3,2,1
2018,Enlisted,37874,17,4,13
2018,Enlisted,37919,13,8,5
2018,Enlisted,37939,5,1,4
2018,Enlisted,38001,11,3,8
2018,Enlisted,38008,11,6,5
2018,Enlisted,38012,20,9,11
2018,Enlisted,38019,20,2,18
2018,Enlisted,38024,5,0,5
2018,Enlisted,38053,25,1,24
2018,Enlisted,38063,15,11,4
2018,Enlisted,38079,1,0,1
2018,Enlisted,38118,60,10,50
2018,Enlisted,38201,11,5,6
2018,Enlisted,38225,3,0,3
2018,Enlisted,38242,6,3,3
2018,Enlisted,38261,14,9,5
2018,Enlisted,38301,13,2,11
2018,Enlisted,38302,21,5,16
2018,Enlisted,38320,4,3,1
2018,Enlisted,38340,10,3,7
2018,Enlisted,38343,8,1,7
2018,Enlisted,38344,14,6,8
2018,Enlisted,38351,18,1,17
2018,Enlisted,38358,10,3,7
2018,Enlisted,38363,6,2,4
2018,Enlisted,38372,4,1,3
2018,Enlisted,38375,10,2,8
2018,Enlisted,38382,31,11,20
2018,Enlisted,38401,11,5,6
2018,Enlisted,38464,2,0,2
2018,Enlisted,38478,5,0,5
2018,Enlisted,38485,2,2,0
2018,Enlisted,38506,9,3,6
2018,Enlisted,38556,19,11,8
2018,Enlisted,38563,1,0,1
2018,Enlisted,38570,16,6,10
2018,Enlisted,38572,4,0,4
2018,Enlisted,38583,4,1,3
2018,Enlisted,38606,10,2,8
2018,Enlisted,38614,4,1,3
2018,Enlisted,38632,2,2,0
2018,Enlisted,38635,2,1,1
2018,Enlisted,38663,4,4,0
2018,Enlisted,38668,58,12,46
2018,Enlisted,38671,49,4,45
2018,Enlisted,38701,24,0,24
2018,Enlisted,38751,4,2,2
2018,Enlisted,38801,54,6,48
2018,Enlisted,38803,10,3,7
2018,Enlisted,38821,31,7,24
2018,Enlisted,38829,5,1,4
2018,Enlisted,38834,2,1,1
2018,Enlisted,38843,2,0,2
2018,Enlisted,38851,21,0,21
2018,Enlisted,38852,6,1,5
2018,Enlisted,38860,14,3,11
2018,Enlisted,38863,6,4,2
2018,Enlisted,38901,17,11,6
2018,Enlisted,38915,22,2,20
2018,Enlisted,38916,15,2,13
2018,Enlisted,38921,2,1,1
2018,Enlisted,38926,2,0,2
2018,Enlisted,38930,4,0,4
2018,Enlisted,38965,6,0,6
2018,Enlisted,38967,7,1,6
2018,Enlisted,39042,15,6,9
2018,Enlisted,39043,17,0,17
2018,Enlisted,39046,32,1,31
2018,Enlisted,39051,7,1,6
2018,Enlisted,39059,6,1,5
2018,Enlisted,39060,21,6,15
2018,Enlisted,39074,15,4,11
2018,Enlisted,39090,3,0,3
2018,Enlisted,39111,2,2,0
2018,Enlisted,39117,13,2,11
2018,Enlisted,39120,3,2,1
2018,Enlisted,39159,1,0,1
2018,Enlisted,39168,3,0,3
2018,Enlisted,39183,14,2,12
2018,Enlisted,39194,7,1,6
2018,Enlisted,39202,4,2,2
2018,Enlisted,39204,44,12,32
2018,Enlisted,39209,20,4,16
2018,Enlisted,39216,16,9,7
2018,Enlisted,39296,3,2,1
2018,Enlisted,39307,40,8,32
2018,Enlisted,39328,1,0,1
2018,Enlisted,39339,3,0,3
2018,Enlisted,39345,34,5,29
2018,Enlisted,39350,20,5,15
2018,Enlisted,39367,9,4,5
2018,Enlisted,39403,2,1,1
2018,Enlisted,39407,62,13,49
2018,Enlisted,39422,14,2,12
2018,Enlisted,39429,1,0,1
2018,Enlisted,39440,9,4,5
2018,Enlisted,39455,4,4,0
2018,Enlisted,39466,37,4,33
2018,Enlisted,39468,1,1,0
2018,Enlisted,39470,14,1,13
2018,Enlisted,39476,1,0,1
2018,Enlisted,39505,32,7,25
2018,Enlisted,39507,21,5,16
2018,Enlisted,39532,3,1,2
2018,Enlisted,39556,4,2,2
2018,Enlisted,39567,12,2,10
2018,Enlisted,39577,28,2,26
2018,Enlisted,39601,1,0,1
2018,Enlisted,39638,2,0,2
2018,Enlisted,39648,46,12,34
2018,Enlisted,39654,25,6,19
2018,Enlisted,39667,4,1,3
2018,Enlisted,39704,1,0,1
2018,Enlisted,39730,7,1,6
2018,Enlisted,39735,2,1,1
2018,Enlisted,39744,3,0,3
2018,Enlisted,39760,47,4,43
2018,Enlisted,39773,10,1,9
2018,Enlisted,40004,15,5,10
2018,Enlisted,40065,17,2,15
2018,Enlisted,40069,2,0,2
2018,Enlisted,40108,7,1,6
2018,Enlisted,40121,6,3,3
2018,Enlisted,40205,41,10,31
2018,Enlisted,40218,62,14,48
2018,Enlisted,40311,10,2,8
2018,Enlisted,40330,16,3,13
2018,Enlisted,40351,8,0,8
2018,Enlisted,40422,4,1,3
2018,Enlisted,40472,23,5,18
2018,Enlisted,40475,106,15,91
2018,Enlisted,40510,16,1,15
2018,Enlisted,40601,42,20,22
2018,Enlisted,40741,6,0,6
2018,Enlisted,40769,4,2,2
2018,Enlisted,40831,14,3,11
2018,Enlisted,40906,8,5,3
2018,Enlisted,40965,24,2,22
2018,Enlisted,41005,66,7,59
2018,Enlisted,41008,10,1,9
2018,Enlisted,41031,9,2,7
2018,Enlisted,41094,42,8,34
2018,Enlisted,41101,27,8,19
2018,Enlisted,41164,9,2,7
2018,Enlisted,41339,4,1,3
2018,Enlisted,41653,9,1,8
2018,Enlisted,41701,23,1,22
2018,Enlisted,42025,22,3,19
2018,Enlisted,42071,22,2,20
2018,Enlisted,42086,15,2,13
2018,Enlisted,42101,18,2,16
2018,Enlisted,42141,22,0,22
2018,Enlisted,42167,7,1,6
2018,Enlisted,42240,10,3,7
2018,Enlisted,42276,17,0,17
2018,Enlisted,42301,23,5,18
2018,Enlisted,42330,6,1,5
2018,Enlisted,42345,23,5,18
2018,Enlisted,42431,16,0,16
2018,Enlisted,42501,26,5,21
2018,Enlisted,42633,13,0,13
2018,Enlisted,42701,7,1,6
2018,Enlisted,42718,17,1,16
2018,Enlisted,42754,8,1,7
2018,Enlisted,43015,49,8,41
2018,Enlisted,43040,64,4,60
2018,Enlisted,43055,25,4,21
2018,Enlisted,43102,27,2,25
2018,Enlisted,43213,77,12,65
2018,Enlisted,43217,161,22,139
2018,Enlisted,43235,7,7,0
2018,Enlisted,43402,10,2,8
2018,Enlisted,43465,100,12,88
2018,Enlisted,43614,33,2,31
2018,Enlisted,43756,82,3,79
2018,Enlisted,43812,24,2,22
2018,Enlisted,44023,13,1,12
2018,Enlisted,44055,30,4,26
2018,Enlisted,44128,67,42,25
2018,Enlisted,44142,14,5,9
2018,Enlisted,44224,27,6,21
2018,Enlisted,44256,16,3,13
2018,Enlisted,44313,13,6,7
2018,Enlisted,44444,55,3,52
2018,Enlisted,44515,44,3,41
2018,Enlisted,44601,31,5,26
2018,Enlisted,44622,7,0,7
2018,Enlisted,44691,32,2,30
2018,Enlisted,44720,139,11,128
2018,Enlisted,44857,19,4,15
2018,Enlisted,44870,8,4,4
2018,Enlisted,44883,17,4,13
2018,Enlisted,44903,65,4,61
2018,Enlisted,45015,14,5,9
2018,Enlisted,45036,5,0,5
2018,Enlisted,45044,42,4,38
2018,Enlisted,45215,78,9,69
2018,Enlisted,45331,14,3,11
2018,Enlisted,45356,41,4,37
2018,Enlisted,45385,18,5,13
2018,Enlisted,45430,26,2,24
2018,Enlisted,45502,64,4,60
2018,Enlisted,45601,12,3,9
2018,Enlisted,45662,25,3,22
2018,Enlisted,45804,15,0,15
2018,Enlisted,45885,10,3,7
2018,Enlisted,46012,12,1,11
2018,Enlisted,46036,11,2,9
2018,Enlisted,46041,24,7,17
2018,Enlisted,46052,14,1,13
2018,Enlisted,46122,47,5,42
2018,Enlisted,46124,42,15,27
2018,Enlisted,46131,90,22,68
2018,Enlisted,46135,17,1,16
2018,Enlisted,46140,39,11,28
2018,Enlisted,46151,32,6,26
2018,Enlisted,46176,44,9,35
2018,Enlisted,46208,7,1,6
2018,Enlisted,46216,44,7,37
2018,Enlisted,46241,188,50,138
2018,Enlisted,46323,7,2,5
2018,Enlisted,46350,9,4,5
2018,Enlisted,46360,7,3,4
2018,Enlisted,46383,16,3,13
2018,Enlisted,46402,14,2,12
2018,Enlisted,46406,37,8,29
2018,Enlisted,46517,14,2,12
2018,Enlisted,46563,21,6,15
2018,Enlisted,46580,18,3,15
2018,Enlisted,46613,29,4,25
2018,Enlisted,46703,21,2,19
2018,Enlisted,46714,19,1,18
2018,Enlisted,46750,13,2,11
2018,Enlisted,46825,74,17,57
2018,Enlisted,46901,7,5,2
2018,Enlisted,46947,28,4,24
2018,Enlisted,46953,1,0,1
2018,Enlisted,46970,2,1,1
2018,Enlisted,47150,13,2,11
2018,Enlisted,47167,24,9,15
2018,Enlisted,47170,10,2,8
2018,Enlisted,47203,53,9,44
2018,Enlisted,47223,4,1,3
2018,Enlisted,47250,11,1,10
2018,Enlisted,47265,10,0,10
2018,Enlisted,47274,10,5,5
2018,Enlisted,47303,21,8,13
2018,Enlisted,47331,16,6,10
2018,Enlisted,47348,32,3,29
2018,Enlisted,47374,7,5,2
2018,Enlisted,47394,11,6,5
2018,Enlisted,47401,41,4,37
2018,Enlisted,47421,15,0,15
2018,Enlisted,47441,33,9,24
2018,Enlisted,47501,10,3,7
2018,Enlisted,47546,22,7,15
2018,Enlisted,47591,7,3,4
2018,Enlisted,47715,45,9,36
2018,Enlisted,47804,18,4,14
2018,Enlisted,47834,49,9,40
2018,Enlisted,47872,14,2,12
2018,Enlisted,47905,57,10,47
2018,Enlisted,47933,32,7,25
2018,Enlisted,47960,12,2,10
2018,Enlisted,47977,17,4,13
2018,Enlisted,47978,15,0,15
2018,Enlisted,48060,12,1,11
2018,Enlisted,48180,54,16,38
2018,Enlisted,48197,21,6,15
2018,Enlisted,48208,49,7,42
2018,Enlisted,48234,101,24,77
2018,Enlisted,48341,32,8,24
2018,Enlisted,48446,14,0,14
2018,Enlisted,48601,75,14,61
2018,Enlisted,48642,30,4,26
2018,Enlisted,48706,29,6,23
2018,Enlisted,48801,11,3,8
2018,Enlisted,48817,21,4,17
2018,Enlisted,48837,48,13,35
2018,Enlisted,48838,26,5,21
2018,Enlisted,48843,29,7,22
2018,Enlisted,48906,38,15,23
2018,Enlisted,48912,13,2,11
2018,Enlisted,49009,43,8,35
2018,Enlisted,49012,78,11,67
2018,Enlisted,49047,27,9,18
2018,Enlisted,49201,46,10,36
2018,Enlisted,49224,10,0,10
2018,Enlisted,49306,4,3,1
2018,Enlisted,49307,5,2,3
2018,Enlisted,49437,22,2,20
2018,Enlisted,49509,125,35,90
2018,Enlisted,49601,21,6,15
2018,Enlisted,49696,27,5,22
2018,Enlisted,49739,62,20,42
2018,Enlisted,49783,15,0,15
2018,Enlisted,49802,18,2,16
2018,Enlisted,49837,14,0,14
2018,Enlisted,49849,4,1,3
2018,Enlisted,49855,36,3,33
2018,Enlisted,49908,5,1,4
2018,Enlisted,49913,7,0,7
2018,Enlisted,49935,8,1,7
2018,Enlisted,50025,7,0,7
2018,Enlisted,50036,36,7,29
2018,Enlisted,50126,13,0,13
2018,Enlisted,50131,309,58,251
2018,Enlisted,50138,11,3,8
2018,Enlisted,50158,8,1,7
2018,Enlisted,50220,10,1,9
2018,Enlisted,50401,19,7,12
2018,Enlisted,50501,10,2,8
2018,Enlisted,50588,11,0,11
2018,Enlisted,50616,7,1,6
2018,Enlisted,50662,8,1,7
2018,Enlisted,50703,49,13,36
2018,Enlisted,51031,21,3,18
2018,Enlisted,51111,34,5,29
2018,Enlisted,51201,14,1,13
2018,Enlisted,51301,7,3,4
2018,Enlisted,51334,10,4,6
2018,Enlisted,51401,13,2,11
2018,Enlisted,51442,8,1,7
2018,Enlisted,51503,19,3,16
2018,Enlisted,51566,6,1,5
2018,Enlisted,51601,4,0,4
2018,Enlisted,52002,54,12,42
2018,Enlisted,52246,59,15,44
2018,Enlisted,52353,11,1,10
2018,Enlisted,52404,50,15,35
2018,Enlisted,52501,8,4,4
2018,Enlisted,52556,9,0,9
2018,Enlisted,52577,12,0,12
2018,Enlisted,52632,1,0,1
2018,Enlisted,52638,24,4,20
2018,Enlisted,52641,6,2,4
2018,Enlisted,52732,15,4,11
2018,Enlisted,52761,8,1,7
2018,Enlisted,52806,43,11,32
2018,Enlisted,53027,7,2,5
2018,Enlisted,53066,24,1,23
2018,Enlisted,53073,12,0,12
2018,Enlisted,53089,48,2,46
2018,Enlisted,53094,9,1,8
2018,Enlisted,53095,9,5,4
2018,Enlisted,53105,2,0,2
2018,Enlisted,53121,6,2,4
2018,Enlisted,53144,7,1,6
2018,Enlisted,53154,6,2,4
2018,Enlisted,53186,16,0,16
2018,Enlisted,53190,16,5,11
2018,Enlisted,53212,64,13,51
2018,Enlisted,53403,13,0,13
2018,Enlisted,53511,27,5,22
2018,Enlisted,53538,24,2,22
2018,Enlisted,53545,3,0,3
2018,Enlisted,53581,3,0,3
2018,Enlisted,53704,92,14,78
2018,Enlisted,53818,7,0,7
2018,Enlisted,53821,9,2,7
2018,Enlisted,53901,10,2,8
2018,Enlisted,53948,15,2,13
2018,Enlisted,53959,14,4,10
2018,Enlisted,53963,11,3,8
2018,Enlisted,54017,15,3,12
2018,Enlisted,54022,18,3,15
2018,Enlisted,54143,11,1,10
2018,Enlisted,54241,5,1,4
2018,Enlisted,54303,35,8,27
2018,Enlisted,54401,8,1,7
2018,Enlisted,54405,5,1,4
2018,Enlisted,54409,21,6,15
2018,Enlisted,54449,24,2,22
2018,Enlisted,54451,13,0,13
2018,Enlisted,54455,14,2,12
2018,Enlisted,54456,7,1,6
2018,Enlisted,54481,18,3,15
2018,Enlisted,54487,2,0,2
2018,Enlisted,54495,12,3,9
2018,Enlisted,54501,15,1,14
2018,Enlisted,54612,21,0,21
2018,Enlisted,54615,22,3,19
2018,Enlisted,54618,20,3,17
2018,Enlisted,54650,16,3,13
2018,Enlisted,54656,19,6,13
2018,Enlisted,54660,9,2,7
2018,Enlisted,54665,3,0,3
2018,Enlisted,54703,8,2,6
2018,Enlisted,54729,7,0,7
2018,Enlisted,54751,26,1,25
2018,Enlisted,54801,17,1,16
2018,Enlisted,54806,9,0,9
2018,Enlisted,54843,21,2,19
2018,Enlisted,54868,12,0,12
2018,Enlisted,54880,33,2,31
2018,Enlisted,54902,30,3,27
2018,Enlisted,54914,22,7,15
2018,Enlisted,54923,5,1,4
2018,Enlisted,54929,5,1,4
2018,Enlisted,54935,24,3,21
2018,Enlisted,54971,20,4,16
2018,Enlisted,54981,8,0,8
2018,Enlisted,55008,29,3,26
2018,Enlisted,55016,22,5,17
2018,Enlisted,55021,33,9,24
2018,Enlisted,55033,10,4,6
2018,Enlisted,55060,10,4,6
2018,Enlisted,55063,13,3,10
2018,Enlisted,55066,11,5,6
2018,Enlisted,55068,40,9,31
2018,Enlisted,55077,16,2,14
2018,Enlisted,55082,65,7,58
2018,Enlisted,55101,7,0,7
2018,Enlisted,55106,35,4,31
2018,Enlisted,55107,84,9,75
2018,Enlisted,55112,118,10,108
2018,Enlisted,55118,16,4,12
2018,Enlisted,55303,16,2,14
2018,Enlisted,55350,9,2,7
2018,Enlisted,55355,18,5,13
2018,Enlisted,55362,20,1,19
2018,Enlisted,55413,2,2,0
2018,Enlisted,55431,53,11,42
2018,Enlisted,55443,20,3,17
2018,Enlisted,55719,40,2,38
2018,Enlisted,55720,12,2,10
2018,Enlisted,55744,15,3,12
2018,Enlisted,55746,13,1,12
2018,Enlisted,55811,113,10,103
2018,Enlisted,55901,39,3,36
2018,Enlisted,55904,1,0,1
2018,Enlisted,55912,29,4,25
2018,Enlisted,55987,50,4,46
2018,Enlisted,56001,31,5,26
2018,Enlisted,56007,18,1,17
2018,Enlisted,56031,6,1,5
2018,Enlisted,56073,13,2,11
2018,Enlisted,56081,12,0,12
2018,Enlisted,56082,12,1,11
2018,Enlisted,56143,20,0,20
2018,Enlisted,56156,8,0,8
2018,Enlisted,56164,12,1,11
2018,Enlisted,56201,22,0,22
2018,Enlisted,56208,10,1,9
2018,Enlisted,56256,11,1,10
2018,Enlisted,56258,11,3,8
2018,Enlisted,56265,12,0,12
2018,Enlisted,56267,13,3,10
2018,Enlisted,56277,7,1,6
2018,Enlisted,56278,10,0,10
2018,Enlisted,56283,14,0,14
2018,Enlisted,56301,25,2,23
2018,Enlisted,56303,19,5,14
2018,Enlisted,56308,35,0,35
2018,Enlisted,56345,240,24,216
2018,Enlisted,56378,18,2,16
2018,Enlisted,56401,8,0,8
2018,Enlisted,56482,22,1,21
2018,Enlisted,56501,11,2,9
2018,Enlisted,56537,12,0,12
2018,Enlisted,56560,23,3,20
2018,Enlisted,56601,18,3,15
2018,Enlisted,56701,15,1,14
2018,Enlisted,56716,12,0,12
2018,Enlisted,57006,13,0,13
2018,Enlisted,57028,7,1,6
2018,Enlisted,57042,13,1,12
2018,Enlisted,57069,8,1,7
2018,Enlisted,57078,7,0,7
2018,Enlisted,57104,32,5,27
2018,Enlisted,57201,36,7,29
2018,Enlisted,57231,7,1,6
2018,Enlisted,57252,9,0,9
2018,Enlisted,57301,7,1,6
2018,Enlisted,57325,5,0,5
2018,Enlisted,57350,13,0,13
2018,Enlisted,57366,6,0,6
2018,Enlisted,57380,12,1,11
2018,Enlisted,57401,20,1,19
2018,Enlisted,57501,14,2,12
2018,Enlisted,57601,6,0,6
2018,Enlisted,57702,35,12,23
2018,Enlisted,57703,5,0,5
2018,Enlisted,57717,18,4,14
2018,Enlisted,57783,4,2,2
2018,Enlisted,57785,1,0,1
2018,Enlisted,58054,6,0,6
2018,Enlisted,58072,16,0,16
2018,Enlisted,58075,16,0,16
2018,Enlisted,58102,50,8,42
2018,Enlisted,58201,51,5,46
2018,Enlisted,58301,23,2,21
2018,Enlisted,58402,8,2,6
2018,Enlisted,58433,4,3,1
2018,Enlisted,58495,5,0,5
2018,Enlisted,58506,79,10,69
2018,Enlisted,58601,19,2,17
2018,Enlisted,58701,3,0,3
2018,Enlisted,58703,12,3,9
2018,Enlisted,58801,7,3,4
2018,Enlisted,59047,11,2,9
2018,Enlisted,59102,56,18,38
2018,Enlisted,59218,1,0,1
2018,Enlisted,59230,7,0,7
2018,Enlisted,59301,8,1,7
2018,Enlisted,59405,5,2,3
2018,Enlisted,59457,6,0,6
2018,Enlisted,59501,2,0,2
2018,Enlisted,59538,10,3,7
2018,Enlisted,59602,36,14,22
2018,Enlisted,59636,62,49,13
2018,Enlisted,59701,5,0,5
2018,Enlisted,59711,9,1,8
2018,Enlisted,59714,45,18,27
2018,Enlisted,59725,6,4,2
2018,Enlisted,59808,48,16,32
2018,Enlisted,59901,25,8,17
2018,Enlisted,59923,4,1,3
2018,Enlisted,60037,44,2,42
2018,Enlisted,60098,22,5,17
2018,Enlisted,60120,36,3,33
2018,Enlisted,60178,19,4,15
2018,Enlisted,60435,26,3,23
2018,Enlisted,60472,96,10,86
2018,Enlisted,60505,24,3,21
2018,Enlisted,60546,195,24,171
2018,Enlisted,60615,98,12,86
2018,Enlisted,60616,16,3,13
2018,Enlisted,60651,35,5,30
2018,Enlisted,60901,46,15,31
2018,Enlisted,61021,15,1,14
2018,Enlisted,61032,45,1,44
2018,Enlisted,61071,17,1,16
2018,Enlisted,61115,83,7,76
2018,Enlisted,61264,40,1,39
2018,Enlisted,61341,24,2,22
2018,Enlisted,61401,42,2,40
2018,Enlisted,61434,9,0,9
2018,Enlisted,61443,10,2,8
2018,Enlisted,61455,15,4,11
2018,Enlisted,61607,87,21,66
2018,Enlisted,61701,24,4,20
2018,Enlisted,61761,13,4,9
2018,Enlisted,61764,13,1,12
2018,Enlisted,61801,20,3,17
2018,Enlisted,61820,11,0,11
2018,Enlisted,61834,13,0,13
2018,Enlisted,61938,18,2,16
2018,Enlisted,61944,24,0,24
2018,Enlisted,61951,9,2,7
2018,Enlisted,62056,35,13,22
2018,Enlisted,62205,47,1,46
2018,Enlisted,62269,13,0,13
2018,Enlisted,62286,32,1,31
2018,Enlisted,62301,15,1,14
2018,Enlisted,62401,23,6,17
2018,Enlisted,62439,24,2,22
2018,Enlisted,62521,48,6,42
2018,Enlisted,62618,17,1,16
2018,Enlisted,62702,94,9,85
2018,Enlisted,62864,24,5,19
2018,Enlisted,62896,20,5,15
2018,Enlisted,62959,50,11,39
2018,Enlisted,62966,36,4,32
2018,Enlisted,63020,1,0,1
2018,Enlisted,63028,44,7,37
2018,Enlisted,63044,104,21,83
2018,Enlisted,63077,27,1,26
2018,Enlisted,63109,19,4,15
2018,Enlisted,63125,43,15,28
2018,Enlisted,63383,19,7,12
2018,Enlisted,63401,14,5,9
2018,Enlisted,63501,3,1,2
2018,Enlisted,63552,40,5,35
2018,Enlisted,63640,24,2,22
2018,Enlisted,63645,4,1,3
2018,Enlisted,63703,27,7,20
2018,Enlisted,63755,2,0,2
2018,Enlisted,63775,13,0,13
2018,Enlisted,63801,6,1,5
2018,Enlisted,63841,8,3,5
2018,Enlisted,63857,19,9,10
2018,Enlisted,63873,4,0,4
2018,Enlisted,63901,7,1,6
2018,Enlisted,63935,5,0,5
2018,Enlisted,64052,14,8,6
2018,Enlisted,64067,26,12,14
2018,Enlisted,64085,46,5,41
2018,Enlisted,64093,5,3,2
2018,Enlisted,64129,109,31,78
2018,Enlisted,64402,8,4,4
2018,Enlisted,64468,10,4,6
2018,Enlisted,64506,23,7,16
2018,Enlisted,64601,7,6,1
2018,Enlisted,64683,25,10,15
2018,Enlisted,64701,58,5,53
2018,Enlisted,64735,6,1,5
2018,Enlisted,64759,7,0,7
2018,Enlisted,64772,13,5,8
2018,Enlisted,64804,24,5,19
2018,Enlisted,64831,10,3,7
2018,Enlisted,64836,27,4,23
2018,Enlisted,64850,1,1,0
2018,Enlisted,65101,17,7,10
2018,Enlisted,65109,31,9,22
2018,Enlisted,65202,25,6,19
2018,Enlisted,65233,24,9,15
2018,Enlisted,65251,4,2,2
2018,Enlisted,65265,11,1,10
2018,Enlisted,65270,8,2,6
2018,Enlisted,65301,10,5,5
2018,Enlisted,65305,24,6,18
2018,Enlisted,65340,25,5,20
2018,Enlisted,65401,22,7,15
2018,Enlisted,65473,17,7,10
2018,Enlisted,65536,21,0,21
2018,Enlisted,65605,13,9,4
2018,Enlisted,65708,59,6,53
2018,Enlisted,65723,18,3,15
2018,Enlisted,65775,18,6,12
2018,Enlisted,65802,53,10,43
2018,Enlisted,65803,60,15,45
2018,Enlisted,66027,17,6,11
2018,Enlisted,66044,1,1,0
2018,Enlisted,66061,28,7,21
2018,Enlisted,66067,12,3,9
2018,Enlisted,66071,2,0,2
2018,Enlisted,66102,15,4,11
2018,Enlisted,66219,6,1,5
2018,Enlisted,66436,4,1,3
2018,Enlisted,66441,10,6,4
2018,Enlisted,66442,1,0,1
2018,Enlisted,66502,15,8,7
2018,Enlisted,66508,1,0,1
2018,Enlisted,66611,4,4,0
2018,Enlisted,66619,51,17,34
2018,Enlisted,66749,15,5,10
2018,Enlisted,66762,17,3,14
2018,Enlisted,66801,4,3,1
2018,Enlisted,66901,3,1,2
2018,Enlisted,66967,1,0,1
2018,Enlisted,67010,8,1,7
2018,Enlisted,67114,3,0,3
2018,Enlisted,67124,1,0,1
2018,Enlisted,67217,24,13,11
2018,Enlisted,67219,27,6,21
2018,Enlisted,67337,6,0,6
2018,Enlisted,67401,5,2,3
2018,Enlisted,67410,7,1,6
2018,Enlisted,67432,4,1,3
2018,Enlisted,67501,17,5,12
2018,Enlisted,67530,4,1,3
2018,Enlisted,67601,4,0,4
2018,Enlisted,67654,1,0,1
2018,Enlisted,67701,2,0,2
2018,Enlisted,67801,3,0,3
2018,Enlisted,67846,5,1,4
2018,Enlisted,67901,1,0,1
2018,Enlisted,68003,1,1,0
2018,Enlisted,68066,9,4,5
2018,Enlisted,68073,37,9,28
2018,Enlisted,68106,15,2,13
2018,Enlisted,68142,20,5,15
2018,Enlisted,68310,20,12,8
2018,Enlisted,68410,1,0,1
2018,Enlisted,68467,1,1,0
2018,Enlisted,68508,21,7,14
2018,Enlisted,68524,57,14,43
2018,Enlisted,68601,6,2,4
2018,Enlisted,68701,5,1,4
2018,Enlisted,68763,2,0,2
2018,Enlisted,68787,2,1,1
2018,Enlisted,68801,37,11,26
2018,Enlisted,68822,3,1,2
2018,Enlisted,68847,13,4,9
2018,Enlisted,68901,29,3,26
2018,Enlisted,69001,1,1,0
2018,Enlisted,69101,5,1,4
2018,Enlisted,69162,2,0,2
2018,Enlisted,69337,14,1,13
2018,Enlisted,69361,7,0,7
2018,Enlisted,70072,7,2,5
2018,Enlisted,70084,22,2,20
2018,Enlisted,70117,195,21,174
2018,Enlisted,70364,53,14,39
2018,Enlisted,70390,33,4,29
2018,Enlisted,70401,85,19,66
2018,Enlisted,70403,18,1,17
2018,Enlisted,70427,10,1,9
2018,Enlisted,70433,45,6,39
2018,Enlisted,70438,33,5,28
2018,Enlisted,70460,11,2,9
2018,Enlisted,70508,62,8,54
2018,Enlisted,70510,23,13,10
2018,Enlisted,70517,27,8,19
2018,Enlisted,70526,18,3,15
2018,Enlisted,70544,15,3,12
2018,Enlisted,70563,28,4,24
2018,Enlisted,70570,14,0,14
2018,Enlisted,70582,20,0,20
2018,Enlisted,70586,9,1,8
2018,Enlisted,70601,37,8,29
2018,Enlisted,70633,8,1,7
2018,Enlisted,70634,6,1,5
2018,Enlisted,70701,5,1,4
2018,Enlisted,70714,34,3,31
2018,Enlisted,70721,99,19,80
2018,Enlisted,70737,48,4,44
2018,Enlisted,70760,46,8,38
2018,Enlisted,70764,35,2,33
2018,Enlisted,70820,57,7,50
2018,Enlisted,71019,12,7,5
2018,Enlisted,71055,32,10,22
2018,Enlisted,71101,38,3,35
2018,Enlisted,71111,13,0,13
2018,Enlisted,71203,53,3,50
2018,Enlisted,71220,15,3,12
2018,Enlisted,71232,11,2,9
2018,Enlisted,71241,1,0,1
2018,Enlisted,71251,1,1,0
2018,Enlisted,71263,4,0,4
2018,Enlisted,71270,31,4,27
2018,Enlisted,71292,19,1,18
2018,Enlisted,71295,13,0,13
2018,Enlisted,71303,29,4,25
2018,Enlisted,71322,19,3,16
2018,Enlisted,71342,10,2,8
2018,Enlisted,71351,16,2,14
2018,Enlisted,71360,123,19,104
2018,Enlisted,71373,5,1,4
2018,Enlisted,71415,5,1,4
2018,Enlisted,71417,9,2,7
2018,Enlisted,71457,18,1,17
2018,Enlisted,71459,18,2,16
2018,Enlisted,71601,9,4,5
2018,Enlisted,71602,9,0,9
2018,Enlisted,71701,2,0,2
2018,Enlisted,71730,13,1,12
2018,Enlisted,71761,13,0,13
2018,Enlisted,71801,4,2,2
2018,Enlisted,71823,9,0,9
2018,Enlisted,71854,10,1,9
2018,Enlisted,71913,10,0,10
2018,Enlisted,71923,7,1,6
2018,Enlisted,71953,6,3,3
2018,Enlisted,72007,13,9,4
2018,Enlisted,72012,8,1,7
2018,Enlisted,72015,6,0,6
2018,Enlisted,72023,7,2,5
2018,Enlisted,72034,11,2,9
2018,Enlisted,72064,11,1,10
2018,Enlisted,72086,19,5,14
2018,Enlisted,72104,10,2,8
2018,Enlisted,72110,8,1,7
2018,Enlisted,72114,48,4,44
2018,Enlisted,72119,1,1,0
2018,Enlisted,72143,26,10,16
2018,Enlisted,72150,15,0,15
2018,Enlisted,72160,23,6,17
2018,Enlisted,72199,176,32,144
2018,Enlisted,72301,12,3,9
2018,Enlisted,72335,7,2,5
2018,Enlisted,72401,47,1,46
2018,Enlisted,72432,13,2,11
2018,Enlisted,72450,24,1,23
2018,Enlisted,72476,26,5,21
2018,Enlisted,72501,25,15,10
2018,Enlisted,72543,5,1,4
2018,Enlisted,72605,1,0,1
2018,Enlisted,72650,2,0,2
2018,Enlisted,72653,4,1,3
2018,Enlisted,72701,18,2,16
2018,Enlisted,72712,59,13,46
2018,Enlisted,72744,5,0,5
2018,Enlisted,72756,35,2,33
2018,Enlisted,72761,18,2,16
2018,Enlisted,72802,25,3,22
2018,Enlisted,72830,21,3,18
2018,Enlisted,72834,12,1,11
2018,Enlisted,72855,21,0,21
2018,Enlisted,72905,9,2,7
2018,Enlisted,72923,47,2,45
2018,Enlisted,72927,49,1,48
2018,Enlisted,72949,15,1,14
2018,Enlisted,73034,32,3,29
2018,Enlisted,73036,24,4,20
2018,Enlisted,73051,42,7,35
2018,Enlisted,73064,42,11,31
2018,Enlisted,73069,104,18,86
2018,Enlisted,73111,35,14,21
2018,Enlisted,73179,2,1,1
2018,Enlisted,73401,1,0,1
2018,Enlisted,73503,67,9,58
2018,Enlisted,73521,12,3,9
2018,Enlisted,73705,37,4,33
2018,Enlisted,74003,17,4,13
2018,Enlisted,74012,35,9,26
2018,Enlisted,74014,60,9,51
2018,Enlisted,74017,13,1,12
2018,Enlisted,74075,46,5,41
2018,Enlisted,74107,64,9,55
2018,Enlisted,74116,17,8,9
2018,Enlisted,74158,3,1,2
2018,Enlisted,74301,4,2,2
2018,Enlisted,74403,34,8,26
2018,Enlisted,74423,6,2,4
2018,Enlisted,74447,24,1,23
2018,Enlisted,74501,28,3,25
2018,Enlisted,74601,6,0,6
2018,Enlisted,74701,27,0,27
2018,Enlisted,74804,29,3,26
2018,Enlisted,74820,39,13,26
2018,Enlisted,74834,34,12,22
2018,Enlisted,74848,16,1,15
2018,Enlisted,74953,5,0,5
2018,Enlisted,75051,173,68,105
2018,Enlisted,75077,12,2,10
2018,Enlisted,75098,1,0,1
2018,Enlisted,75110,15,5,10
2018,Enlisted,75159,24,22,2
2018,Enlisted,75160,52,17,35
2018,Enlisted,75165,11,4,7
2018,Enlisted,75220,4,1,3
2018,Enlisted,75237,13,6,7
2018,Enlisted,75402,1,1,0
2018,Enlisted,75570,8,1,7
2018,Enlisted,75662,13,13,0
2018,Enlisted,75709,26,13,13
2018,Enlisted,75801,2,2,0
2018,Enlisted,75803,1,1,0
2018,Enlisted,75901,18,12,6
2018,Enlisted,76086,33,4,29
2018,Enlisted,76105,27,4,23
2018,Enlisted,76108,86,30,56
2018,Enlisted,76115,33,12,21
2018,Enlisted,76207,29,8,21
2018,Enlisted,76234,32,7,25
2018,Enlisted,76302,38,18,20
2018,Enlisted,76401,22,4,18
2018,Enlisted,76528,17,11,6
2018,Enlisted,76542,46,31,15
2018,Enlisted,76544,7,4,3
2018,Enlisted,76574,27,12,15
2018,Enlisted,76705,2,0,2
2018,Enlisted,76707,89,39,50
2018,Enlisted,76801,12,4,8
2018,Enlisted,76905,22,4,18
2018,Enlisted,77034,203,86,117
2018,Enlisted,77067,102,46,56
2018,Enlisted,77082,109,38,71
2018,Enlisted,77340,48,23,25
2018,Enlisted,77437,15,7,8
2018,Enlisted,77471,22,9,13
2018,Enlisted,77515,61,12,49
2018,Enlisted,77568,23,4,19
2018,Enlisted,77802,36,10,26
2018,Enlisted,77833,19,2,17
2018,Enlisted,77904,9,9,0
2018,Enlisted,78041,24,9,15
2018,Enlisted,78130,10,6,4
2018,Enlisted,78155,6,4,2
2018,Enlisted,78218,46,26,20
2018,Enlisted,78219,88,35,53
2018,Enlisted,78257,148,89,59
2018,Enlisted,78363,16,5,11
2018,Enlisted,78416,28,8,20
2018,Enlisted,78520,9,3,6
2018,Enlisted,78596,77,26,51
2018,Enlisted,78602,104,41,63
2018,Enlisted,78617,83,38,45
2018,Enlisted,78624,8,7,1
2018,Enlisted,78654,5,5,0
2018,Enlisted,78665,56,35,21
2018,Enlisted,78666,128,61,67
2018,Enlisted,78703,95,49,46
2018,Enlisted,78719,1,0,1
2018,Enlisted,78731,24,10,14
2018,Enlisted,78746,5,4,1
2018,Enlisted,79107,17,1,16
2018,Enlisted,79403,39,17,22
2018,Enlisted,79607,14,5,9
2018,Enlisted,79706,19,8,11
2018,Enlisted,79924,6,4,2
2018,Enlisted,79936,179,57,122
2018,Enlisted,80011,82,50,32
2018,Enlisted,80012,22,10,12
2018,Enlisted,80112,8,6,2
2018,Enlisted,80137,38,20,18
2018,Enlisted,80216,99,54,45
2018,Enlisted,80501,7,0,7
2018,Enlisted,80504,25,11,14
2018,Enlisted,80521,31,15,16
2018,Enlisted,80550,7,5,2
2018,Enlisted,80621,27,9,18
2018,Enlisted,80751,2,1,1
2018,Enlisted,80907,14,7,7
2018,Enlisted,80913,30,18,12
2018,Enlisted,80916,9,6,3
2018,Enlisted,80920,70,32,38
2018,Enlisted,81004,6,4,2
2018,Enlisted,81050,5,1,4
2018,Enlisted,81101,4,0,4
2018,Enlisted,81401,19,5,14
2018,Enlisted,81501,26,12,14
2018,Enlisted,81637,2,2,0
2018,Enlisted,82005,8,5,3
2018,Enlisted,82009,33,11,22
2018,Enlisted,82072,13,2,11
2018,Enlisted,82201,2,2,0
2018,Enlisted,82214,8,2,6
2018,Enlisted,82240,8,1,7
2018,Enlisted,82401,2,0,2
2018,Enlisted,82435,4,3,1
2018,Enlisted,82520,11,2,9
2018,Enlisted,82604,4,0,4
2018,Enlisted,82633,17,0,17
2018,Enlisted,82716,14,2,12
2018,Enlisted,82801,1,0,1
2018,Enlisted,82901,11,3,8
2018,Enlisted,82930,35,8,27
2018,Enlisted,83110,9,2,7
2018,Enlisted,83202,12,1,11
2018,Enlisted,83221,9,1,8
2018,Enlisted,83263,6,2,4
2018,Enlisted,83301,9,4,5
2018,Enlisted,83318,37,2,35
2018,Enlisted,83330,4,2,2
2018,Enlisted,83338,16,1,15
2018,Enlisted,83402,13,0,13
2018,Enlisted,83440,15,2,13
2018,Enlisted,83442,4,0,4
2018,Enlisted,83445,12,1,11
2018,Enlisted,83501,13,3,10
2018,Enlisted,83530,5,1,4
2018,Enlisted,83544,11,2,9
2018,Enlisted,83605,24,4,20
2018,Enlisted,83647,23,5,18
2018,Enlisted,83687,3,1,2
2018,Enlisted,83705,143,45,98
2018,Enlisted,83716,4,0,4
2018,Enlisted,83843,6,0,6
2018,Enlisted,83854,15,3,12
2018,Enlisted,84003,16,6,10
2018,Enlisted,84020,35,10,25
2018,Enlisted,84032,11,3,8
2018,Enlisted,84043,49,26,23
2018,Enlisted,84058,29,4,25
2018,Enlisted,84065,109,29,80
2018,Enlisted,84074,14,2,12
2018,Enlisted,84083,4,2,2
2018,Enlisted,84084,100,44,56
2018,Enlisted,84116,8,2,6
2018,Enlisted,84321,12,5,7
2018,Enlisted,84405,42,12,30
2018,Enlisted,84501,10,3,7
2018,Enlisted,84511,1,1,0
2018,Enlisted,84642,22,5,17
2018,Enlisted,84660,77,10,67
2018,Enlisted,84663,10,3,7
2018,Enlisted,84701,19,6,13
2018,Enlisted,84713,17,2,15
2018,Enlisted,84720,18,2,16
2018,Enlisted,84770,6,1,5
2018,Enlisted,84790,42,7,35
2018,Enlisted,85008,238,79,159
2018,Enlisted,85015,2,2,0
2018,Enlisted,85020,21,7,14
2018,Enlisted,85122,19,6,13
2018,Enlisted,85128,2,2,0
2018,Enlisted,85132,74,36,38
2018,Enlisted,85145,33,16,17
2018,Enlisted,85281,22,12,10
2018,Enlisted,85286,13,9,4
2018,Enlisted,85301,4,0,4
2018,Enlisted,85312,10,3,7
2018,Enlisted,85365,12,2,10
2018,Enlisted,85396,28,17,11
2018,Enlisted,85546,6,4,2
2018,Enlisted,85607,1,1,0
2018,Enlisted,85653,11,8,3
2018,Enlisted,85706,64,18,46
2018,Enlisted,85713,31,19,12
2018,Enlisted,85901,1,1,0
2018,Enlisted,86015,62,19,43
2018,Enlisted,86301,41,21,20
2018,Enlisted,87002,43,8,35
2018,Enlisted,87123,54,11,43
2018,Enlisted,87144,91,24,67
2018,Enlisted,87305,1,0,1
2018,Enlisted,87401,18,2,16
2018,Enlisted,87502,1,1,0
2018,Enlisted,87508,23,8,15
2018,Enlisted,87532,8,1,7
2018,Enlisted,87557,4,0,4
2018,Enlisted,87701,1,1,0
2018,Enlisted,87747,1,1,0
2018,Enlisted,88001,1,0,1
2018,Enlisted,88007,86,24,62
2018,Enlisted,88101,12,2,10
2018,Enlisted,88203,38,11,27
2018,Enlisted,88240,6,4,2
2018,Enlisted,88310,14,4,10
2018,Enlisted,88435,5,0,5
2018,Enlisted,89002,22,1,21
2018,Enlisted,89032,8,4,4
2018,Enlisted,89115,22,3,19
2018,Enlisted,89139,81,17,64
2018,Enlisted,89165,161,51,110
2018,Enlisted,89406,11,4,7
2018,Enlisted,89506,116,28,88
2018,Enlisted,89509,12,1,11
2018,Enlisted,89701,31,10,21
2018,Enlisted,90025,4,3,1
2018,Enlisted,90201,43,17,26
2018,Enlisted,90249,10,3,7
2018,Enlisted,90266,13,5,8
2018,Enlisted,90302,25,9,16
2018,Enlisted,90501,16,8,8
2018,Enlisted,90720,179,68,111
2018,Enlisted,90731,14,9,5
2018,Enlisted,90813,11,4,7
2018,Enlisted,90822,55,25,30
2018,Enlisted,91205,22,12,10
2018,Enlisted,91406,25,6,19
2018,Enlisted,91505,25,11,14
2018,Enlisted,91702,64,30,34
2018,Enlisted,91764,37,13,24
2018,Enlisted,91766,25,9,16
2018,Enlisted,91950,36,11,25
2018,Enlisted,92020,9,3,6
2018,Enlisted,92025,12,7,5
2018,Enlisted,92111,40,18,22
2018,Enlisted,92243,12,6,6
2018,Enlisted,92307,11,6,5
2018,Enlisted,92311,12,4,8
2018,Enlisted,92324,8,5,3
2018,Enlisted,92410,16,10,6
2018,Enlisted,92501,26,13,13
2018,Enlisted,92518,59,17,42
2018,Enlisted,92707,10,4,6
2018,Enlisted,92833,25,11,14
2018,Enlisted,92866,30,15,15
2018,Enlisted,93003,3,3,0
2018,Enlisted,93257,1,1,0
2018,Enlisted,93291,18,7,11
2018,Enlisted,93307,42,14,28
2018,Enlisted,93405,12,4,8
2018,Enlisted,93422,9,4,5
2018,Enlisted,93451,23,12,11
2018,Enlisted,93454,1,0,1
2018,Enlisted,93536,20,8,12
2018,Enlisted,93550,12,9,3
2018,Enlisted,93702,7,3,4
2018,Enlisted,93727,72,28,44
2018,Enlisted,93955,4,2,2
2018,Enlisted,94043,6,5,1
2018,Enlisted,94066,3,1,2
2018,Enlisted,94132,5,4,1
2018,Enlisted,94401,17,9,8
2018,Enlisted,94510,11,4,7
2018,Enlisted,94519,7,1,6
2018,Enlisted,94533,9,5,4
2018,Enlisted,94565,17,10,7
2018,Enlisted,94568,39,24,15
2018,Enlisted,94590,15,6,9
2018,Enlisted,94596,3,1,2
2018,Enlisted,94804,12,5,7
2018,Enlisted,94903,7,4,3
2018,Enlisted,94952,17,1,16
2018,Enlisted,95020,2,0,2
2018,Enlisted,95110,17,9,8
2018,Enlisted,95206,54,22,32
2018,Enlisted,95240,10,3,7
2018,Enlisted,95341,9,3,6
2018,Enlisted,95351,27,9,18
2018,Enlisted,95361,11,4,7
2018,Enlisted,95380,16,5,11
2018,Enlisted,95401,17,5,12
2018,Enlisted,95453,2,1,1
2018,Enlisted,95503,3,2,1
2018,Enlisted,95655,18,6,12
2018,Enlisted,95665,3,3,0
2018,Enlisted,95678,9,1,8
2018,Enlisted,95815,1,0,1
2018,Enlisted,95826,18,1,17
2018,Enlisted,95828,96,38,58
2018,Enlisted,95832,8,2,6
2018,Enlisted,95926,8,1,7
2018,Enlisted,95965,10,2,8
2018,Enlisted,96001,19,2,17
2018,Enlisted,96067,4,1,3
2018,Enlisted,96080,6,0,6
2018,Enlisted,96130,1,0,1
2018,Enlisted,96707,94,50,44
2018,Enlisted,96716,10,6,4
2018,Enlisted,96720,23,5,18
2018,Enlisted,96732,14,4,10
2018,Enlisted,96748,3,1,2
2018,Enlisted,96750,2,0,2
2018,Enlisted,96782,42,19,23
2018,Enlisted,96786,36,11,25
2018,Enlisted,96789,24,6,18
2018,Enlisted,96816,7,0,7
2018,Enlisted,96820,1,1,0
2018,Enlisted,96857,31,11,20
2018,Enlisted,96913,125,15,110
2018,Enlisted,97015,89,19,70
2018,Enlisted,97030,27,10,17
2018,Enlisted,97031,2,1,1
2018,Enlisted,97051,19,5,14
2018,Enlisted,97058,3,1,2
2018,Enlisted,97071,12,8,4
2018,Enlisted,97116,25,9,16
2018,Enlisted,97124,23,9,14
2018,Enlisted,97128,13,2,11
2018,Enlisted,97146,6,2,4
2018,Enlisted,97211,27,10,17
2018,Enlisted,97217,7,3,4
2018,Enlisted,97218,40,11,29
2018,Enlisted,97301,8,1,7
2018,Enlisted,97302,10,6,4
2018,Enlisted,97303,23,10,13
2018,Enlisted,97309,31,14,17
2018,Enlisted,97321,14,1,13
2018,Enlisted,97330,16,6,10
2018,Enlisted,97338,12,4,8
2018,Enlisted,97355,26,6,20
2018,Enlisted,97365,2,0,2
2018,Enlisted,97420,3,0,3
2018,Enlisted,97470,8,3,5
2018,Enlisted,97477,56,13,43
2018,Enlisted,97501,26,8,18
2018,Enlisted,97520,12,5,7
2018,Enlisted,97526,10,4,6
2018,Enlisted,97603,12,7,5
2018,Enlisted,97702,28,8,20
2018,Enlisted,97754,7,2,5
2018,Enlisted,97756,10,2,8
2018,Enlisted,97801,12,2,10
2018,Enlisted,97814,4,3,1
2018,Enlisted,97838,10,1,9
2018,Enlisted,97850,15,5,10
2018,Enlisted,97862,30,6,24
2018,Enlisted,97914,2,1,1
2018,Enlisted,98032,70,35,35
2018,Enlisted,98052,35,16,19
2018,Enlisted,98108,29,10,19
2018,Enlisted,98119,55,24,31
2018,Enlisted,98201,9,0,9
2018,Enlisted,98221,21,5,16
2018,Enlisted,98271,12,5,7
2018,Enlisted,98290,12,2,10
2018,Enlisted,98312,17,9,8
2018,Enlisted,98321,7,7,0
2018,Enlisted,98372,15,6,9
2018,Enlisted,98430,47,26,21
2018,Enlisted,98433,88,56,32
2018,Enlisted,98501,34,13,21
2018,Enlisted,98516,2,2,0
2018,Enlisted,98531,18,7,11
2018,Enlisted,98563,6,3,3
2018,Enlisted,98632,9,2,7
2018,Enlisted,98682,18,4,14
2018,Enlisted,98801,1,0,1
2018,Enlisted,98823,3,1,2
2018,Enlisted,98837,6,3,3
2018,Enlisted,98901,28,8,20
2018,Enlisted,98903,8,2,6
2018,Enlisted,98930,9,3,6
2018,Enlisted,99011,21,7,14
2018,Enlisted,99217,24,8,16
2018,Enlisted,99224,2,2,0
2018,Enlisted,99301,5,0,5
2018,Enlisted,99362,6,0,6
2018,Enlisted,99505,78,34,44
2018,Enlisted,99559,1,0,1
2018,Enlisted,99604,1,1,0
2018,Enlisted,99611,1,0,1
2018,Enlisted,99615,1,0,1
2018,Enlisted,99621,1,1,0
2018,Enlisted,99654,21,3,18
2018,Enlisted,99686,1,1,0
2018,Enlisted,99687,20,5,15
2018,Enlisted,99701,21,12,9
2018,Enlisted,99731,1,0,1
2018,Enlisted,99762,2,0,2
2018,Enlisted,99925,1,0,1
2018,Officer,00604,3,2,1
2018,Officer,00623,1,1,0
2018,Officer,00682,2,2,0
2018,Officer,00683,1,1,0
2018,Officer,00693,4,3,1
2018,Officer,00705,1,1,0
2018,Officer,00725,1,1,0
2018,Officer,00736,1,1,0
2018,Officer,00751,4,3,1
2018,Officer,00785,2,2,0
2018,Officer,00795,7,5,2
2018,Officer,00802,1,1,0
2018,Officer,00850,4,3,1
2018,Officer,00901,5,4,1
2018,Officer,00907,3,3,0
2018,Officer,00934,3,3,0
2018,Officer,01013,2,2,0
2018,Officer,01030,1,1,0
2018,Officer,01085,2,2,0
2018,Officer,01109,6,6,0
2018,Officer,01434,5,5,0
2018,Officer,01605,5,5,0
2018,Officer,01702,1,1,0
2018,Officer,01731,9,9,0
2018,Officer,01760,4,4,0
2018,Officer,01844,6,6,0
2018,Officer,01867,3,3,0
2018,Officer,02169,1,1,0
2018,Officer,02176,2,2,0
2018,Officer,02184,1,1,0
2018,Officer,02301,7,7,0
2018,Officer,02346,4,4,0
2018,Officer,02420,1,1,0
2018,Officer,02542,8,8,0
2018,Officer,02780,2,2,0
2018,Officer,02816,1,1,0
2018,Officer,02818,7,5,2
2018,Officer,02842,1,1,0
2018,Officer,02852,1,1,0
2018,Officer,02886,7,5,2
2018,Officer,02904,7,6,1
2018,Officer,03055,3,3,0
2018,Officer,03060,2,2,0
2018,Officer,03101,2,2,0
2018,Officer,03235,1,1,0
2018,Officer,03244,1,1,0
2018,Officer,03301,4,4,0
2018,Officer,03570,1,1,0
2018,Officer,03766,1,1,0
2018,Officer,03801,1,1,0
2018,Officer,04011,3,3,0
2018,Officer,04268,2,2,0
2018,Officer,04330,2,2,0
2018,Officer,04333,5,5,0
2018,Officer,04401,3,3,0
2018,Officer,04412,2,2,0
2018,Officer,04901,2,2,0
2018,Officer,05001,1,1,0
2018,Officer,05033,1,1,0
2018,Officer,05201,2,2,0
2018,Officer,05403,4,4,0
2018,Officer,05446,11,11,0
2018,Officer,05465,9,9,0
2018,Officer,05478,1,1,0
2018,Officer,05488,1,1,0
2018,Officer,05495,2,2,0
2018,Officer,05602,1,1,0
2018,Officer,05661,1,1,0
2018,Officer,05663,3,3,0
2018,Officer,05676,2,2,0
2018,Officer,05701,1,1,0
2018,Officer,05851,1,1,0
2018,Officer,05855,1,1,0
2018,Officer,06051,2,2,0
2018,Officer,06082,1,1,0
2018,Officer,06096,2,2,0
2018,Officer,06105,1,1,0
2018,Officer,06320,8,6,2
2018,Officer,06360,1,0,1
2018,Officer,06457,8,5,3
2018,Officer,06489,2,1,1
2018,Officer,06498,4,3,1
2018,Officer,06512,3,3,0
2018,Officer,06614,1,1,0
2018,Officer,06702,1,1,0
2018,Officer,06810,4,2,2
2018,Officer,07052,3,3,0
2018,Officer,07090,1,1,0
2018,Officer,07095,2,2,0
2018,Officer,07306,4,4,0
2018,Officer,07457,4,4,0
2018,Officer,07728,5,5,0
2018,Officer,07801,2,2,0
2018,Officer,07960,3,3,0
2018,Officer,08002,2,2,0
2018,Officer,08012,1,1,0
2018,Officer,08060,1,1,0
2018,Officer,08096,2,2,0
2018,Officer,08360,2,2,0
2018,Officer,08533,1,1,0
2018,Officer,08640,2,1,1
2018,Officer,08648,3,3,0
2018,Officer,08733,6,6,0
2018,Officer,08750,1,1,0
2018,Officer,08759,3,3,0
2018,Officer,08873,5,5,0
2018,Officer,10010,9,9,0
2018,Officer,10314,2,2,0
2018,Officer,10468,3,2,1
2018,Officer,10566,3,3,0
2018,Officer,10567,5,5,0
2018,Officer,10701,1,1,0
2018,Officer,11252,4,4,0
2018,Officer,11357,1,1,0
2018,Officer,11433,3,3,0
2018,Officer,11735,2,2,0
2018,Officer,11779,4,3,1
2018,Officer,12110,15,15,0
2018,Officer,12180,8,6,2
2018,Officer,12189,4,3,1
2018,Officer,12302,10,10,0
2018,Officer,12401,2,2,0
2018,Officer,12553,4,4,0
2018,Officer,12804,1,1,0
2018,Officer,13021,1,1,0
2018,Officer,13211,7,7,0
2018,Officer,13501,3,3,0
2018,Officer,13602,2,2,0
2018,Officer,13905,2,2,0
2018,Officer,14094,4,4,0
2018,Officer,14204,1,1,0
2018,Officer,14213,7,6,1
2018,Officer,14304,1,1,0
2018,Officer,14454,2,2,0
2018,Officer,14456,1,1,0
2018,Officer,14624,6,6,0
2018,Officer,14701,1,1,0
2018,Officer,14850,2,2,0
2018,Officer,15216,2,2,0
2018,Officer,15301,1,1,0
2018,Officer,15444,1,1,0
2018,Officer,15666,1,1,0
2018,Officer,15779,1,1,0
2018,Officer,15902,1,1,0
2018,Officer,15904,4,4,0
2018,Officer,16001,1,1,0
2018,Officer,16101,3,2,1
2018,Officer,16226,3,3,0
2018,Officer,16403,5,5,0
2018,Officer,16635,2,2,0
2018,Officer,16652,1,1,0
2018,Officer,16803,3,3,0
2018,Officer,16901,1,1,0
2018,Officer,17003,16,16,0
2018,Officer,17013,7,7,0
2018,Officer,17033,1,1,0
2018,Officer,17042,4,4,0
2018,Officer,17044,3,3,0
2018,Officer,17103,6,4,2
2018,Officer,17701,4,4,0
2018,Officer,17821,1,1,0
2018,Officer,17837,1,1,0
2018,Officer,18040,2,2,0
2018,Officer,18102,2,1,1
2018,Officer,18407,1,1,0
2018,Officer,18466,1,1,0
2018,Officer,18509,8,7,1
2018,Officer,18634,2,2,0
2018,Officer,18651,1,1,0
2018,Officer,18704,2,2,0
2018,Officer,18960,1,1,0
2018,Officer,19044,7,6,1
2018,Officer,19103,2,2,0
2018,Officer,19153,3,3,0
2018,Officer,19154,3,3,0
2018,Officer,19320,3,2,1
2018,Officer,19462,2,2,0
2018,Officer,19475,1,1,0
2018,Officer,19605,1,1,0
2018,Officer,19706,1,1,0
2018,Officer,19711,1,1,0
2018,Officer,19720,3,3,0
2018,Officer,19930,1,1,0
2018,Officer,19939,3,3,0
2018,Officer,19947,1,1,0
2018,Officer,19973,1,1,0
2018,Officer,19977,2,2,0
2018,Officer,20003,26,23,3
2018,Officer,20112,5,5,0
2018,Officer,20175,2,2,0
2018,Officer,20186,2,1,1
2018,Officer,20373,2,2,0
2018,Officer,20623,1,1,0
2018,Officer,20646,1,1,0
2018,Officer,20708,6,6,0
2018,Officer,20882,1,1,0
2018,Officer,21010,3,3,0
2018,Officer,21043,1,1,0
2018,Officer,21057,4,4,0
2018,Officer,21061,2,2,0
2018,Officer,21136,7,6,1
2018,Officer,21157,1,1,0
2018,Officer,21201,1,0,1
2018,Officer,21204,1,1,0
2018,Officer,21222,2,2,0
2018,Officer,21228,2,1,1
2018,Officer,21236,1,1,0
2018,Officer,21401,5,5,0
2018,Officer,21921,1,1,0
2018,Officer,22032,14,10,4
2018,Officer,22060,5,5,0
2018,Officer,22401,4,4,0
2018,Officer,22427,6,5,1
2018,Officer,22602,2,2,0
2018,Officer,22731,2,0,2
2018,Officer,22902,6,6,0
2018,Officer,23069,1,1,0
2018,Officer,23139,2,2,0
2018,Officer,23150,3,3,0
2018,Officer,23181,2,2,0
2018,Officer,23417,1,1,0
2018,Officer,23434,2,2,0
2018,Officer,23451,6,5,1
2018,Officer,23666,7,6,1
2018,Officer,23701,3,3,0
2018,Officer,23805,6,5,1
2018,Officer,23824,5,3,2
2018,Officer,23847,1,1,0
2018,Officer,23851,1,1,0
2018,Officer,24073,1,1,0
2018,Officer,24112,1,0,1
2018,Officer,24151,2,2,0
2018,Officer,24212,1,1,0
2018,Officer,24251,1,1,0
2018,Officer,24401,2,2,0
2018,Officer,24450,1,1,0
2018,Officer,24502,4,4,0
2018,Officer,24523,1,1,0
2018,Officer,24540,3,2,1
2018,Officer,24592,2,2,0
2018,Officer,24609,1,1,0
2018,Officer,24701,4,4,0
2018,Officer,24957,1,1,0
2018,Officer,25168,2,2,0
2018,Officer,25309,4,4,0
2018,Officer,25311,4,4,0
2018,Officer,25530,1,1,0
2018,Officer,25550,2,2,0
2018,Officer,25625,2,2,0
2018,Officer,25846,2,2,0
2018,Officer,26003,2,2,0
2018,Officer,26101,2,2,0
2018,Officer,26187,1,1,0
2018,Officer,26201,3,3,0
2018,Officer,26250,1,1,0
2018,Officer,26301,1,1,0
2018,Officer,26426,1,1,0
2018,Officer,26537,3,3,0
2018,Officer,26554,4,4,0
2018,Officer,26651,1,1,0
2018,Officer,27028,3,3,0
2018,Officer,27103,4,4,0
2018,Officer,27204,2,1,1
2018,Officer,27217,2,2,0
2018,Officer,27264,1,1,0
2018,Officer,27292,1,1,0
2018,Officer,27344,2,2,0
2018,Officer,27360,2,1,1
2018,Officer,27401,1,1,0
2018,Officer,27530,5,5,0
2018,Officer,27549,8,8,0
2018,Officer,27557,1,1,0
2018,Officer,27560,6,6,0
2018,Officer,27581,11,11,0
2018,Officer,27607,4,4,0
2018,Officer,27704,4,4,0
2018,Officer,27828,1,1,0
2018,Officer,27834,1,1,0
2018,Officer,27889,1,1,0
2018,Officer,27932,1,1,0
2018,Officer,28012,3,3,0
2018,Officer,28043,1,1,0
2018,Officer,28054,3,3,0
2018,Officer,28092,2,2,0
2018,Officer,28115,1,1,0
2018,Officer,28147,3,2,1
2018,Officer,28170,1,1,0
2018,Officer,28208,6,6,0
2018,Officer,28306,8,8,0
2018,Officer,28310,4,2,2
2018,Officer,28328,2,2,0
2018,Officer,28337,2,1,1
2018,Officer,28345,1,1,0
2018,Officer,28352,1,1,0
2018,Officer,28359,3,3,0
2018,Officer,28371,2,1,1
2018,Officer,28376,3,3,0
2018,Officer,28377,1,1,0
2018,Officer,28384,2,2,0
2018,Officer,28401,1,1,0
2018,Officer,28405,2,2,0
2018,Officer,28560,1,1,0
2018,Officer,28601,1,1,0
2018,Officer,28621,1,1,0
2018,Officer,28645,1,1,0
2018,Officer,28726,2,2,0
2018,Officer,28734,1,0,1
2018,Officer,28806,1,1,0
2018,Officer,29044,13,13,0
2018,Officer,29108,1,1,0
2018,Officer,29138,2,2,0
2018,Officer,29161,1,1,0
2018,Officer,29201,4,4,0
2018,Officer,29303,4,4,0
2018,Officer,29341,1,1,0
2018,Officer,29379,9,9,0
2018,Officer,29385,1,1,0
2018,Officer,29403,2,2,0
2018,Officer,29418,4,4,0
2018,Officer,29464,7,7,0
2018,Officer,29506,2,2,0
2018,Officer,29510,1,1,0
2018,Officer,29536,1,1,0
2018,Officer,29544,1,1,0
2018,Officer,29571,1,1,0
2018,Officer,29574,1,1,0
2018,Officer,29605,4,4,0
2018,Officer,29620,1,1,0
2018,Officer,29625,3,3,0
2018,Officer,29646,1,1,0
2018,Officer,29651,2,2,0
2018,Officer,29653,2,2,0
2018,Officer,29678,3,3,0
2018,Officer,29715,1,1,0
2018,Officer,29732,3,3,0
2018,Officer,29824,1,1,0
2018,Officer,29829,2,2,0
2018,Officer,29944,2,2,0
2018,Officer,30032,1,1,0
2018,Officer,30040,11,10,1
2018,Officer,30060,17,14,3
2018,Officer,30069,4,4,0
2018,Officer,30114,1,1,0
2018,Officer,30125,1,1,0
2018,Officer,30144,2,2,0
2018,Officer,30161,1,1,0
2018,Officer,30233,1,1,0
2018,Officer,30294,2,2,0
2018,Officer,30297,10,10,0
2018,Officer,30336,7,7,0
2018,Officer,30439,1,1,0
2018,Officer,30461,1,1,0
2018,Officer,30597,6,6,0
2018,Officer,30635,3,3,0
2018,Officer,30643,1,1,0
2018,Officer,30655,3,3,0
2018,Officer,30673,2,2,0
2018,Officer,30680,6,6,0
2018,Officer,30701,2,2,0
2018,Officer,30720,2,2,0
2018,Officer,30904,7,7,0
2018,Officer,31015,1,1,0
2018,Officer,31029,2,2,0
2018,Officer,31040,1,1,0
2018,Officer,31211,6,5,1
2018,Officer,31314,4,4,0
2018,Officer,31329,1,1,0
2018,Officer,31406,4,4,0
2018,Officer,31409,1,0,1
2018,Officer,31520,1,1,0
2018,Officer,31533,2,2,0
2018,Officer,31601,1,1,0
2018,Officer,31794,1,1,0
2018,Officer,31905,3,3,0
2018,Officer,32055,1,1,0
2018,Officer,32064,1,1,0
2018,Officer,32084,1,1,0
2018,Officer,32086,6,2,4
2018,Officer,32091,11,11,0
2018,Officer,32221,5,5,0
2018,Officer,32311,3,3,0
2018,Officer,32351,1,1,0
2018,Officer,32406,1,1,0
2018,Officer,32425,3,3,0
2018,Officer,32447,2,2,0
2018,Officer,32514,2,2,0
2018,Officer,32727,3,2,1
2018,Officer,32806,1,1,0
2018,Officer,32827,4,4,0
2018,Officer,32922,3,3,0
2018,Officer,32935,1,1,0
2018,Officer,33025,3,3,0
2018,Officer,33027,4,4,0
2018,Officer,33039,3,3,0
2018,Officer,33315,2,2,0
2018,Officer,33406,2,2,0
2018,Officer,33563,2,2,0
2018,Officer,33711,2,2,0
2018,Officer,33782,9,8,1
2018,Officer,33811,4,4,0
2018,Officer,33830,1,1,0
2018,Officer,33916,1,1,0
2018,Officer,34208,1,1,0
2018,Officer,34221,1,1,0
2018,Officer,34237,2,2,0
2018,Officer,34266,1,1,0
2018,Officer,34471,1,0,1
2018,Officer,34474,1,1,0
2018,Officer,34604,2,2,0
2018,Officer,34748,2,2,0
2018,Officer,35010,1,1,0
2018,Officer,35016,1,1,0
2018,Officer,35042,9,9,0
2018,Officer,35055,1,1,0
2018,Officer,35072,2,2,0
2018,Officer,35121,2,2,0
2018,Officer,35124,3,3,0
2018,Officer,35146,2,2,0
2018,Officer,35161,1,1,0
2018,Officer,35209,1,1,0
2018,Officer,35217,5,5,0
2018,Officer,35405,1,1,0
2018,Officer,35565,4,4,0
2018,Officer,35601,2,2,0
2018,Officer,35613,2,2,0
2018,Officer,35803,3,3,0
2018,Officer,35967,1,1,0
2018,Officer,36009,1,1,0
2018,Officer,36016,1,1,0
2018,Officer,36032,1,1,0
2018,Officer,36043,5,5,0
2018,Officer,36067,1,1,0
2018,Officer,36078,1,1,0
2018,Officer,36081,1,1,0
2018,Officer,36109,9,9,0
2018,Officer,36121,1,1,0
2018,Officer,36203,4,4,0
2018,Officer,36205,1,1,0
2018,Officer,36251,2,2,0
2018,Officer,36265,1,1,0
2018,Officer,36322,2,2,0
2018,Officer,36330,3,3,0
2018,Officer,36421,2,2,0
2018,Officer,36442,1,1,0
2018,Officer,36502,1,1,0
2018,Officer,36522,1,1,0
2018,Officer,36532,1,1,0
2018,Officer,36605,5,5,0
2018,Officer,36701,1,1,0
2018,Officer,36732,1,1,0
2018,Officer,36854,1,1,0
2018,Officer,37066,2,2,0
2018,Officer,37090,2,2,0
2018,Officer,37129,3,3,0
2018,Officer,37167,16,14,2
2018,Officer,37172,1,1,0
2018,Officer,37204,10,7,3
2018,Officer,37217,1,1,0
2018,Officer,37303,1,1,0
2018,Officer,37323,1,1,0
2018,Officer,37356,1,1,0
2018,Officer,37398,2,2,0
2018,Officer,37404,5,5,0
2018,Officer,37620,1,1,0
2018,Officer,37645,5,4,1
2018,Officer,37650,1,1,0
2018,Officer,37743,1,1,0
2018,Officer,37757,1,0,1
2018,Officer,37777,7,6,1
2018,Officer,37854,1,1,0
2018,Officer,37874,1,1,0
2018,Officer,37919,1,1,0
2018,Officer,38019,1,0,1
2018,Officer,38024,3,3,0
2018,Officer,38063,1,1,0
2018,Officer,38242,2,2,0
2018,Officer,38302,3,2,1
2018,Officer,38343,1,1,0
2018,Officer,38375,1,0,1
2018,Officer,38382,3,2,1
2018,Officer,38401,1,1,0
2018,Officer,38506,3,3,0
2018,Officer,38556,1,1,0
2018,Officer,38563,1,1,0
2018,Officer,38570,1,1,0
2018,Officer,38606,2,1,1
2018,Officer,38635,1,1,0
2018,Officer,38668,2,2,0
2018,Officer,38671,1,1,0
2018,Officer,38801,4,4,0
2018,Officer,38803,3,2,1
2018,Officer,38821,1,1,0
2018,Officer,38851,2,2,0
2018,Officer,38915,2,2,0
2018,Officer,39042,1,1,0
2018,Officer,39046,3,3,0
2018,Officer,39051,1,1,0
2018,Officer,39059,1,1,0
2018,Officer,39060,3,3,0
2018,Officer,39159,1,1,0
2018,Officer,39183,3,3,0
2018,Officer,39194,2,2,0
2018,Officer,39202,3,2,1
2018,Officer,39204,7,6,1
2018,Officer,39216,4,4,0
2018,Officer,39296,3,3,0
2018,Officer,39307,1,1,0
2018,Officer,39345,5,5,0
2018,Officer,39350,1,1,0
2018,Officer,39403,3,3,0
2018,Officer,39407,1,0,1
2018,Officer,39422,1,1,0
2018,Officer,39440,1,1,0
2018,Officer,39466,1,1,0
2018,Officer,39470,3,3,0
2018,Officer,39507,3,3,0
2018,Officer,39532,1,1,0
2018,Officer,39556,1,1,0
2018,Officer,39648,2,2,0
2018,Officer,39654,1,1,0
2018,Officer,39760,1,1,0
2018,Officer,39773,1,1,0
2018,Officer,40004,1,0,1
2018,Officer,40065,4,4,0
2018,Officer,40205,1,1,0
2018,Officer,40213,3,3,0
2018,Officer,40218,2,2,0
2018,Officer,40311,2,2,0
2018,Officer,40330,1,1,0
2018,Officer,40475,6,4,2
2018,Officer,40510,4,4,0
2018,Officer,40601,17,12,5
2018,Officer,40741,2,2,0
2018,Officer,40906,6,6,0
2018,Officer,40965,3,3,0
2018,Officer,41005,2,2,0
2018,Officer,41008,2,2,0
2018,Officer,41031,1,1,0
2018,Officer,41094,2,2,0
2018,Officer,41101,3,2,1
2018,Officer,41701,1,1,0
2018,Officer,42025,1,0,1
2018,Officer,42071,1,1,0
2018,Officer,42101,2,1,1
2018,Officer,42141,3,3,0
2018,Officer,42167,1,1,0
2018,Officer,42276,1,1,0
2018,Officer,42301,2,2,0
2018,Officer,42345,1,1,0
2018,Officer,42431,1,1,0
2018,Officer,42501,1,1,0
2018,Officer,42633,1,1,0
2018,Officer,43040,2,2,0
2018,Officer,43055,2,2,0
2018,Officer,43102,2,2,0
2018,Officer,43213,10,8,2
2018,Officer,43217,9,9,0
2018,Officer,43235,5,3,2
2018,Officer,43402,1,1,0
2018,Officer,43465,4,4,0
2018,Officer,43756,3,2,1
2018,Officer,43812,1,1,0
2018,Officer,44055,2,2,0
2018,Officer,44128,3,3,0
2018,Officer,44142,2,2,0
2018,Officer,44224,5,4,1
2018,Officer,44256,1,1,0
2018,Officer,44313,1,1,0
2018,Officer,44444,4,4,0
2018,Officer,44515,2,0,2
2018,Officer,44601,2,2,0
2018,Officer,44691,1,1,0
2018,Officer,44720,7,5,2
2018,Officer,44857,1,1,0
2018,Officer,44903,3,3,0
2018,Officer,45015,3,3,0
2018,Officer,45036,1,1,0
2018,Officer,45215,10,10,0
2018,Officer,45356,3,2,1
2018,Officer,45430,5,5,0
2018,Officer,45502,3,2,1
2018,Officer,45601,1,1,0
2018,Officer,45662,1,1,0
2018,Officer,45885,2,2,0
2018,Officer,46012,2,2,0
2018,Officer,46036,2,2,0
2018,Officer,46041,2,1,1
2018,Officer,46052,1,1,0
2018,Officer,46122,1,1,0
2018,Officer,46124,3,3,0
2018,Officer,46131,10,8,2
2018,Officer,46140,2,2,0
2018,Officer,46176,5,4,1
2018,Officer,46216,2,2,0
2018,Officer,46241,20,17,3
2018,Officer,46350,1,1,0
2018,Officer,46360,1,1,0
2018,Officer,46383,1,1,0
2018,Officer,46402,1,1,0
2018,Officer,46406,2,1,1
2018,Officer,46517,1,1,0
2018,Officer,46613,3,2,1
2018,Officer,46714,1,1,0
2018,Officer,46825,4,4,0
2018,Officer,46947,1,1,0
2018,Officer,46953,1,1,0
2018,Officer,47167,3,3,0
2018,Officer,47170,1,1,0
2018,Officer,47203,7,7,0
2018,Officer,47250,2,2,0
2018,Officer,47274,1,1,0
2018,Officer,47303,3,3,0
2018,Officer,47331,2,1,1
2018,Officer,47348,2,2,0
2018,Officer,47374,4,3,1
2018,Officer,47401,2,2,0
2018,Officer,47441,1,1,0
2018,Officer,47501,2,2,0
2018,Officer,47546,1,1,0
2018,Officer,47591,1,1,0
2018,Officer,47715,6,5,1
2018,Officer,47834,1,1,0
2018,Officer,47872,3,3,0
2018,Officer,47905,8,5,3
2018,Officer,48045,2,1,1
2018,Officer,48060,2,2,0
2018,Officer,48180,3,3,0
2018,Officer,48197,4,4,0
2018,Officer,48208,2,2,0
2018,Officer,48234,16,13,3
2018,Officer,48341,2,2,0
2018,Officer,48601,5,4,1
2018,Officer,48706,1,1,0
2018,Officer,48817,1,1,0
2018,Officer,48837,1,1,0
2018,Officer,48838,1,1,0
2018,Officer,48843,1,1,0
2018,Officer,48906,14,14,0
2018,Officer,48912,4,3,1
2018,Officer,49009,3,2,1
2018,Officer,49047,2,2,0
2018,Officer,49201,1,1,0
2018,Officer,49224,3,3,0
2018,Officer,49306,1,1,0
2018,Officer,49307,1,1,0
2018,Officer,49437,1,1,0
2018,Officer,49509,8,8,0
2018,Officer,49601,1,1,0
2018,Officer,49739,2,2,0
2018,Officer,49849,1,1,0
2018,Officer,49855,1,1,0
2018,Officer,49908,1,0,1
2018,Officer,50036,3,3,0
2018,Officer,50126,1,1,0
2018,Officer,50131,23,19,4
2018,Officer,50158,1,1,0
2018,Officer,50616,2,2,0
2018,Officer,50662,1,1,0
2018,Officer,50703,2,2,0
2018,Officer,51111,1,1,0
2018,Officer,51301,2,2,0
2018,Officer,51442,1,1,0
2018,Officer,51503,1,1,0
2018,Officer,51566,2,2,0
2018,Officer,52246,3,2,1
2018,Officer,52353,2,1,1
2018,Officer,52404,5,5,0
2018,Officer,52501,1,1,0
2018,Officer,52577,2,2,0
2018,Officer,52632,1,1,0
2018,Officer,52806,2,2,0
2018,Officer,53066,1,1,0
2018,Officer,53089,1,0,1
2018,Officer,53095,2,2,0
2018,Officer,53154,1,1,0
2018,Officer,53186,2,2,0
2018,Officer,53212,4,4,0
2018,Officer,53403,4,3,1
2018,Officer,53511,2,2,0
2018,Officer,53581,1,1,0
2018,Officer,53704,14,14,0
2018,Officer,53948,1,1,0
2018,Officer,54022,1,1,0
2018,Officer,54143,1,1,0
2018,Officer,54303,1,1,0
2018,Officer,54401,2,2,0
2018,Officer,54451,1,1,0
2018,Officer,54487,1,1,0
2018,Officer,54495,1,1,0
2018,Officer,54618,10,9,1
2018,Officer,54650,1,1,0
2018,Officer,54656,1,1,0
2018,Officer,54703,3,3,0
2018,Officer,54729,2,2,0
2018,Officer,54801,1,1,0
2018,Officer,54843,1,1,0
2018,Officer,54880,1,1,0
2018,Officer,54914,2,1,1
2018,Officer,54935,2,1,1
2018,Officer,54971,1,1,0
2018,Officer,55008,1,1,0
2018,Officer,55016,6,6,0
2018,Officer,55021,5,5,0
2018,Officer,55063,1,1,0
2018,Officer,55068,7,6,1
2018,Officer,55082,10,8,2
2018,Officer,55106,1,1,0
2018,Officer,55107,8,6,2
2018,Officer,55112,4,4,0
2018,Officer,55303,3,2,1
2018,Officer,55350,1,0,1
2018,Officer,55362,3,3,0
2018,Officer,55431,1,1,0
2018,Officer,55719,2,2,0
2018,Officer,55720,2,2,0
2018,Officer,55744,3,3,0
2018,Officer,55746,3,2,1
2018,Officer,55811,7,6,1
2018,Officer,55901,1,1,0
2018,Officer,55912,1,1,0
2018,Officer,55987,1,1,0
2018,Officer,56001,1,1,0
2018,Officer,56007,4,4,0
2018,Officer,56073,2,1,1
2018,Officer,56265,1,1,0
2018,Officer,56278,1,1,0
2018,Officer,56303,3,3,0
2018,Officer,56345,5,5,0
2018,Officer,56378,1,1,0
2018,Officer,56401,1,1,0
2018,Officer,56482,2,2,0
2018,Officer,56560,5,4,1
2018,Officer,56701,1,1,0
2018,Officer,57042,1,1,0
2018,Officer,57069,2,2,0
2018,Officer,57104,3,3,0
2018,Officer,57201,4,4,0
2018,Officer,57350,1,1,0
2018,Officer,57401,1,1,0
2018,Officer,57501,1,1,0
2018,Officer,57702,5,4,1
2018,Officer,57703,1,1,0
2018,Officer,57783,2,2,0
2018,Officer,58075,1,1,0
2018,Officer,58102,5,5,0
2018,Officer,58201,3,3,0
2018,Officer,58301,2,2,0
2018,Officer,58506,7,6,1
2018,Officer,58701,1,1,0
2018,Officer,59301,1,1,0
2018,Officer,59405,1,0,1
2018,Officer,59501,1,1,0
2018,Officer,59602,3,3,0
2018,Officer,59636,5,5,0
2018,Officer,59701,2,2,0
2018,Officer,59714,3,0,3
2018,Officer,59808,3,3,0
2018,Officer,60037,4,4,0
2018,Officer,60120,2,1,1
2018,Officer,60435,1,0,1
2018,Officer,60472,3,3,0
2018,Officer,60546,8,7,1
2018,Officer,60615,3,1,2
2018,Officer,60616,4,3,1
2018,Officer,60651,3,2,1
2018,Officer,60901,1,1,0
2018,Officer,61032,2,2,0
2018,Officer,61071,1,0,1
2018,Officer,61115,1,0,1
2018,Officer,61264,1,1,0
2018,Officer,61401,1,0,1
2018,Officer,61434,2,2,0
2018,Officer,61443,1,0,1
2018,Officer,61455,2,2,0
2018,Officer,61607,7,6,1
2018,Officer,61701,3,3,0
2018,Officer,61761,2,2,0
2018,Officer,61764,1,1,0
2018,Officer,61801,9,7,2
2018,Officer,61938,2,2,0
2018,Officer,61944,1,1,0
2018,Officer,61951,2,2,0
2018,Officer,62205,2,1,1
2018,Officer,62269,1,1,0
2018,Officer,62286,2,2,0
2018,Officer,62301,1,1,0
2018,Officer,62401,1,1,0
2018,Officer,62439,1,1,0
2018,Officer,62702,9,4,5
2018,Officer,62959,2,2,0
2018,Officer,62966,2,2,0
2018,Officer,63044,8,7,1
2018,Officer,63125,7,7,0
2018,Officer,63401,1,1,0
2018,Officer,63552,1,1,0
2018,Officer,63703,2,2,0
2018,Officer,63841,1,1,0
2018,Officer,63873,1,1,0
2018,Officer,63901,1,1,0
2018,Officer,64067,1,1,0
2018,Officer,64085,1,0,1
2018,Officer,64129,8,8,0
2018,Officer,64468,5,5,0
2018,Officer,64506,2,2,0
2018,Officer,64683,1,1,0
2018,Officer,64701,1,1,0
2018,Officer,64735,1,1,0
2018,Officer,64759,1,1,0
2018,Officer,64804,7,7,0
2018,Officer,64836,2,1,1
2018,Officer,64850,3,3,0
2018,Officer,65101,12,10,2
2018,Officer,65109,2,2,0
2018,Officer,65202,1,1,0
2018,Officer,65301,2,2,0
2018,Officer,65305,3,3,0
2018,Officer,65340,2,2,0
2018,Officer,65401,1,1,0
2018,Officer,65473,2,2,0
2018,Officer,65536,1,1,0
2018,Officer,65605,1,1,0
2018,Officer,65708,2,2,0
2018,Officer,65802,1,1,0
2018,Officer,66027,4,2,2
2018,Officer,66061,3,3,0
2018,Officer,66219,11,10,1
2018,Officer,66442,1,1,0
2018,Officer,66502,2,2,0
2018,Officer,66611,3,2,1
2018,Officer,66619,4,4,0
2018,Officer,66749,1,1,0
2018,Officer,66762,1,1,0
2018,Officer,67010,2,2,0
2018,Officer,67219,2,2,0
2018,Officer,67337,1,1,0
2018,Officer,67410,1,1,0
2018,Officer,67432,2,2,0
2018,Officer,67501,1,1,0
2018,Officer,67530,1,1,0
2018,Officer,67601,2,2,0
2018,Officer,67654,1,1,0
2018,Officer,68003,1,1,0
2018,Officer,68073,4,4,0
2018,Officer,68106,1,1,0
2018,Officer,68142,2,2,0
2018,Officer,68310,1,0,1
2018,Officer,68508,5,2,3
2018,Officer,68524,13,11,2
2018,Officer,68601,2,2,0
2018,Officer,68801,3,3,0
2018,Officer,68847,1,1,0
2018,Officer,68901,1,1,0
2018,Officer,70117,10,10,0
2018,Officer,70390,1,1,0
2018,Officer,70401,3,3,0
2018,Officer,70427,1,1,0
2018,Officer,70508,7,6,1
2018,Officer,70510,3,3,0
2018,Officer,70570,2,2,0
2018,Officer,70582,1,1,0
2018,Officer,70601,3,3,0
2018,Officer,70634,1,1,0
2018,Officer,70721,10,10,0
2018,Officer,70737,2,2,0
2018,Officer,70820,3,3,0
2018,Officer,71203,2,2,0
2018,Officer,71232,1,1,0
2018,Officer,71270,3,2,1
2018,Officer,71292,2,2,0
2018,Officer,71303,2,2,0
2018,Officer,71360,4,3,1
2018,Officer,71417,1,1,0
2018,Officer,71457,2,1,1
2018,Officer,71671,1,1,0
2018,Officer,71823,1,1,0
2018,Officer,72012,1,1,0
2018,Officer,72034,1,1,0
2018,Officer,72064,1,1,0
2018,Officer,72086,1,1,0
2018,Officer,72114,1,1,0
2018,Officer,72143,1,1,0
2018,Officer,72150,1,1,0
2018,Officer,72160,2,2,0
2018,Officer,72199,19,16,3
2018,Officer,72335,1,1,0
2018,Officer,72401,3,3,0
2018,Officer,72476,1,1,0
2018,Officer,72543,2,2,0
2018,Officer,72604,1,1,0
2018,Officer,72701,4,3,1
2018,Officer,72712,3,3,0
2018,Officer,72744,1,1,0
2018,Officer,72756,1,1,0
2018,Officer,72761,2,2,0
2018,Officer,72802,1,1,0
2018,Officer,72855,1,1,0
2018,Officer,72923,1,1,0
2018,Officer,72927,4,4,0
2018,Officer,73036,1,1,0
2018,Officer,73051,3,3,0
2018,Officer,73064,1,1,0
2018,Officer,73069,6,6,0
2018,Officer,73111,8,8,0
2018,Officer,73179,2,1,1
2018,Officer,73503,4,4,0
2018,Officer,73705,2,2,0
2018,Officer,74014,5,5,0
2018,Officer,74075,2,2,0
2018,Officer,74116,2,1,1
2018,Officer,74403,1,1,0
2018,Officer,74501,1,1,0
2018,Officer,74701,1,1,0
2018,Officer,74820,2,2,0
2018,Officer,75051,11,11,0
2018,Officer,75110,1,1,0
2018,Officer,75159,2,2,0
2018,Officer,75160,3,3,0
2018,Officer,75165,1,1,0
2018,Officer,75237,1,1,0
2018,Officer,75402,1,1,0
2018,Officer,75709,2,2,0
2018,Officer,75901,1,1,0
2018,Officer,76105,2,2,0
2018,Officer,76108,5,5,0
2018,Officer,76115,4,4,0
2018,Officer,76207,1,1,0
2018,Officer,76234,1,1,0
2018,Officer,76302,1,1,0
2018,Officer,76502,1,1,0
2018,Officer,76574,1,1,0
2018,Officer,76707,1,1,0
2018,Officer,77034,10,10,0
2018,Officer,77067,1,1,0
2018,Officer,77082,10,10,0
2018,Officer,77340,5,5,0
2018,Officer,77471,1,1,0
2018,Officer,77515,1,1,0
2018,Officer,77568,2,2,0
2018,Officer,77802,4,4,0
2018,Officer,78130,1,1,0
2018,Officer,78218,4,4,0
2018,Officer,78219,3,3,0
2018,Officer,78257,16,16,0
2018,Officer,78363,1,1,0
2018,Officer,78416,3,3,0
2018,Officer,78596,2,2,0
2018,Officer,78602,14,14,0
2018,Officer,78617,9,8,1
2018,Officer,78665,4,3,1
2018,Officer,78666,3,3,0
2018,Officer,78703,26,24,2
2018,Officer,78731,3,3,0
2018,Officer,78746,4,4,0
2018,Officer,79107,1,1,0
2018,Officer,79403,1,1,0
2018,Officer,79607,6,6,0
2018,Officer,79936,5,5,0
2018,Officer,80011,11,10,1
2018,Officer,80012,5,3,2
2018,Officer,80112,3,3,0
2018,Officer,80137,3,3,0
2018,Officer,80216,6,6,0
2018,Officer,80501,2,1,1
2018,Officer,80504,1,1,0
2018,Officer,80521,4,4,0
2018,Officer,80907,1,1,0
2018,Officer,80913,2,2,0
2018,Officer,80916,6,6,0
2018,Officer,80920,9,8,1
2018,Officer,81401,1,0,1
2018,Officer,82005,2,1,1
2018,Officer,82009,3,3,0
2018,Officer,82072,2,2,0
2018,Officer,82240,1,1,0
2018,Officer,82401,1,1,0
2018,Officer,82604,6,4,2
2018,Officer,83202,1,0,1
2018,Officer,83221,1,1,0
2018,Officer,83318,3,2,1
2018,Officer,83338,2,2,0
2018,Officer,83530,1,0,1
2018,Officer,83605,3,2,1
2018,Officer,83617,1,1,0
2018,Officer,83687,2,2,0
2018,Officer,83705,11,7,4
2018,Officer,83843,1,1,0
2018,Officer,83854,1,1,0
2018,Officer,84003,2,2,0
2018,Officer,84020,9,9,0
2018,Officer,84043,2,2,0
2018,Officer,84058,3,3,0
2018,Officer,84065,11,10,1
2018,Officer,84084,9,9,0
2018,Officer,84116,1,1,0
2018,Officer,84321,1,1,0
2018,Officer,84405,3,3,0
2018,Officer,84642,1,1,0
2018,Officer,84660,6,6,0
2018,Officer,84720,3,3,0
2018,Officer,84770,1,1,0
2018,Officer,84790,2,2,0
2018,Officer,85008,29,27,2
2018,Officer,85020,3,3,0
2018,Officer,85122,3,3,0
2018,Officer,85128,2,2,0
2018,Officer,85132,2,2,0
2018,Officer,85145,3,2,1
2018,Officer,85281,3,3,0
2018,Officer,85312,3,3,0
2018,Officer,85396,1,1,0
2018,Officer,85607,1,1,0
2018,Officer,85653,1,1,0
2018,Officer,85706,1,1,0
2018,Officer,85713,3,3,0
2018,Officer,86015,2,2,0
2018,Officer,86301,3,2,1
2018,Officer,87123,9,8,1
2018,Officer,87144,10,10,0
2018,Officer,87401,2,2,0
2018,Officer,87508,8,8,0
2018,Officer,88007,3,3,0
2018,Officer,88203,1,1,0
2018,Officer,88310,2,2,0
2018,Officer,88435,3,3,0
2018,Officer,89002,1,1,0
2018,Officer,89032,1,1,0
2018,Officer,89115,2,2,0
2018,Officer,89139,4,4,0
2018,Officer,89165,7,7,0
2018,Officer,89406,3,3,0
2018,Officer,89506,5,5,0
2018,Officer,89509,1,1,0
2018,Officer,89701,7,7,0
2018,Officer,90025,1,1,0
2018,Officer,90201,6,6,0
2018,Officer,90266,2,2,0
2018,Officer,90501,1,1,0
2018,Officer,90720,15,15,0
2018,Officer,90813,3,3,0
2018,Officer,90822,3,3,0
2018,Officer,91205,2,2,0
2018,Officer,91406,2,2,0
2018,Officer,91505,3,3,0
2018,Officer,91702,6,6,0
2018,Officer,91764,1,1,0
2018,Officer,91766,2,2,0
2018,Officer,91950,1,1,0
2018,Officer,92020,1,1,0
2018,Officer,92111,4,4,0
2018,Officer,92243,1,1,0
2018,Officer,92410,1,1,0
2018,Officer,92518,4,4,0
2018,Officer,92833,1,1,0
2018,Officer,93003,1,1,0
2018,Officer,93257,1,1,0
2018,Officer,93307,1,1,0
2018,Officer,93405,1,1,0
2018,Officer,93454,2,2,0
2018,Officer,93536,3,3,0
2018,Officer,93550,1,1,0
2018,Officer,93727,2,2,0
2018,Officer,94043,1,1,0
2018,Officer,94132,3,3,0
2018,Officer,94401,1,1,0
2018,Officer,94510,2,2,0
2018,Officer,94533,3,3,0
2018,Officer,94565,1,1,0
2018,Officer,94568,1,1,0
2018,Officer,94590,1,1,0
2018,Officer,95020,1,1,0
2018,Officer,95110,1,1,0
2018,Officer,95206,3,3,0
2018,Officer,95240,1,1,0
2018,Officer,95351,1,1,0
2018,Officer,95361,1,1,0
2018,Officer,95401,1,1,0
2018,Officer,95503,1,1,0
2018,Officer,95678,1,1,0
2018,Officer,95826,5,5,0
2018,Officer,95828,2,2,0
2018,Officer,95926,1,1,0
2018,Officer,96707,19,14,5
2018,Officer,96720,3,3,0
2018,Officer,96732,1,1,0
2018,Officer,96750,1,1,0
2018,Officer,96782,10,10,0
2018,Officer,96786,5,4,1
2018,Officer,96789,2,2,0
2018,Officer,96857,1,1,0
2018,Officer,96913,8,6,2
2018,Officer,97015,3,3,0
2018,Officer,97058,1,1,0
2018,Officer,97116,1,1,0
2018,Officer,97124,3,2,1
2018,Officer,97211,3,3,0
2018,Officer,97218,2,2,0
2018,Officer,97301,4,3,1
2018,Officer,97302,1,1,0
2018,Officer,97303,1,0,1
2018,Officer,97309,12,8,4
2018,Officer,97321,1,1,0
2018,Officer,97330,1,1,0
2018,Officer,97355,3,3,0
2018,Officer,97470,1,1,0
2018,Officer,97477,3,3,0
2018,Officer,97501,1,1,0
2018,Officer,97702,2,1,1
2018,Officer,97754,2,2,0
2018,Officer,97850,2,2,0
2018,Officer,97914,1,1,0
2018,Officer,98032,3,3,0
2018,Officer,98108,2,2,0
2018,Officer,98119,10,10,0
2018,Officer,98221,3,3,0
2018,Officer,98271,1,1,0
2018,Officer,98430,8,8,0
2018,Officer,98433,4,4,0
2018,Officer,98501,3,3,0
2018,Officer,98531,1,1,0
2018,Officer,98682,2,2,0
2018,Officer,98901,1,1,0
2018,Officer,98903,2,2,0
2018,Officer,99011,1,1,0
2018,Officer,99217,5,5,0
2018,Officer,99301,1,1,0
2018,Officer,99505,7,6,1
2018,Officer,99654,1,1,0
2018,Officer,99687,4,3,1
2018,Officer,99701,2,2,0
2018,Warrant Officer,00725,1,1,0
2018,Warrant Officer,00850,1,1,0
2018,Warrant Officer,00901,2,2,0
2018,Warrant Officer,01085,4,4,0
2018,Warrant Officer,01434,2,2,0
2018,Warrant Officer,01702,2,2,0
2018,Warrant Officer,01731,2,2,0
2018,Warrant Officer,01867,1,1,0
2018,Warrant Officer,02542,6,6,0
2018,Warrant Officer,02852,1,1,0
2018,Warrant Officer,03101,2,2,0
2018,Warrant Officer,03301,4,4,0
2018,Warrant Officer,03815,1,1,0
2018,Warrant Officer,04330,1,1,0
2018,Warrant Officer,04333,2,2,0
2018,Warrant Officer,04401,3,3,0
2018,Warrant Officer,05403,3,3,0
2018,Warrant Officer,05446,2,2,0
2018,Warrant Officer,06096,3,3,0
2018,Warrant Officer,06105,2,2,0
2018,Warrant Officer,06320,1,1,0
2018,Warrant Officer,06457,1,1,0
2018,Warrant Officer,07052,1,1,0
2018,Warrant Officer,07801,1,1,0
2018,Warrant Officer,07865,1,1,0
2018,Warrant Officer,08648,2,2,0
2018,Warrant Officer,08733,5,5,0
2018,Warrant Officer,10314,1,1,0
2018,Warrant Officer,10567,1,1,0
2018,Warrant Officer,11252,1,1,0
2018,Warrant Officer,11779,2,2,0
2018,Warrant Officer,12110,9,9,0
2018,Warrant Officer,12180,1,1,0
2018,Warrant Officer,12401,1,1,0
2018,Warrant Officer,13211,3,3,0
2018,Warrant Officer,13905,1,1,0
2018,Warrant Officer,14624,3,3,0
2018,Warrant Officer,15301,1,1,0
2018,Warrant Officer,15902,1,1,0
2018,Warrant Officer,17003,8,8,0
2018,Warrant Officer,17013,1,1,0
2018,Warrant Officer,17022,1,1,0
2018,Warrant Officer,17103,1,1,0
2018,Warrant Officer,18102,1,1,0
2018,Warrant Officer,19044,1,1,0
2018,Warrant Officer,19720,2,2,0
2018,Warrant Officer,19973,1,1,0
2018,Warrant Officer,20003,7,7,0
2018,Warrant Officer,20112,2,2,0
2018,Warrant Officer,20373,1,1,0
2018,Warrant Officer,20708,2,2,0
2018,Warrant Officer,21010,4,4,0
2018,Warrant Officer,21057,1,1,0
2018,Warrant Officer,21078,1,1,0
2018,Warrant Officer,21201,2,2,0
2018,Warrant Officer,21204,1,1,0
2018,Warrant Officer,22032,1,1,0
2018,Warrant Officer,22060,1,1,0
2018,Warrant Officer,22427,1,1,0
2018,Warrant Officer,23150,3,3,0
2018,Warrant Officer,23237,1,1,0
2018,Warrant Officer,23502,1,1,0
2018,Warrant Officer,23824,1,1,0
2018,Warrant Officer,24401,1,1,0
2018,Warrant Officer,25846,1,1,0
2018,Warrant Officer,26003,4,4,0
2018,Warrant Officer,26101,1,1,0
2018,Warrant Officer,26187,1,1,0
2018,Warrant Officer,26330,1,1,0
2018,Warrant Officer,26537,4,4,0
2018,Warrant Officer,27401,2,2,0
2018,Warrant Officer,27560,6,6,0
2018,Warrant Officer,27607,1,1,0
2018,Warrant Officer,27870,2,2,0
2018,Warrant Officer,28001,2,2,0
2018,Warrant Officer,28147,8,8,0
2018,Warrant Officer,28328,1,1,0
2018,Warrant Officer,28658,1,1,0
2018,Warrant Officer,29006,1,1,0
2018,Warrant Officer,29044,8,8,0
2018,Warrant Officer,29115,1,1,0
2018,Warrant Officer,29201,2,2,0
2018,Warrant Officer,29360,1,1,0
2018,Warrant Officer,29605,3,3,0
2018,Warrant Officer,29625,2,2,0
2018,Warrant Officer,29732,1,1,0
2018,Warrant Officer,30032,1,1,0
2018,Warrant Officer,30060,15,15,0
2018,Warrant Officer,30069,1,1,0
2018,Warrant Officer,30161,1,1,0
2018,Warrant Officer,30294,4,4,0
2018,Warrant Officer,30297,5,5,0
2018,Warrant Officer,30635,1,1,0
2018,Warrant Officer,30680,1,1,0
2018,Warrant Officer,30905,1,1,0
2018,Warrant Officer,31211,4,4,0
2018,Warrant Officer,31314,1,1,0
2018,Warrant Officer,31406,1,1,0
2018,Warrant Officer,31409,2,2,0
2018,Warrant Officer,31794,2,2,0
2018,Warrant Officer,32086,3,3,0
2018,Warrant Officer,32091,1,1,0
2018,Warrant Officer,32221,11,11,0
2018,Warrant Officer,32827,2,2,0
2018,Warrant Officer,33039,1,1,0
2018,Warrant Officer,33315,1,1,0
2018,Warrant Officer,33811,1,1,0
2018,Warrant Officer,34604,4,4,0
2018,Warrant Officer,35209,2,2,0
2018,Warrant Officer,35217,2,2,0
2018,Warrant Officer,35405,1,1,0
2018,Warrant Officer,35601,1,1,0
2018,Warrant Officer,35904,1,1,0
2018,Warrant Officer,36043,7,7,0
2018,Warrant Officer,36067,1,1,0
2018,Warrant Officer,36109,4,4,0
2018,Warrant Officer,36203,3,3,0
2018,Warrant Officer,36522,1,1,0
2018,Warrant Officer,36605,3,3,0
2018,Warrant Officer,36608,4,4,0
2018,Warrant Officer,37091,1,1,0
2018,Warrant Officer,37167,2,2,0
2018,Warrant Officer,37204,5,5,0
2018,Warrant Officer,37217,2,2,0
2018,Warrant Officer,37303,1,1,0
2018,Warrant Officer,37388,1,1,0
2018,Warrant Officer,37398,2,2,0
2018,Warrant Officer,37404,1,1,0
2018,Warrant Officer,37717,1,1,0
2018,Warrant Officer,37757,1,1,0
2018,Warrant Officer,37777,2,2,0
2018,Warrant Officer,37919,2,2,0
2018,Warrant Officer,38118,1,1,0
2018,Warrant Officer,38301,13,13,0
2018,Warrant Officer,38302,2,2,0
2018,Warrant Officer,38671,3,3,0
2018,Warrant Officer,38801,3,3,0
2018,Warrant Officer,38901,1,1,0
2018,Warrant Officer,39183,2,2,0
2018,Warrant Officer,39204,2,2,0
2018,Warrant Officer,39209,2,2,0
2018,Warrant Officer,39296,2,2,0
2018,Warrant Officer,39307,2,2,0
2018,Warrant Officer,39367,1,1,0
2018,Warrant Officer,39440,4,4,0
2018,Warrant Officer,39505,1,1,0
2018,Warrant Officer,39730,2,2,0
2018,Warrant Officer,39760,1,1,0
2018,Warrant Officer,40475,1,1,0
2018,Warrant Officer,40510,1,1,0
2018,Warrant Officer,40601,11,11,0
2018,Warrant Officer,43213,3,3,0
2018,Warrant Officer,43217,7,7,0
2018,Warrant Officer,43756,1,1,0
2018,Warrant Officer,44720,1,1,0
2018,Warrant Officer,45015,1,1,0
2018,Warrant Officer,45215,1,1,0
2018,Warrant Officer,45502,1,1,0
2018,Warrant Officer,45601,1,1,0
2018,Warrant Officer,46124,1,1,0
2018,Warrant Officer,46131,3,3,0
2018,Warrant Officer,46176,4,4,0
2018,Warrant Officer,46241,6,6,0
2018,Warrant Officer,46360,1,1,0
2018,Warrant Officer,46402,1,1,0
2018,Warrant Officer,46406,6,6,0
2018,Warrant Officer,47374,1,1,0
2018,Warrant Officer,47401,1,1,0
2018,Warrant Officer,47715,1,1,0
2018,Warrant Officer,48045,1,1,0
2018,Warrant Officer,48180,1,1,0
2018,Warrant Officer,48208,2,2,0
2018,Warrant Officer,48837,5,5,0
2018,Warrant Officer,48843,4,4,0
2018,Warrant Officer,48906,2,2,0
2018,Warrant Officer,49009,1,1,0
2018,Warrant Officer,49306,1,1,0
2018,Warrant Officer,49739,2,2,0
2018,Warrant Officer,50036,4,4,0
2018,Warrant Officer,50131,11,11,0
2018,Warrant Officer,50401,1,1,0
2018,Warrant Officer,50501,2,2,0
2018,Warrant Officer,50703,2,2,0
2018,Warrant Officer,51111,2,2,0
2018,Warrant Officer,52002,1,1,0
2018,Warrant Officer,52404,1,1,0
2018,Warrant Officer,52556,1,1,0
2018,Warrant Officer,52806,1,1,0
2018,Warrant Officer,53704,3,3,0
2018,Warrant Officer,53821,1,1,0
2018,Warrant Officer,54660,1,1,0
2018,Warrant Officer,55068,3,3,0
2018,Warrant Officer,55077,1,1,0
2018,Warrant Officer,55101,1,1,0
2018,Warrant Officer,55107,6,6,0
2018,Warrant Officer,55303,1,1,0
2018,Warrant Officer,55431,3,3,0
2018,Warrant Officer,55443,1,1,0
2018,Warrant Officer,56301,3,3,0
2018,Warrant Officer,56345,6,6,0
2018,Warrant Officer,57104,1,1,0
2018,Warrant Officer,57201,1,1,0
2018,Warrant Officer,57501,1,1,0
2018,Warrant Officer,57702,1,1,0
2018,Warrant Officer,57703,6,6,0
2018,Warrant Officer,58075,1,1,0
2018,Warrant Officer,58102,1,1,0
2018,Warrant Officer,58506,6,6,0
2018,Warrant Officer,59602,9,9,0
2018,Warrant Officer,59901,1,1,0
2018,Warrant Officer,60615,1,1,0
2018,Warrant Officer,60616,3,3,0
2018,Warrant Officer,60651,2,2,0
2018,Warrant Officer,60901,2,2,0
2018,Warrant Officer,61401,1,1,0
2018,Warrant Officer,61607,1,1,0
2018,Warrant Officer,61701,1,1,0
2018,Warrant Officer,61761,1,1,0
2018,Warrant Officer,62521,2,2,0
2018,Warrant Officer,62966,1,1,0
2018,Warrant Officer,63703,1,1,0
2018,Warrant Officer,64506,1,1,0
2018,Warrant Officer,65305,3,3,0
2018,Warrant Officer,65802,1,1,0
2018,Warrant Officer,65803,1,1,0
2018,Warrant Officer,66027,3,3,0
2018,Warrant Officer,66502,3,3,0
2018,Warrant Officer,66619,3,3,0
2018,Warrant Officer,67401,2,2,0
2018,Warrant Officer,67701,1,1,0
2018,Warrant Officer,68106,1,1,0
2018,Warrant Officer,68508,1,1,0
2018,Warrant Officer,68524,3,3,0
2018,Warrant Officer,68801,1,1,0
2018,Warrant Officer,68847,1,1,0
2018,Warrant Officer,70117,3,3,0
2018,Warrant Officer,70401,4,4,0
2018,Warrant Officer,71055,1,1,0
2018,Warrant Officer,71360,5,5,0
2018,Warrant Officer,71913,1,1,0
2018,Warrant Officer,72199,8,8,0
2018,Warrant Officer,72543,1,1,0
2018,Warrant Officer,72701,1,1,0
2018,Warrant Officer,73051,4,4,0
2018,Warrant Officer,73069,2,2,0
2018,Warrant Officer,73111,1,1,0
2018,Warrant Officer,74116,1,1,0
2018,Warrant Officer,74158,1,1,0
2018,Warrant Officer,74820,2,2,0
2018,Warrant Officer,75051,5,5,0
2018,Warrant Officer,75570,1,1,0
2018,Warrant Officer,76108,1,1,0
2018,Warrant Officer,76115,1,1,0
2018,Warrant Officer,76401,1,1,0
2018,Warrant Officer,76528,1,1,0
2018,Warrant Officer,77034,5,5,0
2018,Warrant Officer,78218,1,1,0
2018,Warrant Officer,78257,1,1,0
2018,Warrant Officer,78617,3,3,0
2018,Warrant Officer,78666,1,1,0
2018,Warrant Officer,78703,3,3,0
2018,Warrant Officer,78719,1,1,0
2018,Warrant Officer,78731,1,1,0
2018,Warrant Officer,80011,13,13,0
2018,Warrant Officer,80112,2,2,0
2018,Warrant Officer,80216,2,2,0
2018,Warrant Officer,80521,1,1,0
2018,Warrant Officer,80751,1,1,0
2018,Warrant Officer,81401,1,1,0
2018,Warrant Officer,82005,5,5,0
2018,Warrant Officer,82009,1,1,0
2018,Warrant Officer,82072,2,2,0
2018,Warrant Officer,82214,1,1,0
2018,Warrant Officer,83501,1,1,0
2018,Warrant Officer,83705,6,6,0
2018,Warrant Officer,84020,2,2,0
2018,Warrant Officer,84065,8,8,0
2018,Warrant Officer,84084,10,10,0
2018,Warrant Officer,84116,1,1,0
2018,Warrant Officer,84405,1,1,0
2018,Warrant Officer,84660,1,1,0
2018,Warrant Officer,85008,8,8,0
2018,Warrant Officer,85145,4,4,0
2018,Warrant Officer,85653,6,6,0
2018,Warrant Officer,87144,5,5,0
2018,Warrant Officer,87508,3,3,0
2018,Warrant Officer,88007,1,1,0
2018,Warrant Officer,89032,1,1,0
2018,Warrant Officer,89139,2,2,0
2018,Warrant Officer,89506,2,2,0
2018,Warrant Officer,89701,2,2,0
2018,Warrant Officer,90201,1,1,0
2018,Warrant Officer,90720,16,16,0
2018,Warrant Officer,90822,2,2,0
2018,Warrant Officer,91702,1,1,0
2018,Warrant Officer,92111,1,1,0
2018,Warrant Officer,93405,2,2,0
2018,Warrant Officer,93955,1,1,0
2018,Warrant Officer,94132,1,1,0
2018,Warrant Officer,95206,2,2,0
2018,Warrant Officer,95401,1,1,0
2018,Warrant Officer,95665,2,2,0
2018,Warrant Officer,95678,1,1,0
2018,Warrant Officer,95826,1,1,0
2018,Warrant Officer,95828,1,1,0
2018,Warrant Officer,96707,2,2,0
2018,Warrant Officer,96720,4,4,0
2018,Warrant Officer,96732,1,1,0
2018,Warrant Officer,96750,1,1,0
2018,Warrant Officer,96782,1,1,0
2018,Warrant Officer,96786,1,1,0
2018,Warrant Officer,96857,3,3,0
2018,Warrant Officer,96913,3,3,0
2018,Warrant Officer,97146,1,1,0
2018,Warrant Officer,97211,1,1,0
2018,Warrant Officer,97302,2,2,0
2018,Warrant Officer,97501,1,1,0
2018,Warrant Officer,97801,1,1,0
2018,Warrant Officer,98433,7,7,0
2018,Warrant Officer,98903,1,1,0
2018,Warrant Officer,99505,4,4,0
2018,Warrant Officer,99701,2,2,0
2019,Enlisted,     ,3,0,3
2019,Enlisted,00000,4,1,3
2019,Enlisted,00604,14,3,11
2019,Enlisted,00612,8,3,5
2019,Enlisted,00623,14,2,12
2019,Enlisted,00624,24,0,24
2019,Enlisted,00641,3,0,3
2019,Enlisted,00682,29,1,28
2019,Enlisted,00683,2,0,2
2019,Enlisted,00693,16,1,15
2019,Enlisted,00705,17,4,13
2019,Enlisted,00714,17,1,16
2019,Enlisted,00725,11,3,8
2019,Enlisted,00735,34,2,32
2019,Enlisted,00736,24,1,23
2019,Enlisted,00751,28,1,27
2019,Enlisted,00769,9,1,8
2019,Enlisted,00785,8,1,7
2019,Enlisted,00792,29,4,25
2019,Enlisted,00795,92,7,85
2019,Enlisted,00802,10,0,10
2019,Enlisted,00850,15,1,14
2019,Enlisted,00901,12,0,12
2019,Enlisted,00907,4,0,4
2019,Enlisted,00934,55,5,50
2019,Enlisted,00951,12,1,11
2019,Enlisted,01013,12,6,6
2019,Enlisted,01022,1,1,0
2019,Enlisted,01030,18,2,16
2019,Enlisted,01062,1,0,1
2019,Enlisted,01082,21,1,20
2019,Enlisted,01085,9,0,9
2019,Enlisted,01109,15,1,14
2019,Enlisted,01201,7,3,4
2019,Enlisted,01301,4,1,3
2019,Enlisted,01434,42,7,35
2019,Enlisted,01440,11,1,10
2019,Enlisted,01453,3,0,3
2019,Enlisted,01588,10,2,8
2019,Enlisted,01605,67,7,60
2019,Enlisted,01701,1,1,0
2019,Enlisted,01702,27,2,25
2019,Enlisted,01731,7,0,7
2019,Enlisted,01760,22,6,16
2019,Enlisted,01844,24,4,20
2019,Enlisted,01867,44,8,36
2019,Enlisted,01923,6,2,4
2019,Enlisted,01950,6,3,3
2019,Enlisted,02043,9,3,6
2019,Enlisted,02122,10,1,9
2019,Enlisted,02138,7,3,4
2019,Enlisted,02169,29,2,27
2019,Enlisted,02176,27,5,22
2019,Enlisted,02184,12,5,7
2019,Enlisted,02301,29,4,25
2019,Enlisted,02324,9,0,9
2019,Enlisted,02346,10,1,9
2019,Enlisted,02420,5,0,5
2019,Enlisted,02532,8,2,6
2019,Enlisted,02542,75,14,61
2019,Enlisted,02724,9,0,9
2019,Enlisted,02769,23,2,21
2019,Enlisted,02780,20,2,18
2019,Enlisted,02809,5,1,4
2019,Enlisted,02818,159,38,121
2019,Enlisted,02842,16,11,5
2019,Enlisted,02852,33,6,27
2019,Enlisted,02885,36,1,35
2019,Enlisted,02886,8,1,7
2019,Enlisted,02896,10,4,6
2019,Enlisted,02904,18,0,18
2019,Enlisted,02906,2,0,2
2019,Enlisted,02920,9,8,1
2019,Enlisted,03055,26,8,18
2019,Enlisted,03060,10,0,10
2019,Enlisted,03101,23,10,13
2019,Enlisted,03235,1,1,0
2019,Enlisted,03244,16,0,16
2019,Enlisted,03264,15,5,10
2019,Enlisted,03275,2,0,2
2019,Enlisted,03301,66,20,46
2019,Enlisted,03561,22,2,20
2019,Enlisted,03766,17,2,15
2019,Enlisted,03801,4,2,2
2019,Enlisted,03867,5,2,3
2019,Enlisted,03878,7,0,7
2019,Enlisted,03884,3,0,3
2019,Enlisted,04011,19,2,17
2019,Enlisted,04073,9,4,5
2019,Enlisted,04092,4,1,3
2019,Enlisted,04240,14,3,11
2019,Enlisted,04268,19,4,15
2019,Enlisted,04330,16,0,16
2019,Enlisted,04333,5,2,3
2019,Enlisted,04401,31,5,26
2019,Enlisted,04412,28,11,17
2019,Enlisted,04730,7,0,7
2019,Enlisted,04736,1,0,1
2019,Enlisted,04901,21,3,18
2019,Enlisted,04976,4,0,4
2019,Enlisted,05001,8,4,4
2019,Enlisted,05033,14,2,12
2019,Enlisted,05158,3,1,2
2019,Enlisted,05201,10,5,5
2019,Enlisted,05403,9,2,7
2019,Enlisted,05404,12,3,9
2019,Enlisted,05446,22,12,10
2019,Enlisted,05450,5,2,3
2019,Enlisted,05465,29,16,13
2019,Enlisted,05478,6,1,5
2019,Enlisted,05488,5,3,2
2019,Enlisted,05491,5,5,0
2019,Enlisted,05495,22,6,16
2019,Enlisted,05602,7,3,4
2019,Enlisted,05661,5,2,3
2019,Enlisted,05663,22,8,14
2019,Enlisted,05676,6,1,5
2019,Enlisted,05701,7,1,6
2019,Enlisted,05851,8,2,6
2019,Enlisted,05855,2,0,2
2019,Enlisted,06051,24,7,17
2019,Enlisted,06066,6,0,6
2019,Enlisted,06082,14,0,14
2019,Enlisted,06096,38,4,34
2019,Enlisted,06105,4,3,1
2019,Enlisted,06110,38,4,34
2019,Enlisted,06320,42,1,41
2019,Enlisted,06340,17,1,16
2019,Enlisted,06357,23,8,15
2019,Enlisted,06360,39,3,36
2019,Enlisted,06457,47,5,42
2019,Enlisted,06470,1,1,0
2019,Enlisted,06489,15,3,12
2019,Enlisted,06497,2,0,2
2019,Enlisted,06498,41,2,39
2019,Enlisted,06512,35,9,26
2019,Enlisted,06614,15,2,13
2019,Enlisted,06702,8,2,6
2019,Enlisted,06810,37,9,28
2019,Enlisted,07052,35,7,28
2019,Enlisted,07090,30,6,24
2019,Enlisted,07095,21,4,17
2019,Enlisted,07107,14,3,11
2019,Enlisted,07306,43,12,31
2019,Enlisted,07457,23,3,20
2019,Enlisted,07666,69,7,62
2019,Enlisted,07728,35,3,32
2019,Enlisted,07801,28,4,24
2019,Enlisted,07806,22,1,21
2019,Enlisted,07840,4,3,1
2019,Enlisted,07865,17,3,14
2019,Enlisted,07871,1,0,1
2019,Enlisted,07960,52,4,48
2019,Enlisted,08002,27,5,22
2019,Enlisted,08012,16,2,14
2019,Enlisted,08037,9,1,8
2019,Enlisted,08060,12,2,10
2019,Enlisted,08096,34,4,30
2019,Enlisted,08098,29,1,28
2019,Enlisted,08210,12,1,11
2019,Enlisted,08360,25,2,23
2019,Enlisted,08401,5,1,4
2019,Enlisted,08640,12,5,7
2019,Enlisted,08648,12,1,11
2019,Enlisted,08733,60,11,49
2019,Enlisted,08750,53,9,44
2019,Enlisted,08753,16,2,14
2019,Enlisted,08755,3,1,2
2019,Enlisted,08759,16,2,14
2019,Enlisted,08822,18,0,18
2019,Enlisted,08873,51,2,49
2019,Enlisted,10010,99,26,73
2019,Enlisted,10021,1,1,0
2019,Enlisted,10037,81,10,71
2019,Enlisted,10314,34,8,26
2019,Enlisted,10468,15,1,14
2019,Enlisted,10566,27,4,23
2019,Enlisted,10567,142,20,122
2019,Enlisted,10701,24,3,21
2019,Enlisted,10962,16,4,12
2019,Enlisted,11252,117,17,100
2019,Enlisted,11357,37,8,29
2019,Enlisted,11433,78,14,64
2019,Enlisted,11735,71,19,52
2019,Enlisted,11779,33,5,28
2019,Enlisted,12078,19,4,15
2019,Enlisted,12110,67,9,58
2019,Enlisted,12180,21,2,19
2019,Enlisted,12189,5,4,1
2019,Enlisted,12302,45,7,38
2019,Enlisted,12401,11,1,10
2019,Enlisted,12451,11,4,7
2019,Enlisted,12553,32,7,25
2019,Enlisted,12804,22,1,21
2019,Enlisted,12962,11,3,8
2019,Enlisted,13021,22,1,21
2019,Enlisted,13211,51,5,46
2019,Enlisted,13501,38,4,34
2019,Enlisted,13602,17,3,14
2019,Enlisted,13669,5,1,4
2019,Enlisted,13856,8,0,8
2019,Enlisted,13905,26,5,21
2019,Enlisted,14048,8,0,8
2019,Enlisted,14094,17,2,15
2019,Enlisted,14204,71,13,58
2019,Enlisted,14213,51,5,46
2019,Enlisted,14304,25,1,24
2019,Enlisted,14454,27,2,25
2019,Enlisted,14456,10,0,10
2019,Enlisted,14624,84,12,72
2019,Enlisted,14701,7,0,7
2019,Enlisted,14760,5,2,3
2019,Enlisted,14843,4,0,4
2019,Enlisted,14845,23,0,23
2019,Enlisted,14850,25,4,21
2019,Enlisted,15010,24,4,20
2019,Enlisted,15216,27,1,26
2019,Enlisted,15301,19,3,16
2019,Enlisted,15370,15,1,14
2019,Enlisted,15425,11,4,7
2019,Enlisted,15444,10,0,10
2019,Enlisted,15537,10,0,10
2019,Enlisted,15541,12,1,11
2019,Enlisted,15601,10,1,9
2019,Enlisted,15666,13,2,11
2019,Enlisted,15701,12,5,7
2019,Enlisted,15767,10,1,9
2019,Enlisted,15779,3,2,1
2019,Enlisted,15902,13,3,10
2019,Enlisted,15904,76,6,70
2019,Enlisted,16001,36,11,25
2019,Enlisted,16101,30,0,30
2019,Enlisted,16127,10,1,9
2019,Enlisted,16148,15,1,14
2019,Enlisted,16226,10,2,8
2019,Enlisted,16403,49,10,39
2019,Enlisted,16635,8,1,7
2019,Enlisted,16652,3,0,3
2019,Enlisted,16738,11,3,8
2019,Enlisted,16803,20,5,15
2019,Enlisted,16830,3,0,3
2019,Enlisted,16901,2,0,2
2019,Enlisted,17003,210,27,183
2019,Enlisted,17013,26,5,21
2019,Enlisted,17022,29,4,25
2019,Enlisted,17033,8,0,8
2019,Enlisted,17042,29,0,29
2019,Enlisted,17044,22,2,20
2019,Enlisted,17098,3,1,2
2019,Enlisted,17103,53,2,51
2019,Enlisted,17201,13,0,13
2019,Enlisted,17222,7,0,7
2019,Enlisted,17325,11,3,8
2019,Enlisted,17331,13,2,11
2019,Enlisted,17701,24,5,19
2019,Enlisted,17745,12,2,10
2019,Enlisted,17821,15,3,12
2019,Enlisted,17837,7,2,5
2019,Enlisted,18040,21,1,20
2019,Enlisted,18102,21,1,20
2019,Enlisted,18201,13,3,10
2019,Enlisted,18235,10,2,8
2019,Enlisted,18252,8,2,6
2019,Enlisted,18407,5,2,3
2019,Enlisted,18431,10,1,9
2019,Enlisted,18466,15,0,15
2019,Enlisted,18509,39,7,32
2019,Enlisted,18634,4,1,3
2019,Enlisted,18651,5,0,5
2019,Enlisted,18704,19,1,18
2019,Enlisted,18834,4,1,3
2019,Enlisted,18960,5,0,5
2019,Enlisted,19044,54,7,47
2019,Enlisted,19103,15,2,13
2019,Enlisted,19153,30,1,29
2019,Enlisted,19154,163,12,151
2019,Enlisted,19320,14,4,10
2019,Enlisted,19460,12,0,12
2019,Enlisted,19462,16,1,15
2019,Enlisted,19475,40,3,37
2019,Enlisted,19526,8,0,8
2019,Enlisted,19530,18,4,14
2019,Enlisted,19605,18,1,17
2019,Enlisted,19706,29,5,24
2019,Enlisted,19711,32,3,29
2019,Enlisted,19720,33,9,24
2019,Enlisted,19804,18,2,16
2019,Enlisted,19808,3,1,2
2019,Enlisted,19930,2,1,1
2019,Enlisted,19939,26,2,24
2019,Enlisted,19947,19,0,19
2019,Enlisted,19973,24,1,23
2019,Enlisted,19977,12,2,10
2019,Enlisted,20003,30,8,22
2019,Enlisted,20112,47,14,33
2019,Enlisted,20175,17,6,11
2019,Enlisted,20186,17,5,12
2019,Enlisted,20373,21,6,15
2019,Enlisted,20623,12,0,12
2019,Enlisted,20646,6,1,5
2019,Enlisted,20653,4,2,2
2019,Enlisted,20708,20,10,10
2019,Enlisted,20882,4,0,4
2019,Enlisted,20904,13,3,10
2019,Enlisted,21010,54,9,45
2019,Enlisted,21043,27,4,23
2019,Enlisted,21057,17,4,13
2019,Enlisted,21061,10,5,5
2019,Enlisted,21078,18,1,17
2019,Enlisted,21136,43,7,36
2019,Enlisted,21157,19,3,16
2019,Enlisted,21201,1,1,0
2019,Enlisted,21204,18,2,16
2019,Enlisted,21216,14,4,10
2019,Enlisted,21222,28,8,20
2019,Enlisted,21228,16,2,14
2019,Enlisted,21236,15,2,13
2019,Enlisted,21401,22,6,16
2019,Enlisted,21502,3,0,3
2019,Enlisted,21601,1,0,1
2019,Enlisted,21657,8,0,8
2019,Enlisted,21701,20,11,9
2019,Enlisted,21740,4,1,3
2019,Enlisted,21801,16,5,11
2019,Enlisted,21921,1,1,0
2019,Enlisted,22032,8,3,5
2019,Enlisted,22060,57,30,27
2019,Enlisted,22401,47,6,41
2019,Enlisted,22427,22,2,20
2019,Enlisted,22601,9,2,7
2019,Enlisted,22602,20,3,17
2019,Enlisted,22664,3,0,3
2019,Enlisted,22731,4,1,3
2019,Enlisted,22801,8,1,7
2019,Enlisted,22902,18,5,13
2019,Enlisted,23139,25,4,21
2019,Enlisted,23150,53,7,46
2019,Enlisted,23181,14,3,11
2019,Enlisted,23237,11,2,9
2019,Enlisted,23417,7,1,6
2019,Enlisted,23434,7,2,5
2019,Enlisted,23451,96,9,87
2019,Enlisted,23502,38,5,33
2019,Enlisted,23609,8,0,8
2019,Enlisted,23666,27,3,24
2019,Enlisted,23701,16,4,12
2019,Enlisted,23805,14,3,11
2019,Enlisted,23824,43,11,32
2019,Enlisted,23847,7,4,3
2019,Enlisted,23851,5,1,4
2019,Enlisted,23901,13,2,11
2019,Enlisted,24073,16,2,14
2019,Enlisted,24112,15,0,15
2019,Enlisted,24151,18,1,17
2019,Enlisted,24212,4,0,4
2019,Enlisted,24251,15,5,10
2019,Enlisted,24301,7,1,6
2019,Enlisted,24401,4,3,1
2019,Enlisted,24450,19,1,18
2019,Enlisted,24502,25,10,15
2019,Enlisted,24523,12,5,7
2019,Enlisted,24540,4,2,2
2019,Enlisted,24592,7,1,6
2019,Enlisted,24609,8,0,8
2019,Enlisted,24701,9,1,8
2019,Enlisted,24957,13,3,10
2019,Enlisted,25168,44,7,37
2019,Enlisted,25262,4,1,3
2019,Enlisted,25309,3,0,3
2019,Enlisted,25311,3,2,1
2019,Enlisted,25405,22,7,15
2019,Enlisted,25530,48,26,22
2019,Enlisted,25550,13,4,9
2019,Enlisted,25625,28,5,23
2019,Enlisted,25846,66,11,55
2019,Enlisted,26003,11,1,10
2019,Enlisted,26041,29,10,19
2019,Enlisted,26101,20,5,15
2019,Enlisted,26187,17,4,13
2019,Enlisted,26201,14,4,10
2019,Enlisted,26250,15,2,13
2019,Enlisted,26301,12,4,8
2019,Enlisted,26426,9,1,8
2019,Enlisted,26505,4,0,4
2019,Enlisted,26508,20,2,18
2019,Enlisted,26537,36,21,15
2019,Enlisted,26554,17,7,10
2019,Enlisted,26624,9,1,8
2019,Enlisted,26651,7,1,6
2019,Enlisted,26836,10,0,10
2019,Enlisted,27028,5,1,4
2019,Enlisted,27030,3,0,3
2019,Enlisted,27103,48,4,44
2019,Enlisted,27204,1,0,1
2019,Enlisted,27217,39,9,30
2019,Enlisted,27260,17,1,16
2019,Enlisted,27264,6,1,5
2019,Enlisted,27292,11,0,11
2019,Enlisted,27320,21,1,20
2019,Enlisted,27344,10,4,6
2019,Enlisted,27360,5,1,4
2019,Enlisted,27401,36,3,33
2019,Enlisted,27504,22,4,18
2019,Enlisted,27509,5,3,2
2019,Enlisted,27530,42,6,36
2019,Enlisted,27549,9,1,8
2019,Enlisted,27557,32,12,20
2019,Enlisted,27560,86,16,70
2019,Enlisted,27573,1,0,1
2019,Enlisted,27577,1,1,0
2019,Enlisted,27581,11,4,7
2019,Enlisted,27596,37,5,32
2019,Enlisted,27607,12,7,5
2019,Enlisted,27704,32,10,22
2019,Enlisted,27828,1,1,0
2019,Enlisted,27830,2,0,2
2019,Enlisted,27870,7,4,3
2019,Enlisted,27874,2,0,2
2019,Enlisted,27889,3,2,1
2019,Enlisted,27892,1,0,1
2019,Enlisted,28001,32,22,10
2019,Enlisted,28012,3,2,1
2019,Enlisted,28027,33,9,24
2019,Enlisted,28043,5,0,5
2019,Enlisted,28054,22,1,21
2019,Enlisted,28086,12,3,9
2019,Enlisted,28092,5,0,5
2019,Enlisted,28110,3,1,2
2019,Enlisted,28115,15,3,12
2019,Enlisted,28147,27,7,20
2019,Enlisted,28170,2,0,2
2019,Enlisted,28208,22,5,17
2019,Enlisted,28306,45,12,33
2019,Enlisted,28310,32,11,21
2019,Enlisted,28328,8,6,2
2019,Enlisted,28334,8,2,6
2019,Enlisted,28337,1,0,1
2019,Enlisted,28345,8,3,5
2019,Enlisted,28352,23,2,21
2019,Enlisted,28359,8,5,3
2019,Enlisted,28371,6,0,6
2019,Enlisted,28376,30,6,24
2019,Enlisted,28377,14,5,9
2019,Enlisted,28379,16,4,12
2019,Enlisted,28382,8,3,5
2019,Enlisted,28384,7,1,6
2019,Enlisted,28387,1,0,1
2019,Enlisted,28388,8,3,5
2019,Enlisted,28401,1,0,1
2019,Enlisted,28405,39,10,29
2019,Enlisted,28470,3,1,2
2019,Enlisted,28472,9,0,9
2019,Enlisted,28504,52,8,44
2019,Enlisted,28518,4,2,2
2019,Enlisted,28540,30,8,22
2019,Enlisted,28560,9,2,7
2019,Enlisted,28577,4,2,2
2019,Enlisted,28590,17,1,16
2019,Enlisted,28601,5,1,4
2019,Enlisted,28607,6,0,6
2019,Enlisted,28621,5,0,5
2019,Enlisted,28640,4,2,2
2019,Enlisted,28645,28,5,23
2019,Enlisted,28655,5,0,5
2019,Enlisted,28658,3,1,2
2019,Enlisted,28659,17,6,11
2019,Enlisted,28677,8,0,8
2019,Enlisted,28681,5,0,5
2019,Enlisted,28726,1,1,0
2019,Enlisted,28734,9,0,9
2019,Enlisted,28752,7,2,5
2019,Enlisted,28779,10,2,8
2019,Enlisted,28806,26,7,19
2019,Enlisted,29006,20,3,17
2019,Enlisted,29020,17,2,15
2019,Enlisted,29044,139,33,106
2019,Enlisted,29102,3,1,2
2019,Enlisted,29108,49,4,45
2019,Enlisted,29115,48,2,46
2019,Enlisted,29138,6,2,4
2019,Enlisted,29151,22,2,20
2019,Enlisted,29161,24,5,19
2019,Enlisted,29170,7,0,7
2019,Enlisted,29201,2,0,2
2019,Enlisted,29303,15,1,14
2019,Enlisted,29325,9,1,8
2019,Enlisted,29341,6,1,5
2019,Enlisted,29360,12,2,10
2019,Enlisted,29379,27,6,21
2019,Enlisted,29385,16,1,15
2019,Enlisted,29403,27,3,24
2019,Enlisted,29409,2,0,2
2019,Enlisted,29418,70,6,64
2019,Enlisted,29440,12,2,10
2019,Enlisted,29461,29,7,22
2019,Enlisted,29464,27,7,20
2019,Enlisted,29488,19,0,19
2019,Enlisted,29506,5,0,5
2019,Enlisted,29510,5,0,5
2019,Enlisted,29512,18,1,17
2019,Enlisted,29532,11,2,9
2019,Enlisted,29536,5,2,3
2019,Enlisted,29544,12,0,12
2019,Enlisted,29550,7,1,6
2019,Enlisted,29556,29,2,27
2019,Enlisted,29571,17,2,15
2019,Enlisted,29574,27,5,22
2019,Enlisted,29577,5,0,5
2019,Enlisted,29605,35,4,31
2019,Enlisted,29620,29,3,26
2019,Enlisted,29625,27,3,24
2019,Enlisted,29631,15,0,15
2019,Enlisted,29641,4,0,4
2019,Enlisted,29644,14,5,9
2019,Enlisted,29646,21,1,20
2019,Enlisted,29651,16,1,15
2019,Enlisted,29653,12,0,12
2019,Enlisted,29678,16,4,12
2019,Enlisted,29706,28,3,25
2019,Enlisted,29715,13,0,13
2019,Enlisted,29720,3,1,2
2019,Enlisted,29732,10,0,10
2019,Enlisted,29810,3,0,3
2019,Enlisted,29812,6,0,6
2019,Enlisted,29824,14,4,10
2019,Enlisted,29829,6,0,6
2019,Enlisted,29835,9,0,9
2019,Enlisted,29906,26,4,22
2019,Enlisted,29944,7,0,7
2019,Enlisted,30014,24,10,14
2019,Enlisted,30032,21,9,12
2019,Enlisted,30040,55,23,32
2019,Enlisted,30046,68,17,51
2019,Enlisted,30060,148,62,86
2019,Enlisted,30069,96,22,74
2019,Enlisted,30114,13,3,10
2019,Enlisted,30125,18,4,14
2019,Enlisted,30134,17,2,15
2019,Enlisted,30144,55,24,31
2019,Enlisted,30161,28,14,14
2019,Enlisted,30224,39,8,31
2019,Enlisted,30233,21,6,15
2019,Enlisted,30240,23,6,17
2019,Enlisted,30263,47,19,28
2019,Enlisted,30294,83,21,62
2019,Enlisted,30297,93,31,62
2019,Enlisted,30336,60,33,27
2019,Enlisted,30401,11,3,8
2019,Enlisted,30427,30,8,22
2019,Enlisted,30439,10,4,6
2019,Enlisted,30460,3,0,3
2019,Enlisted,30461,17,3,14
2019,Enlisted,30501,12,6,6
2019,Enlisted,30577,25,2,23
2019,Enlisted,30597,1,1,0
2019,Enlisted,30635,22,3,19
2019,Enlisted,30643,19,1,18
2019,Enlisted,30655,33,17,16
2019,Enlisted,30673,37,9,28
2019,Enlisted,30680,56,21,35
2019,Enlisted,30701,35,12,23
2019,Enlisted,30720,16,6,10
2019,Enlisted,30824,9,1,8
2019,Enlisted,30830,23,1,22
2019,Enlisted,30904,71,21,50
2019,Enlisted,30905,43,9,34
2019,Enlisted,30909,1,1,0
2019,Enlisted,31015,28,11,17
2019,Enlisted,31029,70,22,48
2019,Enlisted,31040,18,11,7
2019,Enlisted,31061,29,7,22
2019,Enlisted,31211,57,15,42
2019,Enlisted,31313,11,4,7
2019,Enlisted,31314,65,32,33
2019,Enlisted,31329,10,10,0
2019,Enlisted,31406,106,43,63
2019,Enlisted,31409,22,12,10
2019,Enlisted,31520,25,11,14
2019,Enlisted,31533,5,3,2
2019,Enlisted,31601,8,5,3
2019,Enlisted,31704,16,1,15
2019,Enlisted,31792,24,11,13
2019,Enlisted,31794,20,8,12
2019,Enlisted,31901,2,1,1
2019,Enlisted,31905,30,18,12
2019,Enlisted,32055,25,6,19
2019,Enlisted,32064,9,6,3
2019,Enlisted,32084,19,6,13
2019,Enlisted,32086,25,5,20
2019,Enlisted,32091,112,39,73
2019,Enlisted,32164,30,3,27
2019,Enlisted,32177,7,0,7
2019,Enlisted,32221,129,43,86
2019,Enlisted,32311,31,8,23
2019,Enlisted,32351,33,3,30
2019,Enlisted,32406,7,3,4
2019,Enlisted,32425,19,4,15
2019,Enlisted,32428,10,1,9
2019,Enlisted,32447,6,2,4
2019,Enlisted,32514,32,13,19
2019,Enlisted,32536,12,6,6
2019,Enlisted,32542,1,1,0
2019,Enlisted,32609,3,3,0
2019,Enlisted,32724,19,3,16
2019,Enlisted,32727,8,1,7
2019,Enlisted,32771,28,12,16
2019,Enlisted,32806,46,15,31
2019,Enlisted,32827,11,6,5
2019,Enlisted,32922,11,5,6
2019,Enlisted,32935,29,9,20
2019,Enlisted,33025,6,1,5
2019,Enlisted,33027,111,29,82
2019,Enlisted,33039,18,3,15
2019,Enlisted,33127,8,1,7
2019,Enlisted,33315,39,8,31
2019,Enlisted,33405,11,3,8
2019,Enlisted,33406,70,6,64
2019,Enlisted,33523,17,5,12
2019,Enlisted,33563,23,6,17
2019,Enlisted,33606,22,4,18
2019,Enlisted,33711,30,5,25
2019,Enlisted,33782,81,31,50
2019,Enlisted,33801,3,3,0
2019,Enlisted,33811,16,5,11
2019,Enlisted,33825,3,0,3
2019,Enlisted,33830,8,0,8
2019,Enlisted,33844,16,5,11
2019,Enlisted,33859,19,7,12
2019,Enlisted,33873,4,4,0
2019,Enlisted,33880,18,3,15
2019,Enlisted,33916,8,3,5
2019,Enlisted,34208,17,1,16
2019,Enlisted,34221,8,2,6
2019,Enlisted,34237,21,4,17
2019,Enlisted,34266,22,5,17
2019,Enlisted,34429,23,7,16
2019,Enlisted,34471,13,3,10
2019,Enlisted,34474,27,10,17
2019,Enlisted,34604,10,3,7
2019,Enlisted,34748,28,7,21
2019,Enlisted,34947,20,4,16
2019,Enlisted,35010,29,2,27
2019,Enlisted,35016,28,1,27
2019,Enlisted,35040,19,6,13
2019,Enlisted,35042,46,6,40
2019,Enlisted,35055,14,8,6
2019,Enlisted,35072,3,2,1
2019,Enlisted,35121,27,6,21
2019,Enlisted,35124,19,4,15
2019,Enlisted,35146,19,3,16
2019,Enlisted,35161,20,4,16
2019,Enlisted,35178,7,2,5
2019,Enlisted,35209,21,3,18
2019,Enlisted,35217,45,15,30
2019,Enlisted,35259,3,3,0
2019,Enlisted,35405,22,4,18
2019,Enlisted,35501,11,2,9
2019,Enlisted,35555,17,0,17
2019,Enlisted,35565,22,5,17
2019,Enlisted,35601,44,8,36
2019,Enlisted,35613,6,1,5
2019,Enlisted,35630,2,1,1
2019,Enlisted,35803,22,4,18
2019,Enlisted,35805,26,4,22
2019,Enlisted,35904,44,17,27
2019,Enlisted,35967,25,12,13
2019,Enlisted,36016,23,3,20
2019,Enlisted,36027,11,2,9
2019,Enlisted,36043,47,7,40
2019,Enlisted,36067,9,1,8
2019,Enlisted,36078,28,5,23
2019,Enlisted,36081,13,1,12
2019,Enlisted,36083,10,1,9
2019,Enlisted,36109,48,3,45
2019,Enlisted,36117,17,1,16
2019,Enlisted,36121,8,1,7
2019,Enlisted,36203,15,6,9
2019,Enlisted,36205,24,3,21
2019,Enlisted,36250,4,3,1
2019,Enlisted,36251,8,0,8
2019,Enlisted,36265,18,9,9
2019,Enlisted,36302,12,1,11
2019,Enlisted,36322,4,4,0
2019,Enlisted,36323,6,1,5
2019,Enlisted,36330,31,5,26
2019,Enlisted,36340,12,1,11
2019,Enlisted,36420,7,4,3
2019,Enlisted,36426,8,0,8
2019,Enlisted,36442,7,2,5
2019,Enlisted,36502,8,0,8
2019,Enlisted,36522,18,0,18
2019,Enlisted,36532,23,1,22
2019,Enlisted,36535,24,6,18
2019,Enlisted,36605,62,9,53
2019,Enlisted,36608,3,1,2
2019,Enlisted,36701,7,4,3
2019,Enlisted,36801,12,2,10
2019,Enlisted,36854,18,5,13
2019,Enlisted,36867,4,1,3
2019,Enlisted,37015,11,3,8
2019,Enlisted,37033,5,1,4
2019,Enlisted,37042,8,7,1
2019,Enlisted,37056,22,4,18
2019,Enlisted,37066,16,7,9
2019,Enlisted,37083,7,2,5
2019,Enlisted,37090,14,5,9
2019,Enlisted,37091,7,3,4
2019,Enlisted,37097,4,3,1
2019,Enlisted,37110,19,9,10
2019,Enlisted,37127,7,2,5
2019,Enlisted,37129,30,11,19
2019,Enlisted,37160,6,1,5
2019,Enlisted,37167,56,16,40
2019,Enlisted,37172,12,8,4
2019,Enlisted,37178,8,3,5
2019,Enlisted,37185,15,1,14
2019,Enlisted,37204,50,20,30
2019,Enlisted,37217,32,11,21
2019,Enlisted,37303,7,1,6
2019,Enlisted,37321,10,0,10
2019,Enlisted,37323,29,9,20
2019,Enlisted,37327,9,0,9
2019,Enlisted,37356,9,1,8
2019,Enlisted,37388,35,9,26
2019,Enlisted,37398,14,4,10
2019,Enlisted,37404,36,11,25
2019,Enlisted,37615,6,2,4
2019,Enlisted,37620,14,4,10
2019,Enlisted,37644,10,2,8
2019,Enlisted,37645,10,1,9
2019,Enlisted,37683,2,1,1
2019,Enlisted,37717,9,3,6
2019,Enlisted,37743,13,3,10
2019,Enlisted,37757,11,3,8
2019,Enlisted,37760,11,1,10
2019,Enlisted,37771,17,5,12
2019,Enlisted,37777,40,17,23
2019,Enlisted,37801,5,3,2
2019,Enlisted,37821,24,4,20
2019,Enlisted,37825,8,3,5
2019,Enlisted,37841,15,1,14
2019,Enlisted,37854,9,1,8
2019,Enlisted,37857,4,0,4
2019,Enlisted,37860,3,1,2
2019,Enlisted,37863,2,1,1
2019,Enlisted,37874,20,3,17
2019,Enlisted,37919,8,4,4
2019,Enlisted,37939,6,0,6
2019,Enlisted,38001,8,2,6
2019,Enlisted,38008,11,2,9
2019,Enlisted,38012,11,6,5
2019,Enlisted,38019,7,0,7
2019,Enlisted,38024,6,0,6
2019,Enlisted,38053,16,2,14
2019,Enlisted,38063,10,6,4
2019,Enlisted,38118,41,7,34
2019,Enlisted,38201,20,3,17
2019,Enlisted,38225,9,1,8
2019,Enlisted,38242,11,4,7
2019,Enlisted,38261,18,9,9
2019,Enlisted,38301,9,3,6
2019,Enlisted,38302,12,0,12
2019,Enlisted,38320,9,2,7
2019,Enlisted,38340,13,4,9
2019,Enlisted,38343,20,4,16
2019,Enlisted,38344,17,3,14
2019,Enlisted,38351,18,4,14
2019,Enlisted,38358,8,1,7
2019,Enlisted,38372,13,4,9
2019,Enlisted,38375,14,2,12
2019,Enlisted,38382,14,4,10
2019,Enlisted,38401,7,1,6
2019,Enlisted,38464,7,2,5
2019,Enlisted,38478,9,2,7
2019,Enlisted,38485,5,3,2
2019,Enlisted,38506,8,3,5
2019,Enlisted,38556,5,0,5
2019,Enlisted,38563,3,1,2
2019,Enlisted,38570,6,2,4
2019,Enlisted,38572,7,1,6
2019,Enlisted,38583,12,4,8
2019,Enlisted,38606,3,1,2
2019,Enlisted,38632,2,1,1
2019,Enlisted,38635,2,0,2
2019,Enlisted,38663,1,0,1
2019,Enlisted,38668,38,4,34
2019,Enlisted,38671,33,3,30
2019,Enlisted,38701,17,0,17
2019,Enlisted,38732,1,0,1
2019,Enlisted,38751,2,1,1
2019,Enlisted,38801,55,6,49
2019,Enlisted,38803,7,2,5
2019,Enlisted,38821,26,3,23
2019,Enlisted,38829,2,0,2
2019,Enlisted,38834,2,1,1
2019,Enlisted,38843,4,1,3
2019,Enlisted,38851,18,0,18
2019,Enlisted,38852,2,0,2
2019,Enlisted,38860,10,0,10
2019,Enlisted,38863,6,1,5
2019,Enlisted,38901,21,10,11
2019,Enlisted,38915,23,2,21
2019,Enlisted,38916,15,2,13
2019,Enlisted,38921,3,1,2
2019,Enlisted,38926,3,0,3
2019,Enlisted,38930,5,1,4
2019,Enlisted,38965,3,1,2
2019,Enlisted,38967,1,0,1
2019,Enlisted,39042,31,1,30
2019,Enlisted,39046,13,1,12
2019,Enlisted,39051,7,0,7
2019,Enlisted,39059,1,0,1
2019,Enlisted,39060,27,3,24
2019,Enlisted,39074,10,3,7
2019,Enlisted,39090,2,2,0
2019,Enlisted,39111,3,1,2
2019,Enlisted,39117,12,0,12
2019,Enlisted,39120,3,1,2
2019,Enlisted,39159,2,0,2
2019,Enlisted,39168,1,0,1
2019,Enlisted,39183,30,3,27
2019,Enlisted,39194,4,0,4
2019,Enlisted,39202,7,4,3
2019,Enlisted,39204,64,7,57
2019,Enlisted,39209,29,5,24
2019,Enlisted,39216,11,3,8
2019,Enlisted,39307,38,5,33
2019,Enlisted,39339,1,0,1
2019,Enlisted,39345,37,3,34
2019,Enlisted,39350,14,2,12
2019,Enlisted,39367,2,0,2
2019,Enlisted,39401,14,4,10
2019,Enlisted,39407,57,5,52
2019,Enlisted,39422,14,0,14
2019,Enlisted,39429,1,0,1
2019,Enlisted,39440,24,1,23
2019,Enlisted,39452,1,0,1
2019,Enlisted,39466,13,2,11
2019,Enlisted,39470,4,3,1
2019,Enlisted,39505,39,9,30
2019,Enlisted,39507,26,3,23
2019,Enlisted,39532,6,3,3
2019,Enlisted,39556,5,1,4
2019,Enlisted,39567,34,2,32
2019,Enlisted,39577,11,1,10
2019,Enlisted,39601,3,0,3
2019,Enlisted,39648,34,7,27
2019,Enlisted,39654,25,2,23
2019,Enlisted,39702,1,0,1
2019,Enlisted,39704,2,2,0
2019,Enlisted,39730,13,1,12
2019,Enlisted,39744,4,0,4
2019,Enlisted,39760,36,2,34
2019,Enlisted,39773,9,0,9
2019,Enlisted,40004,10,3,7
2019,Enlisted,40065,21,2,19
2019,Enlisted,40069,2,0,2
2019,Enlisted,40108,9,2,7
2019,Enlisted,40121,3,2,1
2019,Enlisted,40205,37,6,31
2019,Enlisted,40218,45,4,41
2019,Enlisted,40311,9,0,9
2019,Enlisted,40330,7,2,5
2019,Enlisted,40351,15,0,15
2019,Enlisted,40422,4,0,4
2019,Enlisted,40472,24,4,20
2019,Enlisted,40475,83,9,74
2019,Enlisted,40510,35,3,32
2019,Enlisted,40601,88,19,69
2019,Enlisted,40741,16,1,15
2019,Enlisted,40769,14,2,12
2019,Enlisted,40831,19,3,16
2019,Enlisted,40906,19,2,17
2019,Enlisted,40965,13,2,11
2019,Enlisted,41005,83,10,73
2019,Enlisted,41008,4,0,4
2019,Enlisted,41031,20,5,15
2019,Enlisted,41094,9,2,7
2019,Enlisted,41101,26,6,20
2019,Enlisted,41164,6,1,5
2019,Enlisted,41339,2,0,2
2019,Enlisted,41653,11,3,8
2019,Enlisted,41701,17,1,16
2019,Enlisted,42025,8,2,6
2019,Enlisted,42064,8,0,8
2019,Enlisted,42071,26,1,25
2019,Enlisted,42086,11,0,11
2019,Enlisted,42101,11,2,9
2019,Enlisted,42141,16,1,15
2019,Enlisted,42167,8,0,8
2019,Enlisted,42240,9,3,6
2019,Enlisted,42276,4,1,3
2019,Enlisted,42301,15,0,15
2019,Enlisted,42330,8,3,5
2019,Enlisted,42345,27,9,18
2019,Enlisted,42431,12,0,12
2019,Enlisted,42501,21,5,16
2019,Enlisted,42633,3,0,3
2019,Enlisted,42701,10,2,8
2019,Enlisted,42718,8,0,8
2019,Enlisted,42754,12,1,11
2019,Enlisted,43015,34,2,32
2019,Enlisted,43040,21,1,20
2019,Enlisted,43055,41,4,37
2019,Enlisted,43102,21,3,18
2019,Enlisted,43213,67,9,58
2019,Enlisted,43217,104,21,83
2019,Enlisted,43235,5,5,0
2019,Enlisted,43402,32,4,28
2019,Enlisted,43465,93,6,87
2019,Enlisted,43614,28,0,28
2019,Enlisted,43756,84,0,84
2019,Enlisted,43812,23,2,21
2019,Enlisted,44023,15,4,11
2019,Enlisted,44055,12,2,10
2019,Enlisted,44128,27,4,23
2019,Enlisted,44142,18,3,15
2019,Enlisted,44224,70,9,61
2019,Enlisted,44256,24,2,22
2019,Enlisted,44313,16,1,15
2019,Enlisted,44444,38,1,37
2019,Enlisted,44515,31,3,28
2019,Enlisted,44601,33,8,25
2019,Enlisted,44622,15,2,13
2019,Enlisted,44691,27,2,25
2019,Enlisted,44720,92,17,75
2019,Enlisted,44857,26,3,23
2019,Enlisted,44870,15,5,10
2019,Enlisted,44883,16,3,13
2019,Enlisted,44903,83,4,79
2019,Enlisted,45015,40,5,35
2019,Enlisted,45036,20,2,18
2019,Enlisted,45044,15,0,15
2019,Enlisted,45215,64,5,59
2019,Enlisted,45331,12,1,11
2019,Enlisted,45356,45,2,43
2019,Enlisted,45385,16,7,9
2019,Enlisted,45430,31,3,28
2019,Enlisted,45502,139,5,134
2019,Enlisted,45601,27,4,23
2019,Enlisted,45662,31,2,29
2019,Enlisted,45804,8,1,7
2019,Enlisted,45885,25,0,25
2019,Enlisted,46012,15,1,14
2019,Enlisted,46036,1,0,1
2019,Enlisted,46041,13,0,13
2019,Enlisted,46052,17,0,17
2019,Enlisted,46122,11,4,7
2019,Enlisted,46124,44,10,34
2019,Enlisted,46131,84,5,79
2019,Enlisted,46135,7,0,7
2019,Enlisted,46140,20,8,12
2019,Enlisted,46151,20,5,15
2019,Enlisted,46176,44,8,36
2019,Enlisted,46216,33,0,33
2019,Enlisted,46241,173,21,152
2019,Enlisted,46323,3,0,3
2019,Enlisted,46350,12,1,11
2019,Enlisted,46360,1,0,1
2019,Enlisted,46383,11,0,11
2019,Enlisted,46402,14,2,12
2019,Enlisted,46406,33,7,26
2019,Enlisted,46517,27,2,25
2019,Enlisted,46563,23,1,22
2019,Enlisted,46580,19,3,16
2019,Enlisted,46613,38,5,33
2019,Enlisted,46703,11,2,9
2019,Enlisted,46714,8,1,7
2019,Enlisted,46750,5,0,5
2019,Enlisted,46825,71,10,61
2019,Enlisted,46901,13,3,10
2019,Enlisted,46947,21,2,19
2019,Enlisted,46953,6,0,6
2019,Enlisted,46970,3,0,3
2019,Enlisted,47150,6,2,4
2019,Enlisted,47167,17,4,13
2019,Enlisted,47170,16,0,16
2019,Enlisted,47203,28,5,23
2019,Enlisted,47223,2,1,1
2019,Enlisted,47250,16,2,14
2019,Enlisted,47265,8,0,8
2019,Enlisted,47274,8,4,4
2019,Enlisted,47303,25,1,24
2019,Enlisted,47331,22,4,18
2019,Enlisted,47348,12,4,8
2019,Enlisted,47374,13,1,12
2019,Enlisted,47394,11,0,11
2019,Enlisted,47401,28,2,26
2019,Enlisted,47421,9,0,9
2019,Enlisted,47441,21,2,19
2019,Enlisted,47501,11,1,10
2019,Enlisted,47546,18,5,13
2019,Enlisted,47591,3,2,1
2019,Enlisted,47715,35,7,28
2019,Enlisted,47804,33,1,32
2019,Enlisted,47834,18,1,17
2019,Enlisted,47872,4,0,4
2019,Enlisted,47905,50,8,42
2019,Enlisted,47933,20,2,18
2019,Enlisted,47960,37,1,36
2019,Enlisted,47977,9,0,9
2019,Enlisted,47978,3,0,3
2019,Enlisted,48060,13,0,13
2019,Enlisted,48180,63,14,49
2019,Enlisted,48197,54,5,49
2019,Enlisted,48208,45,7,38
2019,Enlisted,48234,78,16,62
2019,Enlisted,48341,18,3,15
2019,Enlisted,48446,18,4,14
2019,Enlisted,48601,56,16,40
2019,Enlisted,48642,44,3,41
2019,Enlisted,48706,16,0,16
2019,Enlisted,48801,14,2,12
2019,Enlisted,48817,13,2,11
2019,Enlisted,48837,76,13,63
2019,Enlisted,48838,18,3,15
2019,Enlisted,48843,26,5,21
2019,Enlisted,48906,41,13,28
2019,Enlisted,48912,12,2,10
2019,Enlisted,49009,46,9,37
2019,Enlisted,49012,90,9,81
2019,Enlisted,49047,30,8,22
2019,Enlisted,49201,24,2,22
2019,Enlisted,49224,10,1,9
2019,Enlisted,49306,2,0,2
2019,Enlisted,49307,23,1,22
2019,Enlisted,49437,34,2,32
2019,Enlisted,49509,149,27,122
2019,Enlisted,49601,14,5,9
2019,Enlisted,49696,35,5,30
2019,Enlisted,49707,2,0,2
2019,Enlisted,49739,33,7,26
2019,Enlisted,49783,10,1,9
2019,Enlisted,49801,3,0,3
2019,Enlisted,49802,8,0,8
2019,Enlisted,49837,15,0,15
2019,Enlisted,49849,9,1,8
2019,Enlisted,49855,26,1,25
2019,Enlisted,49913,10,2,8
2019,Enlisted,50025,8,0,8
2019,Enlisted,50036,42,6,36
2019,Enlisted,50126,12,3,9
2019,Enlisted,50131,313,39,274
2019,Enlisted,50138,11,0,11
2019,Enlisted,50158,6,0,6
2019,Enlisted,50220,9,0,9
2019,Enlisted,50401,16,1,15
2019,Enlisted,50501,12,1,11
2019,Enlisted,50588,20,2,18
2019,Enlisted,50616,7,1,6
2019,Enlisted,50662,10,0,10
2019,Enlisted,50703,50,4,46
2019,Enlisted,51031,17,1,16
2019,Enlisted,51111,39,5,34
2019,Enlisted,51201,5,0,5
2019,Enlisted,51301,2,0,2
2019,Enlisted,51334,15,4,11
2019,Enlisted,51401,14,2,12
2019,Enlisted,51442,4,0,4
2019,Enlisted,51503,56,6,50
2019,Enlisted,51566,18,2,16
2019,Enlisted,51601,4,0,4
2019,Enlisted,52002,31,2,29
2019,Enlisted,52246,56,3,53
2019,Enlisted,52353,16,1,15
2019,Enlisted,52404,58,1,57
2019,Enlisted,52501,19,1,18
2019,Enlisted,52556,17,2,15
2019,Enlisted,52577,11,2,9
2019,Enlisted,52632,20,1,19
2019,Enlisted,52638,27,4,23
2019,Enlisted,52641,15,0,15
2019,Enlisted,52732,9,1,8
2019,Enlisted,52761,11,1,10
2019,Enlisted,52806,54,3,51
2019,Enlisted,53027,8,0,8
2019,Enlisted,53066,25,3,22
2019,Enlisted,53073,7,0,7
2019,Enlisted,53089,13,1,12
2019,Enlisted,53094,6,1,5
2019,Enlisted,53095,14,4,10
2019,Enlisted,53105,10,1,9
2019,Enlisted,53121,7,0,7
2019,Enlisted,53154,1,1,0
2019,Enlisted,53186,17,2,15
2019,Enlisted,53212,85,14,71
2019,Enlisted,53403,12,0,12
2019,Enlisted,53511,19,3,16
2019,Enlisted,53538,11,3,8
2019,Enlisted,53545,11,1,10
2019,Enlisted,53581,14,1,13
2019,Enlisted,53704,106,10,96
2019,Enlisted,53821,11,0,11
2019,Enlisted,53901,6,2,4
2019,Enlisted,53948,8,1,7
2019,Enlisted,53959,16,5,11
2019,Enlisted,53963,12,2,10
2019,Enlisted,54017,10,1,9
2019,Enlisted,54022,12,3,9
2019,Enlisted,54143,6,1,5
2019,Enlisted,54241,5,1,4
2019,Enlisted,54303,14,3,11
2019,Enlisted,54401,8,0,8
2019,Enlisted,54405,8,2,6
2019,Enlisted,54409,10,1,9
2019,Enlisted,54449,6,0,6
2019,Enlisted,54451,19,1,18
2019,Enlisted,54455,11,2,9
2019,Enlisted,54456,11,1,10
2019,Enlisted,54481,13,3,10
2019,Enlisted,54487,6,0,6
2019,Enlisted,54495,7,1,6
2019,Enlisted,54501,13,1,12
2019,Enlisted,54612,17,4,13
2019,Enlisted,54615,18,2,16
2019,Enlisted,54618,11,3,8
2019,Enlisted,54650,33,4,29
2019,Enlisted,54656,8,1,7
2019,Enlisted,54660,17,1,16
2019,Enlisted,54665,6,0,6
2019,Enlisted,54703,21,1,20
2019,Enlisted,54729,11,2,9
2019,Enlisted,54751,25,0,25
2019,Enlisted,54801,23,0,23
2019,Enlisted,54806,11,1,10
2019,Enlisted,54843,7,1,6
2019,Enlisted,54868,6,0,6
2019,Enlisted,54880,30,3,27
2019,Enlisted,54902,36,0,36
2019,Enlisted,54914,14,1,13
2019,Enlisted,54923,3,1,2
2019,Enlisted,54929,2,0,2
2019,Enlisted,54935,19,3,16
2019,Enlisted,54971,20,4,16
2019,Enlisted,54981,11,1,10
2019,Enlisted,55008,42,2,40
2019,Enlisted,55016,29,3,26
2019,Enlisted,55021,42,3,39
2019,Enlisted,55033,19,0,19
2019,Enlisted,55060,9,0,9
2019,Enlisted,55063,19,2,17
2019,Enlisted,55066,24,1,23
2019,Enlisted,55068,37,1,36
2019,Enlisted,55077,18,0,18
2019,Enlisted,55082,77,3,74
2019,Enlisted,55101,17,1,16
2019,Enlisted,55106,29,1,28
2019,Enlisted,55107,51,4,47
2019,Enlisted,55112,106,8,98
2019,Enlisted,55118,49,10,39
2019,Enlisted,55303,14,5,9
2019,Enlisted,55350,14,2,12
2019,Enlisted,55355,25,3,22
2019,Enlisted,55362,18,1,17
2019,Enlisted,55413,1,1,0
2019,Enlisted,55431,43,2,41
2019,Enlisted,55443,13,0,13
2019,Enlisted,55719,55,4,51
2019,Enlisted,55720,26,1,25
2019,Enlisted,55744,16,0,16
2019,Enlisted,55746,11,0,11
2019,Enlisted,55811,49,2,47
2019,Enlisted,55904,29,0,29
2019,Enlisted,55912,35,1,34
2019,Enlisted,55987,34,4,30
2019,Enlisted,56001,16,1,15
2019,Enlisted,56007,18,1,17
2019,Enlisted,56031,12,0,12
2019,Enlisted,56073,14,1,13
2019,Enlisted,56081,11,1,10
2019,Enlisted,56082,17,2,15
2019,Enlisted,56143,11,1,10
2019,Enlisted,56156,7,0,7
2019,Enlisted,56164,4,0,4
2019,Enlisted,56201,17,1,16
2019,Enlisted,56208,14,0,14
2019,Enlisted,56256,5,0,5
2019,Enlisted,56258,9,0,9
2019,Enlisted,56265,22,1,21
2019,Enlisted,56267,9,0,9
2019,Enlisted,56277,13,3,10
2019,Enlisted,56278,10,1,9
2019,Enlisted,56283,8,0,8
2019,Enlisted,56301,29,2,27
2019,Enlisted,56303,43,1,42
2019,Enlisted,56308,26,3,23
2019,Enlisted,56345,158,8,150
2019,Enlisted,56378,12,0,12
2019,Enlisted,56401,29,2,27
2019,Enlisted,56482,12,3,9
2019,Enlisted,56501,18,0,18
2019,Enlisted,56537,6,0,6
2019,Enlisted,56560,41,1,40
2019,Enlisted,56601,17,2,15
2019,Enlisted,56701,12,0,12
2019,Enlisted,56716,17,2,15
2019,Enlisted,57006,5,1,4
2019,Enlisted,57028,7,0,7
2019,Enlisted,57042,13,2,11
2019,Enlisted,57069,14,1,13
2019,Enlisted,57078,12,1,11
2019,Enlisted,57104,39,2,37
2019,Enlisted,57201,33,3,30
2019,Enlisted,57252,8,0,8
2019,Enlisted,57301,8,1,7
2019,Enlisted,57325,10,1,9
2019,Enlisted,57350,14,0,14
2019,Enlisted,57366,5,2,3
2019,Enlisted,57380,21,1,20
2019,Enlisted,57401,9,2,7
2019,Enlisted,57501,17,2,15
2019,Enlisted,57601,4,1,3
2019,Enlisted,57702,23,4,19
2019,Enlisted,57703,15,2,13
2019,Enlisted,57717,12,1,11
2019,Enlisted,57783,4,0,4
2019,Enlisted,57785,4,1,3
2019,Enlisted,58054,6,0,6
2019,Enlisted,58072,10,1,9
2019,Enlisted,58075,24,2,22
2019,Enlisted,58102,59,7,52
2019,Enlisted,58201,61,8,53
2019,Enlisted,58301,19,1,18
2019,Enlisted,58402,19,2,17
2019,Enlisted,58433,12,1,11
2019,Enlisted,58495,5,0,5
2019,Enlisted,58506,88,11,77
2019,Enlisted,58601,9,3,6
2019,Enlisted,58701,13,0,13
2019,Enlisted,58703,20,3,17
2019,Enlisted,58801,14,1,13
2019,Enlisted,59047,15,0,15
2019,Enlisted,59102,45,8,37
2019,Enlisted,59218,1,0,1
2019,Enlisted,59230,12,0,12
2019,Enlisted,59301,16,0,16
2019,Enlisted,59405,2,0,2
2019,Enlisted,59501,5,0,5
2019,Enlisted,59538,5,2,3
2019,Enlisted,59601,5,1,4
2019,Enlisted,59602,42,7,35
2019,Enlisted,59636,30,24,6
2019,Enlisted,59701,6,1,5
2019,Enlisted,59711,9,1,8
2019,Enlisted,59714,35,11,24
2019,Enlisted,59725,7,1,6
2019,Enlisted,59808,38,2,36
2019,Enlisted,59901,20,2,18
2019,Enlisted,59923,5,1,4
2019,Enlisted,60037,27,1,26
2019,Enlisted,60098,13,1,12
2019,Enlisted,60120,16,3,13
2019,Enlisted,60178,18,1,17
2019,Enlisted,60418,21,4,17
2019,Enlisted,60435,38,5,33
2019,Enlisted,60472,23,1,22
2019,Enlisted,60505,13,1,12
2019,Enlisted,60546,182,20,162
2019,Enlisted,60615,66,6,60
2019,Enlisted,60616,34,6,28
2019,Enlisted,60651,52,6,46
2019,Enlisted,60901,55,4,51
2019,Enlisted,61021,14,1,13
2019,Enlisted,61032,30,1,29
2019,Enlisted,61071,25,0,25
2019,Enlisted,61115,75,6,69
2019,Enlisted,61264,87,6,81
2019,Enlisted,61341,30,2,28
2019,Enlisted,61401,43,0,43
2019,Enlisted,61434,13,0,13
2019,Enlisted,61443,9,1,8
2019,Enlisted,61455,22,1,21
2019,Enlisted,61607,67,6,61
2019,Enlisted,61701,19,3,16
2019,Enlisted,61761,17,3,14
2019,Enlisted,61764,16,4,12
2019,Enlisted,61801,15,0,15
2019,Enlisted,61802,12,2,10
2019,Enlisted,61820,13,2,11
2019,Enlisted,61834,20,4,16
2019,Enlisted,61938,17,1,16
2019,Enlisted,61944,22,1,21
2019,Enlisted,61951,11,2,9
2019,Enlisted,62056,33,10,23
2019,Enlisted,62205,41,3,38
2019,Enlisted,62269,14,0,14
2019,Enlisted,62286,29,2,27
2019,Enlisted,62301,26,0,26
2019,Enlisted,62401,16,5,11
2019,Enlisted,62439,4,1,3
2019,Enlisted,62521,55,7,48
2019,Enlisted,62618,26,1,25
2019,Enlisted,62702,129,13,116
2019,Enlisted,62864,46,6,40
2019,Enlisted,62896,13,3,10
2019,Enlisted,62959,31,4,27
2019,Enlisted,62966,68,9,59
2019,Enlisted,63020,8,0,8
2019,Enlisted,63028,31,1,30
2019,Enlisted,63044,128,16,112
2019,Enlisted,63077,17,3,14
2019,Enlisted,63109,10,2,8
2019,Enlisted,63125,99,7,92
2019,Enlisted,63383,28,4,24
2019,Enlisted,63401,15,2,13
2019,Enlisted,63552,25,2,23
2019,Enlisted,63640,28,2,26
2019,Enlisted,63645,1,0,1
2019,Enlisted,63703,23,3,20
2019,Enlisted,63755,20,4,16
2019,Enlisted,63775,23,3,20
2019,Enlisted,63801,11,0,11
2019,Enlisted,63841,9,0,9
2019,Enlisted,63857,5,0,5
2019,Enlisted,63873,1,0,1
2019,Enlisted,63901,6,2,4
2019,Enlisted,63935,3,0,3
2019,Enlisted,64052,17,2,15
2019,Enlisted,64067,20,2,18
2019,Enlisted,64085,31,2,29
2019,Enlisted,64093,12,2,10
2019,Enlisted,64129,136,17,119
2019,Enlisted,64402,20,1,19
2019,Enlisted,64468,14,1,13
2019,Enlisted,64506,19,1,18
2019,Enlisted,64601,19,0,19
2019,Enlisted,64683,20,0,20
2019,Enlisted,64701,23,1,22
2019,Enlisted,64735,14,2,12
2019,Enlisted,64772,8,1,7
2019,Enlisted,64804,19,3,16
2019,Enlisted,64831,11,3,8
2019,Enlisted,64836,24,5,19
2019,Enlisted,64850,1,0,1
2019,Enlisted,65101,6,1,5
2019,Enlisted,65109,25,7,18
2019,Enlisted,65202,26,4,22
2019,Enlisted,65233,33,4,29
2019,Enlisted,65251,4,0,4
2019,Enlisted,65265,5,0,5
2019,Enlisted,65270,18,1,17
2019,Enlisted,65301,9,1,8
2019,Enlisted,65305,21,2,19
2019,Enlisted,65340,27,2,25
2019,Enlisted,65401,28,4,24
2019,Enlisted,65473,25,3,22
2019,Enlisted,65605,4,1,3
2019,Enlisted,65708,27,5,22
2019,Enlisted,65723,27,2,25
2019,Enlisted,65775,57,2,55
2019,Enlisted,65802,54,4,50
2019,Enlisted,65803,54,13,41
2019,Enlisted,66027,27,9,18
2019,Enlisted,66044,2,0,2
2019,Enlisted,66061,56,14,42
2019,Enlisted,66067,16,2,14
2019,Enlisted,66071,10,0,10
2019,Enlisted,66102,34,3,31
2019,Enlisted,66219,13,6,7
2019,Enlisted,66434,4,1,3
2019,Enlisted,66436,3,0,3
2019,Enlisted,66441,17,6,11
2019,Enlisted,66442,2,1,1
2019,Enlisted,66502,28,7,21
2019,Enlisted,66508,9,0,9
2019,Enlisted,66611,3,2,1
2019,Enlisted,66619,71,13,58
2019,Enlisted,66749,22,2,20
2019,Enlisted,66762,29,2,27
2019,Enlisted,66801,3,1,2
2019,Enlisted,66967,2,0,2
2019,Enlisted,67010,10,0,10
2019,Enlisted,67114,11,3,8
2019,Enlisted,67124,4,2,2
2019,Enlisted,67217,22,6,16
2019,Enlisted,67219,85,13,72
2019,Enlisted,67337,13,0,13
2019,Enlisted,67401,11,5,6
2019,Enlisted,67410,6,0,6
2019,Enlisted,67432,5,1,4
2019,Enlisted,67501,23,2,21
2019,Enlisted,67530,7,1,6
2019,Enlisted,67601,11,1,10
2019,Enlisted,67654,1,1,0
2019,Enlisted,67701,2,1,1
2019,Enlisted,67801,1,1,0
2019,Enlisted,67846,1,0,1
2019,Enlisted,67901,1,1,0
2019,Enlisted,68066,19,1,18
2019,Enlisted,68073,63,15,48
2019,Enlisted,68106,34,2,32
2019,Enlisted,68142,42,5,37
2019,Enlisted,68310,21,6,15
2019,Enlisted,68467,9,0,9
2019,Enlisted,68508,34,9,25
2019,Enlisted,68524,50,10,40
2019,Enlisted,68601,13,5,8
2019,Enlisted,68701,9,1,8
2019,Enlisted,68787,4,0,4
2019,Enlisted,68801,26,2,24
2019,Enlisted,68822,2,0,2
2019,Enlisted,68847,5,1,4
2019,Enlisted,68901,15,3,12
2019,Enlisted,69001,2,1,1
2019,Enlisted,69101,6,1,5
2019,Enlisted,69162,1,0,1
2019,Enlisted,69337,6,0,6
2019,Enlisted,69361,9,1,8
2019,Enlisted,70072,20,2,18
2019,Enlisted,70084,20,1,19
2019,Enlisted,70117,151,21,130
2019,Enlisted,70364,50,4,46
2019,Enlisted,70390,27,11,16
2019,Enlisted,70401,85,17,68
2019,Enlisted,70403,22,1,21
2019,Enlisted,70427,16,0,16
2019,Enlisted,70433,34,4,30
2019,Enlisted,70438,9,1,8
2019,Enlisted,70460,41,2,39
2019,Enlisted,70508,33,3,30
2019,Enlisted,70510,13,3,10
2019,Enlisted,70517,22,9,13
2019,Enlisted,70526,19,1,18
2019,Enlisted,70544,14,3,11
2019,Enlisted,70563,13,1,12
2019,Enlisted,70570,12,0,12
2019,Enlisted,70582,23,3,20
2019,Enlisted,70586,22,0,22
2019,Enlisted,70601,34,7,27
2019,Enlisted,70633,6,0,6
2019,Enlisted,70634,2,1,1
2019,Enlisted,70714,34,0,34
2019,Enlisted,70721,96,4,92
2019,Enlisted,70737,25,3,22
2019,Enlisted,70760,15,2,13
2019,Enlisted,70764,32,2,30
2019,Enlisted,70820,51,8,43
2019,Enlisted,71019,12,5,7
2019,Enlisted,71055,48,6,42
2019,Enlisted,71101,46,10,36
2019,Enlisted,71111,29,3,26
2019,Enlisted,71203,39,1,38
2019,Enlisted,71220,12,0,12
2019,Enlisted,71232,11,1,10
2019,Enlisted,71241,8,2,6
2019,Enlisted,71251,3,0,3
2019,Enlisted,71263,6,0,6
2019,Enlisted,71270,41,3,38
2019,Enlisted,71292,24,2,22
2019,Enlisted,71295,6,1,5
2019,Enlisted,71303,14,1,13
2019,Enlisted,71322,9,0,9
2019,Enlisted,71342,7,1,6
2019,Enlisted,71351,16,3,13
2019,Enlisted,71360,154,25,129
2019,Enlisted,71373,6,0,6
2019,Enlisted,71415,5,1,4
2019,Enlisted,71417,29,1,28
2019,Enlisted,71457,12,1,11
2019,Enlisted,71459,14,4,10
2019,Enlisted,71601,12,1,11
2019,Enlisted,71602,18,1,17
2019,Enlisted,71671,15,1,14
2019,Enlisted,71701,12,2,10
2019,Enlisted,71730,10,1,9
2019,Enlisted,71801,6,0,6
2019,Enlisted,71823,12,0,12
2019,Enlisted,71854,7,2,5
2019,Enlisted,71923,11,2,9
2019,Enlisted,71953,17,3,14
2019,Enlisted,72006,2,1,1
2019,Enlisted,72012,20,1,19
2019,Enlisted,72015,40,5,35
2019,Enlisted,72023,20,0,20
2019,Enlisted,72034,16,3,13
2019,Enlisted,72086,21,2,19
2019,Enlisted,72104,10,1,9
2019,Enlisted,72110,5,0,5
2019,Enlisted,72119,1,1,0
2019,Enlisted,72143,35,2,33
2019,Enlisted,72150,23,1,22
2019,Enlisted,72160,8,1,7
2019,Enlisted,72199,204,35,169
2019,Enlisted,72301,15,1,14
2019,Enlisted,72335,10,1,9
2019,Enlisted,72401,35,2,33
2019,Enlisted,72432,12,1,11
2019,Enlisted,72450,23,0,23
2019,Enlisted,72476,29,4,25
2019,Enlisted,72501,10,1,9
2019,Enlisted,72543,13,1,12
2019,Enlisted,72604,7,1,6
2019,Enlisted,72650,7,1,6
2019,Enlisted,72653,17,0,17
2019,Enlisted,72701,24,5,19
2019,Enlisted,72712,60,4,56
2019,Enlisted,72744,39,3,36
2019,Enlisted,72756,49,2,47
2019,Enlisted,72761,5,0,5
2019,Enlisted,72802,26,0,26
2019,Enlisted,72830,19,2,17
2019,Enlisted,72834,16,2,14
2019,Enlisted,72855,16,1,15
2019,Enlisted,72905,11,2,9
2019,Enlisted,72923,60,5,55
2019,Enlisted,72927,12,1,11
2019,Enlisted,72949,14,1,13
2019,Enlisted,73034,29,3,26
2019,Enlisted,73036,17,4,13
2019,Enlisted,73051,34,6,28
2019,Enlisted,73064,78,4,74
2019,Enlisted,73069,98,23,75
2019,Enlisted,73111,38,4,34
2019,Enlisted,73179,13,1,12
2019,Enlisted,73401,18,4,14
2019,Enlisted,73503,75,8,67
2019,Enlisted,73521,12,1,11
2019,Enlisted,73705,22,1,21
2019,Enlisted,74003,2,0,2
2019,Enlisted,74012,17,6,11
2019,Enlisted,74014,84,10,74
2019,Enlisted,74017,17,1,16
2019,Enlisted,74075,11,1,10
2019,Enlisted,74107,32,11,21
2019,Enlisted,74116,30,4,26
2019,Enlisted,74158,4,1,3
2019,Enlisted,74301,33,2,31
2019,Enlisted,74403,52,5,47
2019,Enlisted,74423,14,3,11
2019,Enlisted,74447,16,1,15
2019,Enlisted,74501,16,2,14
2019,Enlisted,74601,15,0,15
2019,Enlisted,74701,26,2,24
2019,Enlisted,74804,15,3,12
2019,Enlisted,74820,19,2,17
2019,Enlisted,74834,33,5,28
2019,Enlisted,74848,16,0,16
2019,Enlisted,75051,152,50,102
2019,Enlisted,75077,28,3,25
2019,Enlisted,75098,36,10,26
2019,Enlisted,75110,30,1,29
2019,Enlisted,75159,61,18,43
2019,Enlisted,75160,24,6,18
2019,Enlisted,75165,17,1,16
2019,Enlisted,75220,12,5,7
2019,Enlisted,75402,44,15,29
2019,Enlisted,75570,1,1,0
2019,Enlisted,75662,7,3,4
2019,Enlisted,75709,22,7,15
2019,Enlisted,75803,4,1,3
2019,Enlisted,75901,46,8,38
2019,Enlisted,76067,1,0,1
2019,Enlisted,76086,18,1,17
2019,Enlisted,76108,46,10,36
2019,Enlisted,76115,10,3,7
2019,Enlisted,76207,14,3,11
2019,Enlisted,76234,6,1,5
2019,Enlisted,76302,17,4,13
2019,Enlisted,76401,26,1,25
2019,Enlisted,76502,10,3,7
2019,Enlisted,76528,4,0,4
2019,Enlisted,76542,56,24,32
2019,Enlisted,76544,2,1,1
2019,Enlisted,76574,34,11,23
2019,Enlisted,76707,84,25,59
2019,Enlisted,76801,21,0,21
2019,Enlisted,76905,9,3,6
2019,Enlisted,77034,188,47,141
2019,Enlisted,77067,60,18,42
2019,Enlisted,77082,93,17,76
2019,Enlisted,77340,39,8,31
2019,Enlisted,77437,41,5,36
2019,Enlisted,77471,26,5,21
2019,Enlisted,77503,8,7,1
2019,Enlisted,77515,53,5,48
2019,Enlisted,77568,20,6,14
2019,Enlisted,77802,41,9,32
2019,Enlisted,77833,15,3,12
2019,Enlisted,77904,13,3,10
2019,Enlisted,78041,22,6,16
2019,Enlisted,78130,13,3,10
2019,Enlisted,78155,9,4,5
2019,Enlisted,78218,53,13,40
2019,Enlisted,78219,128,31,97
2019,Enlisted,78257,160,46,114
2019,Enlisted,78363,22,2,20
2019,Enlisted,78416,28,5,23
2019,Enlisted,78520,7,1,6
2019,Enlisted,78596,64,12,52
2019,Enlisted,78602,124,29,95
2019,Enlisted,78617,150,56,94
2019,Enlisted,78624,3,1,2
2019,Enlisted,78654,5,2,3
2019,Enlisted,78665,42,24,18
2019,Enlisted,78666,62,23,39
2019,Enlisted,78703,128,30,98
2019,Enlisted,78731,52,16,36
2019,Enlisted,78746,1,1,0
2019,Enlisted,78861,5,1,4
2019,Enlisted,79107,33,2,31
2019,Enlisted,79403,40,7,33
2019,Enlisted,79607,35,7,28
2019,Enlisted,79706,13,2,11
2019,Enlisted,79924,12,2,10
2019,Enlisted,79936,126,32,94
2019,Enlisted,80011,78,40,38
2019,Enlisted,80012,13,2,11
2019,Enlisted,80112,5,2,3
2019,Enlisted,80137,66,39,27
2019,Enlisted,80216,81,24,57
2019,Enlisted,80501,6,4,2
2019,Enlisted,80504,17,7,10
2019,Enlisted,80521,10,3,7
2019,Enlisted,80621,24,10,14
2019,Enlisted,80751,2,1,1
2019,Enlisted,80907,15,5,10
2019,Enlisted,80913,21,14,7
2019,Enlisted,80916,10,6,4
2019,Enlisted,80920,67,43,24
2019,Enlisted,81004,20,10,10
2019,Enlisted,81101,11,2,9
2019,Enlisted,81401,24,8,16
2019,Enlisted,81501,15,7,8
2019,Enlisted,82005,15,4,11
2019,Enlisted,82009,18,4,14
2019,Enlisted,82072,18,2,16
2019,Enlisted,82201,3,0,3
2019,Enlisted,82214,12,4,8
2019,Enlisted,82240,14,1,13
2019,Enlisted,82435,5,3,2
2019,Enlisted,82520,17,1,16
2019,Enlisted,82604,5,1,4
2019,Enlisted,82633,14,0,14
2019,Enlisted,82716,16,1,15
2019,Enlisted,82801,9,1,8
2019,Enlisted,82901,22,2,20
2019,Enlisted,82930,13,1,12
2019,Enlisted,83110,15,1,14
2019,Enlisted,83202,27,6,21
2019,Enlisted,83221,13,2,11
2019,Enlisted,83263,5,1,4
2019,Enlisted,83301,9,1,8
2019,Enlisted,83318,20,2,18
2019,Enlisted,83330,2,0,2
2019,Enlisted,83338,19,0,19
2019,Enlisted,83402,12,4,8
2019,Enlisted,83440,6,2,4
2019,Enlisted,83442,3,0,3
2019,Enlisted,83445,5,1,4
2019,Enlisted,83501,9,1,8
2019,Enlisted,83530,3,1,2
2019,Enlisted,83544,1,1,0
2019,Enlisted,83605,34,5,29
2019,Enlisted,83617,11,0,11
2019,Enlisted,83647,8,1,7
2019,Enlisted,83687,10,2,8
2019,Enlisted,83705,143,32,111
2019,Enlisted,83716,3,1,2
2019,Enlisted,83843,4,0,4
2019,Enlisted,83854,22,0,22
2019,Enlisted,84003,22,5,17
2019,Enlisted,84020,25,7,18
2019,Enlisted,84032,7,1,6
2019,Enlisted,84043,51,22,29
2019,Enlisted,84058,30,4,26
2019,Enlisted,84065,115,35,80
2019,Enlisted,84074,14,0,14
2019,Enlisted,84078,9,3,6
2019,Enlisted,84083,1,1,0
2019,Enlisted,84084,61,11,50
2019,Enlisted,84116,17,0,17
2019,Enlisted,84321,7,1,6
2019,Enlisted,84404,5,1,4
2019,Enlisted,84405,62,5,57
2019,Enlisted,84501,10,3,7
2019,Enlisted,84511,15,1,14
2019,Enlisted,84642,8,0,8
2019,Enlisted,84647,4,0,4
2019,Enlisted,84660,24,0,24
2019,Enlisted,84663,5,0,5
2019,Enlisted,84701,8,2,6
2019,Enlisted,84713,5,1,4
2019,Enlisted,84721,16,3,13
2019,Enlisted,84770,9,1,8
2019,Enlisted,84790,26,3,23
2019,Enlisted,85008,261,82,179
2019,Enlisted,85015,2,0,2
2019,Enlisted,85020,14,3,11
2019,Enlisted,85122,29,10,19
2019,Enlisted,85128,3,2,1
2019,Enlisted,85132,91,13,78
2019,Enlisted,85145,28,8,20
2019,Enlisted,85281,15,7,8
2019,Enlisted,85286,8,2,6
2019,Enlisted,85301,6,1,5
2019,Enlisted,85312,12,4,8
2019,Enlisted,85365,7,4,3
2019,Enlisted,85396,33,16,17
2019,Enlisted,85546,4,0,4
2019,Enlisted,85607,7,0,7
2019,Enlisted,85706,25,9,16
2019,Enlisted,85713,23,8,15
2019,Enlisted,85901,3,1,2
2019,Enlisted,86015,67,10,57
2019,Enlisted,86301,23,6,17
2019,Enlisted,87002,34,4,30
2019,Enlisted,87123,23,5,18
2019,Enlisted,87144,125,34,91
2019,Enlisted,87305,2,1,1
2019,Enlisted,87401,14,5,9
2019,Enlisted,87508,25,8,17
2019,Enlisted,87532,5,2,3
2019,Enlisted,87557,3,0,3
2019,Enlisted,87701,3,0,3
2019,Enlisted,87747,2,0,2
2019,Enlisted,88001,3,1,2
2019,Enlisted,88007,106,33,73
2019,Enlisted,88101,8,0,8
2019,Enlisted,88203,36,6,30
2019,Enlisted,88240,6,2,4
2019,Enlisted,88310,12,8,4
2019,Enlisted,88435,6,2,4
2019,Enlisted,89002,5,1,4
2019,Enlisted,89032,10,1,9
2019,Enlisted,89139,115,7,108
2019,Enlisted,89165,199,19,180
2019,Enlisted,89406,19,2,17
2019,Enlisted,89506,118,19,99
2019,Enlisted,89509,9,0,9
2019,Enlisted,89701,21,1,20
2019,Enlisted,89801,2,2,0
2019,Enlisted,90025,20,6,14
2019,Enlisted,90201,51,16,35
2019,Enlisted,90249,20,7,13
2019,Enlisted,90266,6,1,5
2019,Enlisted,90302,14,5,9
2019,Enlisted,90501,21,3,18
2019,Enlisted,90720,225,80,145
2019,Enlisted,90731,10,5,5
2019,Enlisted,90813,2,2,0
2019,Enlisted,90822,64,23,41
2019,Enlisted,91205,28,12,16
2019,Enlisted,91406,45,10,35
2019,Enlisted,91505,29,5,24
2019,Enlisted,91702,66,28,38
2019,Enlisted,91764,44,12,32
2019,Enlisted,91766,48,11,37
2019,Enlisted,91950,51,13,38
2019,Enlisted,92020,18,12,6
2019,Enlisted,92025,6,4,2
2019,Enlisted,92111,74,32,42
2019,Enlisted,92243,12,1,11
2019,Enlisted,92307,14,7,7
2019,Enlisted,92311,11,2,9
2019,Enlisted,92324,21,8,13
2019,Enlisted,92410,20,8,12
2019,Enlisted,92501,16,10,6
2019,Enlisted,92518,70,23,47
2019,Enlisted,92707,13,5,8
2019,Enlisted,92833,19,9,10
2019,Enlisted,92866,19,12,7
2019,Enlisted,93003,5,1,4
2019,Enlisted,93257,4,3,1
2019,Enlisted,93291,10,5,5
2019,Enlisted,93307,42,18,24
2019,Enlisted,93405,16,6,10
2019,Enlisted,93422,2,1,1
2019,Enlisted,93451,16,13,3
2019,Enlisted,93536,32,8,24
2019,Enlisted,93550,28,7,21
2019,Enlisted,93638,5,2,3
2019,Enlisted,93727,70,15,55
2019,Enlisted,93955,5,1,4
2019,Enlisted,94043,7,5,2
2019,Enlisted,94132,9,4,5
2019,Enlisted,94401,18,3,15
2019,Enlisted,94510,6,3,3
2019,Enlisted,94519,13,1,12
2019,Enlisted,94533,8,0,8
2019,Enlisted,94565,24,3,21
2019,Enlisted,94568,20,8,12
2019,Enlisted,94590,22,3,19
2019,Enlisted,94596,3,0,3
2019,Enlisted,94804,25,5,20
2019,Enlisted,94903,3,1,2
2019,Enlisted,94952,18,3,15
2019,Enlisted,95020,1,1,0
2019,Enlisted,95110,21,6,15
2019,Enlisted,95206,45,10,35
2019,Enlisted,95231,1,0,1
2019,Enlisted,95240,8,3,5
2019,Enlisted,95341,23,2,21
2019,Enlisted,95351,24,15,9
2019,Enlisted,95361,11,2,9
2019,Enlisted,95380,15,4,11
2019,Enlisted,95401,21,2,19
2019,Enlisted,95503,9,5,4
2019,Enlisted,95655,13,6,7
2019,Enlisted,95665,2,0,2
2019,Enlisted,95678,21,4,17
2019,Enlisted,95815,4,1,3
2019,Enlisted,95826,5,2,3
2019,Enlisted,95828,76,29,47
2019,Enlisted,95832,24,8,16
2019,Enlisted,95926,23,2,21
2019,Enlisted,95965,11,5,6
2019,Enlisted,96001,16,5,11
2019,Enlisted,96067,1,0,1
2019,Enlisted,96080,12,0,12
2019,Enlisted,96130,1,0,1
2019,Enlisted,96707,160,36,124
2019,Enlisted,96716,13,4,9
2019,Enlisted,96720,23,6,17
2019,Enlisted,96732,12,3,9
2019,Enlisted,96748,2,0,2
2019,Enlisted,96750,7,0,7
2019,Enlisted,96753,2,1,1
2019,Enlisted,96782,24,9,15
2019,Enlisted,96786,35,8,27
2019,Enlisted,96789,19,5,14
2019,Enlisted,96857,27,8,19
2019,Enlisted,96913,124,9,115
2019,Enlisted,97015,86,25,61
2019,Enlisted,97030,22,7,15
2019,Enlisted,97031,9,0,9
2019,Enlisted,97051,10,1,9
2019,Enlisted,97058,6,1,5
2019,Enlisted,97071,23,4,19
2019,Enlisted,97116,30,8,22
2019,Enlisted,97124,6,2,4
2019,Enlisted,97128,9,1,8
2019,Enlisted,97146,13,1,12
2019,Enlisted,97211,38,9,29
2019,Enlisted,97217,10,2,8
2019,Enlisted,97218,51,12,39
2019,Enlisted,97301,10,1,9
2019,Enlisted,97302,25,3,22
2019,Enlisted,97303,23,7,16
2019,Enlisted,97309,32,10,22
2019,Enlisted,97321,11,3,8
2019,Enlisted,97330,16,6,10
2019,Enlisted,97338,20,4,16
2019,Enlisted,97355,7,0,7
2019,Enlisted,97365,4,2,2
2019,Enlisted,97420,5,1,4
2019,Enlisted,97470,8,3,5
2019,Enlisted,97477,76,19,57
2019,Enlisted,97501,42,7,35
2019,Enlisted,97520,14,3,11
2019,Enlisted,97526,11,1,10
2019,Enlisted,97603,9,4,5
2019,Enlisted,97702,13,1,12
2019,Enlisted,97754,9,1,8
2019,Enlisted,97756,15,2,13
2019,Enlisted,97801,13,4,9
2019,Enlisted,97814,3,0,3
2019,Enlisted,97838,5,2,3
2019,Enlisted,97850,11,1,10
2019,Enlisted,97862,7,1,6
2019,Enlisted,97914,2,1,1
2019,Enlisted,98032,63,28,35
2019,Enlisted,98052,18,7,11
2019,Enlisted,98108,29,7,22
2019,Enlisted,98119,62,24,38
2019,Enlisted,98221,14,2,12
2019,Enlisted,98271,15,2,13
2019,Enlisted,98290,25,8,17
2019,Enlisted,98312,16,7,9
2019,Enlisted,98321,7,6,1
2019,Enlisted,98372,9,2,7
2019,Enlisted,98430,57,31,26
2019,Enlisted,98433,97,44,53
2019,Enlisted,98501,22,7,15
2019,Enlisted,98531,23,9,14
2019,Enlisted,98563,15,4,11
2019,Enlisted,98632,17,3,14
2019,Enlisted,98682,5,0,5
2019,Enlisted,98801,9,2,7
2019,Enlisted,98823,3,0,3
2019,Enlisted,98837,13,4,9
2019,Enlisted,98901,33,10,23
2019,Enlisted,98903,11,3,8
2019,Enlisted,98930,9,1,8
2019,Enlisted,99011,40,13,27
2019,Enlisted,99217,42,16,26
2019,Enlisted,99219,2,1,1
2019,Enlisted,99224,1,1,0
2019,Enlisted,99301,8,2,6
2019,Enlisted,99362,5,1,4
2019,Enlisted,99505,107,35,72
2019,Enlisted,99654,7,1,6
2019,Enlisted,99682,2,2,0
2019,Enlisted,99686,1,0,1
2019,Enlisted,99687,13,2,11
2019,Enlisted,99701,17,6,11
2019,Enlisted,99723,1,1,0
2019,Enlisted,99835,1,0,1
2019,Officer,00604,1,1,0
2019,Officer,00624,1,1,0
2019,Officer,00641,2,2,0
2019,Officer,00682,2,2,0
2019,Officer,00683,1,1,0
2019,Officer,00693,1,1,0
2019,Officer,00705,1,1,0
2019,Officer,00725,1,1,0
2019,Officer,00736,3,3,0
2019,Officer,00751,1,1,0
2019,Officer,00769,3,3,0
2019,Officer,00785,1,1,0
2019,Officer,00795,3,3,0
2019,Officer,00802,2,1,1
2019,Officer,00850,6,5,1
2019,Officer,00901,7,3,4
2019,Officer,00934,3,2,1
2019,Officer,00951,1,1,0
2019,Officer,01013,3,3,0
2019,Officer,01082,1,1,0
2019,Officer,01085,1,1,0
2019,Officer,01109,3,3,0
2019,Officer,01434,2,2,0
2019,Officer,01440,2,2,0
2019,Officer,01453,1,1,0
2019,Officer,01588,2,2,0
2019,Officer,01605,3,3,0
2019,Officer,01701,1,1,0
2019,Officer,01731,3,3,0
2019,Officer,01760,8,8,0
2019,Officer,01844,2,2,0
2019,Officer,01867,3,3,0
2019,Officer,01950,2,2,0
2019,Officer,02169,2,2,0
2019,Officer,02176,3,3,0
2019,Officer,02184,1,1,0
2019,Officer,02301,6,6,0
2019,Officer,02346,1,1,0
2019,Officer,02420,1,1,0
2019,Officer,02542,6,6,0
2019,Officer,02769,1,1,0
2019,Officer,02780,2,2,0
2019,Officer,02809,2,2,0
2019,Officer,02816,3,3,0
2019,Officer,02818,3,2,1
2019,Officer,02852,2,2,0
2019,Officer,02886,2,1,1
2019,Officer,02904,3,3,0
2019,Officer,02920,2,2,0
2019,Officer,03101,2,2,0
2019,Officer,03235,1,1,0
2019,Officer,03275,1,1,0
2019,Officer,03301,6,6,0
2019,Officer,03561,1,1,0
2019,Officer,03766,1,1,0
2019,Officer,03867,2,2,0
2019,Officer,04011,1,1,0
2019,Officer,04240,2,2,0
2019,Officer,04330,5,5,0
2019,Officer,04333,3,3,0
2019,Officer,04401,5,5,0
2019,Officer,04412,1,1,0
2019,Officer,04901,2,2,0
2019,Officer,04976,2,2,0
2019,Officer,05158,1,1,0
2019,Officer,05201,2,2,0
2019,Officer,05403,1,1,0
2019,Officer,05404,2,2,0
2019,Officer,05446,17,17,0
2019,Officer,05465,13,13,0
2019,Officer,05478,1,1,0
2019,Officer,05495,4,4,0
2019,Officer,05661,1,1,0
2019,Officer,05676,2,2,0
2019,Officer,05701,2,2,0
2019,Officer,05851,1,1,0
2019,Officer,05855,1,1,0
2019,Officer,06051,1,1,0
2019,Officer,06096,2,2,0
2019,Officer,06110,1,0,1
2019,Officer,06320,2,1,1
2019,Officer,06357,2,2,0
2019,Officer,06360,2,2,0
2019,Officer,06457,3,2,1
2019,Officer,06614,2,2,0
2019,Officer,06702,2,1,1
2019,Officer,06810,3,3,0
2019,Officer,07052,1,1,0
2019,Officer,07090,1,1,0
2019,Officer,07107,1,1,0
2019,Officer,07306,3,2,1
2019,Officer,07457,2,2,0
2019,Officer,07666,4,4,0
2019,Officer,07728,2,2,0
2019,Officer,07801,2,2,0
2019,Officer,07865,2,1,1
2019,Officer,07871,1,1,0
2019,Officer,08002,1,1,0
2019,Officer,08012,2,2,0
2019,Officer,08037,2,2,0
2019,Officer,08060,1,1,0
2019,Officer,08096,3,2,1
2019,Officer,08360,1,1,0
2019,Officer,08640,5,4,1
2019,Officer,08648,2,2,0
2019,Officer,08733,3,3,0
2019,Officer,08750,2,2,0
2019,Officer,08759,1,1,0
2019,Officer,08873,3,3,0
2019,Officer,10010,5,5,0
2019,Officer,10037,1,0,1
2019,Officer,10314,2,2,0
2019,Officer,10468,1,0,1
2019,Officer,10566,6,5,1
2019,Officer,10567,9,7,2
2019,Officer,10701,2,2,0
2019,Officer,10962,3,1,2
2019,Officer,11252,5,4,1
2019,Officer,11357,4,3,1
2019,Officer,11433,2,1,1
2019,Officer,11735,4,4,0
2019,Officer,12110,7,5,2
2019,Officer,12180,2,1,1
2019,Officer,12189,3,2,1
2019,Officer,12302,9,8,1
2019,Officer,12401,1,0,1
2019,Officer,12451,1,0,1
2019,Officer,12553,1,1,0
2019,Officer,13211,5,5,0
2019,Officer,13501,6,5,1
2019,Officer,13602,1,0,1
2019,Officer,13905,5,2,3
2019,Officer,14048,1,0,1
2019,Officer,14094,2,2,0
2019,Officer,14204,7,7,0
2019,Officer,14213,6,5,1
2019,Officer,14304,3,1,2
2019,Officer,14454,1,0,1
2019,Officer,14456,3,1,2
2019,Officer,14624,8,6,2
2019,Officer,14701,1,1,0
2019,Officer,14845,1,0,1
2019,Officer,15010,2,2,0
2019,Officer,15216,1,1,0
2019,Officer,15301,4,4,0
2019,Officer,15370,1,1,0
2019,Officer,15444,1,1,0
2019,Officer,15666,4,3,1
2019,Officer,15701,1,1,0
2019,Officer,15767,1,1,0
2019,Officer,15902,1,1,0
2019,Officer,15904,2,2,0
2019,Officer,16101,1,1,0
2019,Officer,16148,1,1,0
2019,Officer,16226,1,1,0
2019,Officer,16403,3,3,0
2019,Officer,16635,1,1,0
2019,Officer,16803,3,3,0
2019,Officer,16830,1,1,0
2019,Officer,17003,24,23,1
2019,Officer,17022,2,2,0
2019,Officer,17042,2,2,0
2019,Officer,17044,1,1,0
2019,Officer,17103,4,4,0
2019,Officer,17201,1,1,0
2019,Officer,17331,1,1,0
2019,Officer,17701,1,1,0
2019,Officer,17821,1,1,0
2019,Officer,18040,1,1,0
2019,Officer,18102,3,3,0
2019,Officer,18201,1,1,0
2019,Officer,18466,1,1,0
2019,Officer,18509,6,6,0
2019,Officer,18634,1,1,0
2019,Officer,18651,1,1,0
2019,Officer,18704,2,2,0
2019,Officer,19044,2,2,0
2019,Officer,19153,4,4,0
2019,Officer,19154,7,7,0
2019,Officer,19462,1,1,0
2019,Officer,19475,1,1,0
2019,Officer,19526,2,2,0
2019,Officer,19530,1,1,0
2019,Officer,19605,2,2,0
2019,Officer,19706,1,1,0
2019,Officer,19711,1,1,0
2019,Officer,19720,7,6,1
2019,Officer,19804,1,1,0
2019,Officer,19947,1,1,0
2019,Officer,19977,3,3,0
2019,Officer,20003,20,20,0
2019,Officer,20186,1,1,0
2019,Officer,20373,1,1,0
2019,Officer,20708,1,1,0
2019,Officer,21010,13,11,2
2019,Officer,21057,3,3,0
2019,Officer,21078,2,2,0
2019,Officer,21136,6,4,2
2019,Officer,21157,2,2,0
2019,Officer,21201,5,5,0
2019,Officer,21222,2,2,0
2019,Officer,21228,2,2,0
2019,Officer,21236,1,1,0
2019,Officer,21401,1,1,0
2019,Officer,21502,1,1,0
2019,Officer,21701,1,1,0
2019,Officer,21801,2,2,0
2019,Officer,22032,9,7,2
2019,Officer,22060,6,5,1
2019,Officer,22401,4,3,1
2019,Officer,22427,2,2,0
2019,Officer,22602,6,5,1
2019,Officer,22664,1,1,0
2019,Officer,22902,4,2,2
2019,Officer,23150,5,3,2
2019,Officer,23237,1,1,0
2019,Officer,23434,2,2,0
2019,Officer,23451,4,4,0
2019,Officer,23502,3,3,0
2019,Officer,23609,1,1,0
2019,Officer,23666,7,6,1
2019,Officer,23805,1,1,0
2019,Officer,23824,6,4,2
2019,Officer,23847,1,1,0
2019,Officer,23851,1,1,0
2019,Officer,23901,1,1,0
2019,Officer,24073,1,1,0
2019,Officer,24251,1,0,1
2019,Officer,24401,1,1,0
2019,Officer,24450,2,2,0
2019,Officer,24502,2,2,0
2019,Officer,24957,1,1,0
2019,Officer,25168,3,3,0
2019,Officer,25309,1,1,0
2019,Officer,25530,4,4,0
2019,Officer,25625,1,1,0
2019,Officer,25846,3,3,0
2019,Officer,26041,2,2,0
2019,Officer,26101,3,3,0
2019,Officer,26187,2,2,0
2019,Officer,26201,1,1,0
2019,Officer,26250,1,1,0
2019,Officer,26301,1,1,0
2019,Officer,26426,1,1,0
2019,Officer,26537,3,3,0
2019,Officer,26554,1,1,0
2019,Officer,27103,4,4,0
2019,Officer,27204,2,1,1
2019,Officer,27217,4,4,0
2019,Officer,27320,2,2,0
2019,Officer,27360,1,1,0
2019,Officer,27401,3,2,1
2019,Officer,27509,1,1,0
2019,Officer,27530,2,2,0
2019,Officer,27549,1,1,0
2019,Officer,27560,9,6,3
2019,Officer,27581,2,2,0
2019,Officer,27596,4,4,0
2019,Officer,27607,6,6,0
2019,Officer,27704,3,2,1
2019,Officer,27834,1,1,0
2019,Officer,27856,1,1,0
2019,Officer,27870,2,2,0
2019,Officer,28001,1,1,0
2019,Officer,28027,2,2,0
2019,Officer,28054,5,5,0
2019,Officer,28147,2,2,0
2019,Officer,28170,2,2,0
2019,Officer,28208,5,5,0
2019,Officer,28306,7,7,0
2019,Officer,28310,5,5,0
2019,Officer,28328,4,4,0
2019,Officer,28371,1,1,0
2019,Officer,28376,4,4,0
2019,Officer,28382,1,1,0
2019,Officer,28388,1,1,0
2019,Officer,28401,2,2,0
2019,Officer,28405,2,2,0
2019,Officer,28472,1,1,0
2019,Officer,28504,1,0,1
2019,Officer,28518,1,1,0
2019,Officer,28540,3,3,0
2019,Officer,28590,1,1,0
2019,Officer,28601,1,1,0
2019,Officer,28734,2,2,0
2019,Officer,28806,1,1,0
2019,Officer,29006,2,2,0
2019,Officer,29020,3,3,0
2019,Officer,29044,17,17,0
2019,Officer,29102,2,2,0
2019,Officer,29115,4,4,0
2019,Officer,29151,1,1,0
2019,Officer,29172,1,1,0
2019,Officer,29201,3,3,0
2019,Officer,29303,7,7,0
2019,Officer,29379,3,3,0
2019,Officer,29403,5,5,0
2019,Officer,29418,2,2,0
2019,Officer,29461,1,1,0
2019,Officer,29464,5,5,0
2019,Officer,29506,1,1,0
2019,Officer,29512,3,3,0
2019,Officer,29532,3,3,0
2019,Officer,29550,2,2,0
2019,Officer,29556,1,1,0
2019,Officer,29620,2,2,0
2019,Officer,29625,3,3,0
2019,Officer,29641,1,1,0
2019,Officer,29646,1,1,0
2019,Officer,29653,2,2,0
2019,Officer,29678,6,6,0
2019,Officer,29706,1,1,0
2019,Officer,29715,3,3,0
2019,Officer,29732,1,1,0
2019,Officer,29824,5,5,0
2019,Officer,29944,1,1,0
2019,Officer,30014,1,1,0
2019,Officer,30032,1,1,0
2019,Officer,30040,6,6,0
2019,Officer,30060,28,24,4
2019,Officer,30069,6,4,2
2019,Officer,30114,1,1,0
2019,Officer,30125,1,1,0
2019,Officer,30134,1,1,0
2019,Officer,30144,1,1,0
2019,Officer,30233,2,2,0
2019,Officer,30240,3,3,0
2019,Officer,30263,1,1,0
2019,Officer,30294,5,5,0
2019,Officer,30297,14,14,0
2019,Officer,30336,2,2,0
2019,Officer,30427,2,0,2
2019,Officer,30439,1,1,0
2019,Officer,30501,1,1,0
2019,Officer,30597,3,2,1
2019,Officer,30635,5,5,0
2019,Officer,30680,5,5,0
2019,Officer,30701,7,7,0
2019,Officer,30720,1,1,0
2019,Officer,30824,1,0,1
2019,Officer,30830,2,2,0
2019,Officer,30904,5,4,1
2019,Officer,30905,2,2,0
2019,Officer,31029,4,3,1
2019,Officer,31040,2,2,0
2019,Officer,31061,7,6,1
2019,Officer,31211,10,10,0
2019,Officer,31314,10,7,3
2019,Officer,31406,4,3,1
2019,Officer,31409,1,1,0
2019,Officer,31520,1,1,0
2019,Officer,31533,2,2,0
2019,Officer,31601,1,1,0
2019,Officer,31792,3,3,0
2019,Officer,31794,1,1,0
2019,Officer,31905,3,3,0
2019,Officer,32055,3,3,0
2019,Officer,32084,4,4,0
2019,Officer,32086,3,3,0
2019,Officer,32091,13,13,0
2019,Officer,32164,2,2,0
2019,Officer,32177,1,1,0
2019,Officer,32221,10,10,0
2019,Officer,32311,2,2,0
2019,Officer,32351,2,2,0
2019,Officer,32406,2,2,0
2019,Officer,32425,1,1,0
2019,Officer,32428,1,1,0
2019,Officer,32514,4,4,0
2019,Officer,32724,1,1,0
2019,Officer,32771,2,2,0
2019,Officer,32806,3,3,0
2019,Officer,32935,1,1,0
2019,Officer,33027,4,4,0
2019,Officer,33039,1,1,0
2019,Officer,33127,2,2,0
2019,Officer,33315,2,2,0
2019,Officer,33405,1,1,0
2019,Officer,33406,2,2,0
2019,Officer,33563,1,1,0
2019,Officer,33711,6,6,0
2019,Officer,33782,14,14,0
2019,Officer,33811,1,1,0
2019,Officer,33844,1,1,0
2019,Officer,33859,1,1,0
2019,Officer,33880,1,1,0
2019,Officer,33916,1,1,0
2019,Officer,34221,2,2,0
2019,Officer,34266,5,5,0
2019,Officer,34429,1,1,0
2019,Officer,34604,1,1,0
2019,Officer,34748,1,1,0
2019,Officer,34947,1,1,0
2019,Officer,35010,4,4,0
2019,Officer,35016,2,2,0
2019,Officer,35040,1,1,0
2019,Officer,35042,9,9,0
2019,Officer,35055,4,4,0
2019,Officer,35121,2,2,0
2019,Officer,35124,1,1,0
2019,Officer,35146,1,1,0
2019,Officer,35209,2,2,0
2019,Officer,35217,4,4,0
2019,Officer,35405,3,3,0
2019,Officer,35501,2,2,0
2019,Officer,35565,6,6,0
2019,Officer,35601,6,6,0
2019,Officer,35613,1,1,0
2019,Officer,35803,5,5,0
2019,Officer,35805,2,2,0
2019,Officer,35904,2,2,0
2019,Officer,35967,1,1,0
2019,Officer,36043,8,8,0
2019,Officer,36067,1,1,0
2019,Officer,36109,6,6,0
2019,Officer,36117,3,3,0
2019,Officer,36121,1,1,0
2019,Officer,36203,2,2,0
2019,Officer,36205,2,2,0
2019,Officer,36250,1,1,0
2019,Officer,36251,1,1,0
2019,Officer,36265,3,3,0
2019,Officer,36322,2,2,0
2019,Officer,36340,1,1,0
2019,Officer,36420,1,1,0
2019,Officer,36522,1,1,0
2019,Officer,36532,4,4,0
2019,Officer,36535,1,1,0
2019,Officer,36605,8,8,0
2019,Officer,36801,1,1,0
2019,Officer,36832,1,1,0
2019,Officer,36854,2,2,0
2019,Officer,37015,3,3,0
2019,Officer,37042,1,1,0
2019,Officer,37056,2,2,0
2019,Officer,37090,1,1,0
2019,Officer,37097,1,0,1
2019,Officer,37110,2,1,1
2019,Officer,37129,3,3,0
2019,Officer,37167,6,4,2
2019,Officer,37204,12,11,1
2019,Officer,37217,4,4,0
2019,Officer,37303,2,2,0
2019,Officer,37404,5,5,0
2019,Officer,37615,2,2,0
2019,Officer,37620,1,1,0
2019,Officer,37644,1,1,0
2019,Officer,37645,1,0,1
2019,Officer,37777,4,4,0
2019,Officer,37801,1,1,0
2019,Officer,37821,1,1,0
2019,Officer,37854,1,1,0
2019,Officer,37863,1,1,0
2019,Officer,37874,1,1,0
2019,Officer,37919,2,2,0
2019,Officer,37939,1,1,0
2019,Officer,38024,2,2,0
2019,Officer,38118,2,2,0
2019,Officer,38320,1,1,0
2019,Officer,38340,1,0,1
2019,Officer,38343,1,1,0
2019,Officer,38358,2,1,1
2019,Officer,38372,1,1,0
2019,Officer,38382,9,8,1
2019,Officer,38464,1,1,0
2019,Officer,38506,4,4,0
2019,Officer,38572,1,0,1
2019,Officer,38606,1,1,0
2019,Officer,38668,1,1,0
2019,Officer,38701,2,2,0
2019,Officer,38801,4,4,0
2019,Officer,38803,1,1,0
2019,Officer,38821,1,1,0
2019,Officer,38829,1,1,0
2019,Officer,38915,2,2,0
2019,Officer,38916,1,1,0
2019,Officer,39042,1,1,0
2019,Officer,39046,1,1,0
2019,Officer,39051,1,1,0
2019,Officer,39059,1,1,0
2019,Officer,39111,1,0,1
2019,Officer,39117,3,3,0
2019,Officer,39202,7,4,3
2019,Officer,39204,9,8,1
2019,Officer,39209,1,1,0
2019,Officer,39216,3,3,0
2019,Officer,39307,2,2,0
2019,Officer,39345,2,2,0
2019,Officer,39401,1,1,0
2019,Officer,39407,2,2,0
2019,Officer,39422,1,1,0
2019,Officer,39452,2,0,2
2019,Officer,39466,1,1,0
2019,Officer,39507,2,2,0
2019,Officer,39532,1,1,0
2019,Officer,39556,1,1,0
2019,Officer,39648,1,1,0
2019,Officer,39760,2,2,0
2019,Officer,39773,1,1,0
2019,Officer,40004,3,3,0
2019,Officer,40065,2,1,1
2019,Officer,40205,4,3,1
2019,Officer,40218,3,3,0
2019,Officer,40311,3,3,0
2019,Officer,40330,1,0,1
2019,Officer,40351,2,1,1
2019,Officer,40422,1,1,0
2019,Officer,40475,7,7,0
2019,Officer,40510,6,6,0
2019,Officer,40601,16,15,1
2019,Officer,40831,1,1,0
2019,Officer,40906,2,2,0
2019,Officer,41005,7,5,2
2019,Officer,41008,1,1,0
2019,Officer,41101,3,2,1
2019,Officer,41701,3,2,1
2019,Officer,42064,1,0,1
2019,Officer,42071,2,2,0
2019,Officer,42086,1,1,0
2019,Officer,42101,4,4,0
2019,Officer,42141,5,5,0
2019,Officer,42167,1,1,0
2019,Officer,42240,1,1,0
2019,Officer,42301,2,2,0
2019,Officer,42330,1,1,0
2019,Officer,42345,1,1,0
2019,Officer,42633,1,1,0
2019,Officer,42754,1,1,0
2019,Officer,43015,3,2,1
2019,Officer,43040,2,2,0
2019,Officer,43055,6,6,0
2019,Officer,43102,2,2,0
2019,Officer,43213,11,9,2
2019,Officer,43217,5,3,2
2019,Officer,43235,8,5,3
2019,Officer,43402,2,1,1
2019,Officer,43465,3,3,0
2019,Officer,43614,1,1,0
2019,Officer,43756,6,6,0
2019,Officer,43812,1,1,0
2019,Officer,44023,2,1,1
2019,Officer,44055,1,1,0
2019,Officer,44128,5,5,0
2019,Officer,44142,3,3,0
2019,Officer,44224,5,5,0
2019,Officer,44601,1,1,0
2019,Officer,44720,2,2,0
2019,Officer,44857,2,1,1
2019,Officer,44870,3,3,0
2019,Officer,44883,2,2,0
2019,Officer,44903,2,2,0
2019,Officer,45015,3,3,0
2019,Officer,45036,1,0,1
2019,Officer,45044,1,1,0
2019,Officer,45215,6,5,1
2019,Officer,45331,2,1,1
2019,Officer,45356,1,1,0
2019,Officer,45385,1,1,0
2019,Officer,45430,2,2,0
2019,Officer,45502,1,1,0
2019,Officer,45601,1,1,0
2019,Officer,45662,3,1,2
2019,Officer,46012,2,2,0
2019,Officer,46036,1,1,0
2019,Officer,46041,3,3,0
2019,Officer,46052,1,1,0
2019,Officer,46122,1,1,0
2019,Officer,46124,4,3,1
2019,Officer,46131,13,9,4
2019,Officer,46135,4,3,1
2019,Officer,46140,1,1,0
2019,Officer,46151,2,2,0
2019,Officer,46176,3,3,0
2019,Officer,46216,5,5,0
2019,Officer,46241,16,11,5
2019,Officer,46323,1,1,0
2019,Officer,46360,2,1,1
2019,Officer,46383,2,1,1
2019,Officer,46402,4,4,0
2019,Officer,46406,5,2,3
2019,Officer,46517,1,0,1
2019,Officer,46703,1,1,0
2019,Officer,46750,1,1,0
2019,Officer,46901,2,2,0
2019,Officer,46953,1,1,0
2019,Officer,47150,1,1,0
2019,Officer,47203,2,2,0
2019,Officer,47265,1,1,0
2019,Officer,47303,1,1,0
2019,Officer,47348,1,1,0
2019,Officer,47401,1,1,0
2019,Officer,47441,1,1,0
2019,Officer,47501,1,1,0
2019,Officer,47546,1,1,0
2019,Officer,47715,1,1,0
2019,Officer,47834,1,1,0
2019,Officer,47872,1,1,0
2019,Officer,47905,1,0,1
2019,Officer,47933,1,1,0
2019,Officer,47977,1,1,0
2019,Officer,47978,1,1,0
2019,Officer,48045,1,1,0
2019,Officer,48060,1,1,0
2019,Officer,48180,6,6,0
2019,Officer,48197,1,0,1
2019,Officer,48208,3,3,0
2019,Officer,48234,10,8,2
2019,Officer,48341,1,1,0
2019,Officer,48446,2,2,0
2019,Officer,48601,7,7,0
2019,Officer,48706,1,1,0
2019,Officer,48837,6,4,2
2019,Officer,48843,3,3,0
2019,Officer,48906,10,9,1
2019,Officer,48912,5,5,0
2019,Officer,49009,3,2,1
2019,Officer,49012,5,5,0
2019,Officer,49047,2,2,0
2019,Officer,49201,3,3,0
2019,Officer,49224,3,3,0
2019,Officer,49306,1,1,0
2019,Officer,49437,2,2,0
2019,Officer,49509,3,3,0
2019,Officer,49739,2,2,0
2019,Officer,49849,1,1,0
2019,Officer,50036,2,2,0
2019,Officer,50126,1,1,0
2019,Officer,50131,22,18,4
2019,Officer,50138,2,1,1
2019,Officer,50220,1,1,0
2019,Officer,50616,2,2,0
2019,Officer,50703,4,4,0
2019,Officer,51031,1,1,0
2019,Officer,51111,2,2,0
2019,Officer,51401,1,1,0
2019,Officer,51503,2,2,0
2019,Officer,51566,1,1,0
2019,Officer,52002,2,2,0
2019,Officer,52246,5,4,1
2019,Officer,52404,2,2,0
2019,Officer,52556,1,0,1
2019,Officer,52641,1,1,0
2019,Officer,52732,2,2,0
2019,Officer,52806,3,2,1
2019,Officer,53027,1,1,0
2019,Officer,53089,1,1,0
2019,Officer,53094,1,1,0
2019,Officer,53095,2,2,0
2019,Officer,53186,2,2,0
2019,Officer,53212,8,8,0
2019,Officer,53403,3,3,0
2019,Officer,53538,2,2,0
2019,Officer,53545,1,1,0
2019,Officer,53581,1,0,1
2019,Officer,53704,16,15,1
2019,Officer,53901,1,1,0
2019,Officer,54022,1,1,0
2019,Officer,54241,1,1,0
2019,Officer,54409,1,1,0
2019,Officer,54455,1,1,0
2019,Officer,54495,2,2,0
2019,Officer,54612,1,1,0
2019,Officer,54618,3,1,2
2019,Officer,54650,2,2,0
2019,Officer,54656,1,1,0
2019,Officer,54660,1,1,0
2019,Officer,54703,1,1,0
2019,Officer,54729,3,3,0
2019,Officer,54751,1,1,0
2019,Officer,54843,2,2,0
2019,Officer,54880,3,3,0
2019,Officer,54914,1,0,1
2019,Officer,54929,1,1,0
2019,Officer,55008,2,2,0
2019,Officer,55016,2,2,0
2019,Officer,55021,12,12,0
2019,Officer,55060,3,3,0
2019,Officer,55066,3,3,0
2019,Officer,55068,7,6,1
2019,Officer,55082,4,4,0
2019,Officer,55101,4,4,0
2019,Officer,55106,3,3,0
2019,Officer,55107,7,7,0
2019,Officer,55111,2,2,0
2019,Officer,55112,7,7,0
2019,Officer,55118,1,1,0
2019,Officer,55303,4,4,0
2019,Officer,55355,1,1,0
2019,Officer,55362,1,1,0
2019,Officer,55431,6,6,0
2019,Officer,55443,1,1,0
2019,Officer,55719,2,2,0
2019,Officer,55744,1,1,0
2019,Officer,55811,6,6,0
2019,Officer,56001,4,4,0
2019,Officer,56007,1,1,0
2019,Officer,56081,1,1,0
2019,Officer,56201,1,1,0
2019,Officer,56256,2,1,1
2019,Officer,56265,1,1,0
2019,Officer,56301,2,2,0
2019,Officer,56303,1,1,0
2019,Officer,56345,14,14,0
2019,Officer,56378,1,1,0
2019,Officer,56401,1,1,0
2019,Officer,56482,2,2,0
2019,Officer,56501,1,1,0
2019,Officer,56560,3,3,0
2019,Officer,56701,2,2,0
2019,Officer,57006,1,1,0
2019,Officer,57042,1,1,0
2019,Officer,57069,1,0,1
2019,Officer,57104,2,2,0
2019,Officer,57201,3,3,0
2019,Officer,57301,2,2,0
2019,Officer,57325,1,1,0
2019,Officer,57366,1,1,0
2019,Officer,57380,1,1,0
2019,Officer,57702,8,8,0
2019,Officer,57717,2,2,0
2019,Officer,58072,1,1,0
2019,Officer,58075,2,2,0
2019,Officer,58102,6,6,0
2019,Officer,58201,1,1,0
2019,Officer,58506,6,6,0
2019,Officer,58801,1,1,0
2019,Officer,59047,1,1,0
2019,Officer,59102,3,3,0
2019,Officer,59218,1,0,1
2019,Officer,59405,4,3,1
2019,Officer,59538,1,1,0
2019,Officer,59602,1,1,0
2019,Officer,59636,6,4,2
2019,Officer,59714,3,3,0
2019,Officer,59901,2,2,0
2019,Officer,60037,2,2,0
2019,Officer,60098,2,2,0
2019,Officer,60120,1,1,0
2019,Officer,60418,2,2,0
2019,Officer,60435,1,1,0
2019,Officer,60505,1,0,1
2019,Officer,60546,7,6,1
2019,Officer,60615,2,2,0
2019,Officer,60651,9,5,4
2019,Officer,60901,5,5,0
2019,Officer,61021,2,2,0
2019,Officer,61032,1,1,0
2019,Officer,61115,2,2,0
2019,Officer,61264,3,3,0
2019,Officer,61299,1,1,0
2019,Officer,61341,3,2,1
2019,Officer,61401,2,2,0
2019,Officer,61434,1,1,0
2019,Officer,61443,2,1,1
2019,Officer,61455,3,3,0
2019,Officer,61607,8,6,2
2019,Officer,61701,7,7,0
2019,Officer,61761,2,1,1
2019,Officer,61802,1,0,1
2019,Officer,61820,1,1,0
2019,Officer,61834,1,1,0
2019,Officer,61938,2,1,1
2019,Officer,62056,1,1,0
2019,Officer,62301,1,1,0
2019,Officer,62439,1,1,0
2019,Officer,62521,1,1,0
2019,Officer,62702,13,12,1
2019,Officer,62864,1,1,0
2019,Officer,62896,2,2,0
2019,Officer,62959,2,2,0
2019,Officer,62966,4,2,2
2019,Officer,63028,3,2,1
2019,Officer,63044,6,6,0
2019,Officer,63125,7,7,0
2019,Officer,63401,1,1,0
2019,Officer,63552,1,1,0
2019,Officer,63703,4,4,0
2019,Officer,63801,2,2,0
2019,Officer,63857,2,2,0
2019,Officer,63901,1,0,1
2019,Officer,64067,1,1,0
2019,Officer,64085,1,1,0
2019,Officer,64129,5,4,1
2019,Officer,64402,1,1,0
2019,Officer,64468,3,3,0
2019,Officer,64506,4,3,1
2019,Officer,64701,1,1,0
2019,Officer,64804,4,2,2
2019,Officer,64836,2,2,0
2019,Officer,65101,5,4,1
2019,Officer,65109,5,5,0
2019,Officer,65202,2,2,0
2019,Officer,65233,1,1,0
2019,Officer,65251,1,1,0
2019,Officer,65301,1,1,0
2019,Officer,65305,3,3,0
2019,Officer,65401,1,1,0
2019,Officer,65473,4,2,2
2019,Officer,65708,1,1,0
2019,Officer,65775,2,2,0
2019,Officer,65802,2,2,0
2019,Officer,65803,3,3,0
2019,Officer,66027,3,3,0
2019,Officer,66061,7,7,0
2019,Officer,66067,1,1,0
2019,Officer,66219,5,4,1
2019,Officer,66434,1,1,0
2019,Officer,66436,1,1,0
2019,Officer,66611,4,2,2
2019,Officer,66619,3,3,0
2019,Officer,66749,1,1,0
2019,Officer,66762,1,1,0
2019,Officer,67219,4,3,1
2019,Officer,67501,2,2,0
2019,Officer,67601,1,1,0
2019,Officer,67801,2,2,0
2019,Officer,68073,2,2,0
2019,Officer,68142,1,0,1
2019,Officer,68310,1,1,0
2019,Officer,68503,1,1,0
2019,Officer,68508,4,4,0
2019,Officer,68524,6,5,1
2019,Officer,68601,3,3,0
2019,Officer,68787,1,1,0
2019,Officer,68801,1,1,0
2019,Officer,68901,1,1,0
2019,Officer,70117,13,11,2
2019,Officer,70364,1,1,0
2019,Officer,70390,1,1,0
2019,Officer,70401,3,1,2
2019,Officer,70403,1,1,0
2019,Officer,70427,1,1,0
2019,Officer,70508,4,4,0
2019,Officer,70544,1,1,0
2019,Officer,70582,4,2,2
2019,Officer,70633,1,1,0
2019,Officer,70721,4,4,0
2019,Officer,70820,1,1,0
2019,Officer,71055,2,2,0
2019,Officer,71101,1,1,0
2019,Officer,71270,3,3,0
2019,Officer,71292,2,2,0
2019,Officer,71303,1,1,0
2019,Officer,71360,4,4,0
2019,Officer,71459,1,1,0
2019,Officer,71671,2,1,1
2019,Officer,71701,1,1,0
2019,Officer,71730,2,2,0
2019,Officer,71801,1,1,0
2019,Officer,71823,1,1,0
2019,Officer,71854,1,1,0
2019,Officer,71923,2,2,0
2019,Officer,72012,2,2,0
2019,Officer,72015,1,1,0
2019,Officer,72034,2,2,0
2019,Officer,72110,1,1,0
2019,Officer,72143,1,1,0
2019,Officer,72150,1,1,0
2019,Officer,72199,19,15,4
2019,Officer,72301,2,2,0
2019,Officer,72335,1,1,0
2019,Officer,72401,6,6,0
2019,Officer,72432,1,1,0
2019,Officer,72450,1,1,0
2019,Officer,72476,2,2,0
2019,Officer,72701,1,1,0
2019,Officer,72712,5,5,0
2019,Officer,72744,2,2,0
2019,Officer,72756,3,3,0
2019,Officer,72761,1,1,0
2019,Officer,72802,2,2,0
2019,Officer,72855,2,2,0
2019,Officer,72923,3,3,0
2019,Officer,72927,1,1,0
2019,Officer,72949,2,1,1
2019,Officer,73034,2,1,1
2019,Officer,73051,1,1,0
2019,Officer,73064,3,3,0
2019,Officer,73069,6,6,0
2019,Officer,73111,10,9,1
2019,Officer,73503,2,2,0
2019,Officer,74014,4,2,2
2019,Officer,74017,1,1,0
2019,Officer,74075,1,1,0
2019,Officer,74116,2,2,0
2019,Officer,74403,1,1,0
2019,Officer,74501,1,1,0
2019,Officer,74701,1,1,0
2019,Officer,74820,1,1,0
2019,Officer,74834,1,0,1
2019,Officer,75051,15,14,1
2019,Officer,75077,3,3,0
2019,Officer,75098,2,2,0
2019,Officer,75110,1,1,0
2019,Officer,75159,3,3,0
2019,Officer,75165,3,3,0
2019,Officer,75220,2,2,0
2019,Officer,75662,1,1,0
2019,Officer,75709,1,1,0
2019,Officer,75901,1,1,0
2019,Officer,76108,1,1,0
2019,Officer,76115,3,3,0
2019,Officer,76207,3,3,0
2019,Officer,76302,1,1,0
2019,Officer,76502,1,1,0
2019,Officer,76542,4,4,0
2019,Officer,76574,2,2,0
2019,Officer,76707,8,8,0
2019,Officer,77034,5,5,0
2019,Officer,77067,3,3,0
2019,Officer,77082,14,14,0
2019,Officer,77340,2,2,0
2019,Officer,77471,2,2,0
2019,Officer,77515,1,1,0
2019,Officer,77568,1,1,0
2019,Officer,77802,3,3,0
2019,Officer,77904,1,1,0
2019,Officer,78130,1,1,0
2019,Officer,78155,1,1,0
2019,Officer,78218,2,2,0
2019,Officer,78219,4,4,0
2019,Officer,78257,8,8,0
2019,Officer,78416,8,8,0
2019,Officer,78520,2,2,0
2019,Officer,78596,4,4,0
2019,Officer,78602,5,5,0
2019,Officer,78617,7,7,0
2019,Officer,78624,1,1,0
2019,Officer,78665,6,6,0
2019,Officer,78666,8,8,0
2019,Officer,78703,13,11,2
2019,Officer,78731,8,8,0
2019,Officer,78746,2,2,0
2019,Officer,79403,3,3,0
2019,Officer,79607,7,7,0
2019,Officer,79706,1,1,0
2019,Officer,79936,6,6,0
2019,Officer,80011,16,10,6
2019,Officer,80012,5,3,2
2019,Officer,80112,5,4,1
2019,Officer,80137,5,5,0
2019,Officer,80216,8,4,4
2019,Officer,80501,1,1,0
2019,Officer,80504,1,1,0
2019,Officer,80521,1,1,0
2019,Officer,80550,1,0,1
2019,Officer,80751,1,1,0
2019,Officer,80907,4,3,1
2019,Officer,80913,3,2,1
2019,Officer,80916,2,2,0
2019,Officer,80920,6,4,2
2019,Officer,81004,1,0,1
2019,Officer,81401,2,2,0
2019,Officer,82005,1,1,0
2019,Officer,82009,5,3,2
2019,Officer,82072,1,1,0
2019,Officer,82240,1,1,0
2019,Officer,82604,4,2,2
2019,Officer,82801,1,1,0
2019,Officer,82901,1,1,0
2019,Officer,83110,2,2,0
2019,Officer,83263,1,1,0
2019,Officer,83301,1,1,0
2019,Officer,83318,2,2,0
2019,Officer,83330,1,0,1
2019,Officer,83338,1,1,0
2019,Officer,83402,1,1,0
2019,Officer,83445,1,1,0
2019,Officer,83501,1,1,0
2019,Officer,83544,1,1,0
2019,Officer,83605,1,1,0
2019,Officer,83617,1,1,0
2019,Officer,83647,3,2,1
2019,Officer,83705,16,10,6
2019,Officer,83854,1,0,1
2019,Officer,84003,1,1,0
2019,Officer,84020,10,10,0
2019,Officer,84043,2,2,0
2019,Officer,84058,2,1,1
2019,Officer,84065,14,13,1
2019,Officer,84074,2,1,1
2019,Officer,84084,5,5,0
2019,Officer,84116,2,2,0
2019,Officer,84321,1,1,0
2019,Officer,84404,1,1,0
2019,Officer,84405,2,1,1
2019,Officer,84511,1,1,0
2019,Officer,84642,2,2,0
2019,Officer,84660,1,1,0
2019,Officer,84713,1,1,0
2019,Officer,84790,2,2,0
2019,Officer,85008,29,25,4
2019,Officer,85020,1,0,1
2019,Officer,85132,4,4,0
2019,Officer,85281,2,1,1
2019,Officer,85301,1,1,0
2019,Officer,85312,2,2,0
2019,Officer,85706,1,1,0
2019,Officer,86015,3,3,0
2019,Officer,86301,1,1,0
2019,Officer,87002,1,1,0
2019,Officer,87123,2,2,0
2019,Officer,87144,14,13,1
2019,Officer,87508,3,3,0
2019,Officer,87557,1,1,0
2019,Officer,88007,12,12,0
2019,Officer,89139,6,6,0
2019,Officer,89165,11,10,1
2019,Officer,89406,2,2,0
2019,Officer,89506,7,7,0
2019,Officer,89509,1,1,0
2019,Officer,89701,2,1,1
2019,Officer,90025,1,1,0
2019,Officer,90201,5,5,0
2019,Officer,90302,3,3,0
2019,Officer,90501,1,1,0
2019,Officer,90720,15,15,0
2019,Officer,90731,1,1,0
2019,Officer,90822,2,2,0
2019,Officer,91205,1,1,0
2019,Officer,91406,1,1,0
2019,Officer,91505,3,3,0
2019,Officer,91702,4,4,0
2019,Officer,91764,2,2,0
2019,Officer,91766,1,1,0
2019,Officer,91950,1,1,0
2019,Officer,92111,5,5,0
2019,Officer,92243,1,1,0
2019,Officer,92311,1,1,0
2019,Officer,92410,4,4,0
2019,Officer,92501,1,1,0
2019,Officer,92833,1,1,0
2019,Officer,93291,1,1,0
2019,Officer,93307,1,1,0
2019,Officer,93405,1,1,0
2019,Officer,93451,1,1,0
2019,Officer,93536,1,1,0
2019,Officer,93727,6,6,0
2019,Officer,93955,1,1,0
2019,Officer,94510,1,1,0
2019,Officer,94533,1,1,0
2019,Officer,94568,1,1,0
2019,Officer,94596,1,0,1
2019,Officer,94804,3,3,0
2019,Officer,94903,1,1,0
2019,Officer,95206,6,6,0
2019,Officer,95341,1,1,0
2019,Officer,95351,6,6,0
2019,Officer,95361,2,2,0
2019,Officer,95380,1,1,0
2019,Officer,95401,1,1,0
2019,Officer,95678,3,3,0
2019,Officer,95826,7,7,0
2019,Officer,95828,9,9,0
2019,Officer,95832,1,1,0
2019,Officer,96707,7,7,0
2019,Officer,96720,6,5,1
2019,Officer,96732,1,1,0
2019,Officer,96750,1,1,0
2019,Officer,96753,1,1,0
2019,Officer,96782,3,3,0
2019,Officer,96786,3,2,1
2019,Officer,96789,1,1,0
2019,Officer,96816,1,1,0
2019,Officer,96857,1,1,0
2019,Officer,96913,10,10,0
2019,Officer,97015,6,5,1
2019,Officer,97030,1,1,0
2019,Officer,97051,1,1,0
2019,Officer,97058,1,1,0
2019,Officer,97071,1,1,0
2019,Officer,97116,1,1,0
2019,Officer,97211,3,3,0
2019,Officer,97218,4,3,1
2019,Officer,97301,8,5,3
2019,Officer,97309,2,1,1
2019,Officer,97321,1,1,0
2019,Officer,97338,1,1,0
2019,Officer,97470,1,1,0
2019,Officer,97477,3,3,0
2019,Officer,97520,2,2,0
2019,Officer,97526,3,2,1
2019,Officer,97603,1,1,0
2019,Officer,97702,3,3,0
2019,Officer,97814,1,1,0
2019,Officer,97838,2,2,0
2019,Officer,97850,1,1,0
2019,Officer,98032,6,6,0
2019,Officer,98052,2,2,0
2019,Officer,98108,2,2,0
2019,Officer,98119,7,7,0
2019,Officer,98271,4,4,0
2019,Officer,98312,2,2,0
2019,Officer,98372,2,2,0
2019,Officer,98430,9,9,0
2019,Officer,98433,12,12,0
2019,Officer,98501,1,1,0
2019,Officer,98531,1,1,0
2019,Officer,98682,2,2,0
2019,Officer,98823,1,1,0
2019,Officer,98901,2,2,0
2019,Officer,98930,1,1,0
2019,Officer,99011,2,2,0
2019,Officer,99217,1,1,0
2019,Officer,99505,21,19,2
2019,Officer,99654,3,3,0
2019,Officer,99682,1,1,0
2019,Officer,99731,3,3,0
2019,Warrant Officer,00735,1,1,0
2019,Warrant Officer,00795,2,2,0
2019,Warrant Officer,00802,1,1,0
2019,Warrant Officer,00901,4,4,0
2019,Warrant Officer,00907,1,1,0
2019,Warrant Officer,01085,3,3,0
2019,Warrant Officer,01731,2,2,0
2019,Warrant Officer,01760,3,3,0
2019,Warrant Officer,02301,2,2,0
2019,Warrant Officer,02542,4,4,0
2019,Warrant Officer,02886,1,1,0
2019,Warrant Officer,02920,1,1,0
2019,Warrant Officer,03301,8,8,0
2019,Warrant Officer,04240,1,1,0
2019,Warrant Officer,04401,3,3,0
2019,Warrant Officer,04736,1,1,0
2019,Warrant Officer,04901,1,1,0
2019,Warrant Officer,05403,1,1,0
2019,Warrant Officer,06096,2,2,0
2019,Warrant Officer,06105,1,1,0
2019,Warrant Officer,06457,1,1,0
2019,Warrant Officer,06614,1,1,0
2019,Warrant Officer,07052,1,1,0
2019,Warrant Officer,07801,1,1,0
2019,Warrant Officer,07960,1,1,0
2019,Warrant Officer,08360,1,1,0
2019,Warrant Officer,08401,1,1,0
2019,Warrant Officer,08640,1,1,0
2019,Warrant Officer,08648,1,1,0
2019,Warrant Officer,08733,5,5,0
2019,Warrant Officer,08750,1,1,0
2019,Warrant Officer,08873,1,1,0
2019,Warrant Officer,10037,1,1,0
2019,Warrant Officer,10314,2,2,0
2019,Warrant Officer,10567,3,3,0
2019,Warrant Officer,11779,2,2,0
2019,Warrant Officer,12110,4,4,0
2019,Warrant Officer,12180,1,1,0
2019,Warrant Officer,12302,1,1,0
2019,Warrant Officer,13021,1,1,0
2019,Warrant Officer,13211,4,4,0
2019,Warrant Officer,14048,1,1,0
2019,Warrant Officer,14624,1,1,0
2019,Warrant Officer,15216,1,1,0
2019,Warrant Officer,15301,2,2,0
2019,Warrant Officer,15902,5,5,0
2019,Warrant Officer,16226,1,1,0
2019,Warrant Officer,17003,8,8,0
2019,Warrant Officer,17022,1,1,0
2019,Warrant Officer,17103,2,2,0
2019,Warrant Officer,18102,1,1,0
2019,Warrant Officer,18509,2,2,0
2019,Warrant Officer,19044,1,1,0
2019,Warrant Officer,19720,4,4,0
2019,Warrant Officer,19939,1,1,0
2019,Warrant Officer,20003,3,3,0
2019,Warrant Officer,20112,1,1,0
2019,Warrant Officer,20708,1,1,0
2019,Warrant Officer,21010,6,6,0
2019,Warrant Officer,21401,2,2,0
2019,Warrant Officer,22032,1,1,0
2019,Warrant Officer,22060,4,4,0
2019,Warrant Officer,23150,5,4,1
2019,Warrant Officer,23237,2,2,0
2019,Warrant Officer,23805,2,2,0
2019,Warrant Officer,24151,1,1,0
2019,Warrant Officer,25177,2,2,0
2019,Warrant Officer,25311,1,1,0
2019,Warrant Officer,26003,1,1,0
2019,Warrant Officer,26187,1,1,0
2019,Warrant Officer,26330,7,7,0
2019,Warrant Officer,27320,1,1,0
2019,Warrant Officer,27504,1,1,0
2019,Warrant Officer,27560,9,9,0
2019,Warrant Officer,28001,1,1,0
2019,Warrant Officer,28147,6,6,0
2019,Warrant Officer,28208,1,1,0
2019,Warrant Officer,28328,1,1,0
2019,Warrant Officer,29044,16,16,0
2019,Warrant Officer,29115,2,2,0
2019,Warrant Officer,29303,3,3,0
2019,Warrant Officer,29403,2,2,0
2019,Warrant Officer,29605,1,1,0
2019,Warrant Officer,29625,1,1,0
2019,Warrant Officer,29706,2,2,0
2019,Warrant Officer,29906,1,1,0
2019,Warrant Officer,30032,1,1,0
2019,Warrant Officer,30060,11,11,0
2019,Warrant Officer,30069,3,3,0
2019,Warrant Officer,30240,1,1,0
2019,Warrant Officer,30294,2,2,0
2019,Warrant Officer,30297,6,6,0
2019,Warrant Officer,30336,1,1,0
2019,Warrant Officer,30439,1,1,0
2019,Warrant Officer,30680,3,3,0
2019,Warrant Officer,31040,2,2,0
2019,Warrant Officer,31211,1,1,0
2019,Warrant Officer,31313,1,1,0
2019,Warrant Officer,31314,1,1,0
2019,Warrant Officer,31406,1,1,0
2019,Warrant Officer,31409,2,2,0
2019,Warrant Officer,31905,3,3,0
2019,Warrant Officer,32086,3,3,0
2019,Warrant Officer,32091,1,1,0
2019,Warrant Officer,32164,1,1,0
2019,Warrant Officer,32221,5,5,0
2019,Warrant Officer,33027,1,1,0
2019,Warrant Officer,33406,1,1,0
2019,Warrant Officer,33606,1,1,0
2019,Warrant Officer,33782,5,5,0
2019,Warrant Officer,33811,1,1,0
2019,Warrant Officer,34604,2,2,0
2019,Warrant Officer,35209,2,2,0
2019,Warrant Officer,35217,2,2,0
2019,Warrant Officer,35601,1,1,0
2019,Warrant Officer,35904,2,2,0
2019,Warrant Officer,36043,1,1,0
2019,Warrant Officer,36109,2,2,0
2019,Warrant Officer,36203,1,1,0
2019,Warrant Officer,36362,1,1,0
2019,Warrant Officer,36605,2,2,0
2019,Warrant Officer,36608,2,2,0
2019,Warrant Officer,37033,1,1,0
2019,Warrant Officer,37167,1,1,0
2019,Warrant Officer,37217,4,4,0
2019,Warrant Officer,37398,1,1,0
2019,Warrant Officer,37404,2,2,0
2019,Warrant Officer,37615,1,1,0
2019,Warrant Officer,37644,1,1,0
2019,Warrant Officer,37777,1,1,0
2019,Warrant Officer,37825,1,1,0
2019,Warrant Officer,38301,6,6,0
2019,Warrant Officer,38302,1,1,0
2019,Warrant Officer,38801,4,4,0
2019,Warrant Officer,38803,1,1,0
2019,Warrant Officer,38901,1,1,0
2019,Warrant Officer,39183,1,1,0
2019,Warrant Officer,39202,2,2,0
2019,Warrant Officer,39204,2,2,0
2019,Warrant Officer,39209,3,3,0
2019,Warrant Officer,39307,3,3,0
2019,Warrant Officer,39350,1,1,0
2019,Warrant Officer,39440,1,1,0
2019,Warrant Officer,39759,1,1,0
2019,Warrant Officer,40205,1,1,0
2019,Warrant Officer,40475,1,1,0
2019,Warrant Officer,40601,13,13,0
2019,Warrant Officer,42301,1,1,0
2019,Warrant Officer,43015,1,1,0
2019,Warrant Officer,43213,7,7,0
2019,Warrant Officer,43217,10,10,0
2019,Warrant Officer,43235,4,4,0
2019,Warrant Officer,43756,1,1,0
2019,Warrant Officer,44142,1,1,0
2019,Warrant Officer,44256,1,1,0
2019,Warrant Officer,44720,2,2,0
2019,Warrant Officer,45215,1,1,0
2019,Warrant Officer,45502,3,3,0
2019,Warrant Officer,46124,1,1,0
2019,Warrant Officer,46131,1,1,0
2019,Warrant Officer,46176,7,7,0
2019,Warrant Officer,46216,1,1,0
2019,Warrant Officer,46241,2,2,0
2019,Warrant Officer,46406,2,2,0
2019,Warrant Officer,46901,1,1,0
2019,Warrant Officer,47170,1,1,0
2019,Warrant Officer,47303,2,2,0
2019,Warrant Officer,47715,1,1,0
2019,Warrant Officer,48045,1,1,0
2019,Warrant Officer,48197,1,1,0
2019,Warrant Officer,48837,4,4,0
2019,Warrant Officer,48906,3,3,0
2019,Warrant Officer,49009,1,1,0
2019,Warrant Officer,49201,1,1,0
2019,Warrant Officer,49306,1,1,0
2019,Warrant Officer,49739,1,1,0
2019,Warrant Officer,49783,1,1,0
2019,Warrant Officer,50036,6,6,0
2019,Warrant Officer,50131,3,3,0
2019,Warrant Officer,50138,2,2,0
2019,Warrant Officer,50220,1,1,0
2019,Warrant Officer,50321,1,1,0
2019,Warrant Officer,50703,2,2,0
2019,Warrant Officer,52404,1,1,0
2019,Warrant Officer,52638,1,1,0
2019,Warrant Officer,52806,3,3,0
2019,Warrant Officer,53121,1,1,0
2019,Warrant Officer,53212,1,1,0
2019,Warrant Officer,53704,5,5,0
2019,Warrant Officer,53901,1,1,0
2019,Warrant Officer,54618,1,1,0
2019,Warrant Officer,54902,1,1,0
2019,Warrant Officer,55068,1,1,0
2019,Warrant Officer,55101,2,2,0
2019,Warrant Officer,55107,4,4,0
2019,Warrant Officer,55112,1,1,0
2019,Warrant Officer,55413,1,1,0
2019,Warrant Officer,56301,6,6,0
2019,Warrant Officer,56303,1,1,0
2019,Warrant Officer,56345,8,8,0
2019,Warrant Officer,57104,2,2,0
2019,Warrant Officer,57702,3,3,0
2019,Warrant Officer,57703,2,2,0
2019,Warrant Officer,58102,2,2,0
2019,Warrant Officer,58301,1,1,0
2019,Warrant Officer,58506,2,2,0
2019,Warrant Officer,59102,1,1,0
2019,Warrant Officer,59602,7,7,0
2019,Warrant Officer,60546,1,1,0
2019,Warrant Officer,60616,1,1,0
2019,Warrant Officer,60901,3,3,0
2019,Warrant Officer,61115,1,1,0
2019,Warrant Officer,61264,1,1,0
2019,Warrant Officer,61607,2,2,0
2019,Warrant Officer,61701,2,2,0
2019,Warrant Officer,61802,1,1,0
2019,Warrant Officer,62269,1,1,0
2019,Warrant Officer,62521,4,4,0
2019,Warrant Officer,62702,3,3,0
2019,Warrant Officer,63044,1,1,0
2019,Warrant Officer,63703,1,1,0
2019,Warrant Officer,64735,1,1,0
2019,Warrant Officer,64759,1,1,0
2019,Warrant Officer,65101,1,1,0
2019,Warrant Officer,65109,1,1,0
2019,Warrant Officer,65202,1,1,0
2019,Warrant Officer,65301,1,1,0
2019,Warrant Officer,65305,3,3,0
2019,Warrant Officer,65473,6,6,0
2019,Warrant Officer,65803,3,3,0
2019,Warrant Officer,66027,2,2,0
2019,Warrant Officer,66061,1,1,0
2019,Warrant Officer,66502,1,1,0
2019,Warrant Officer,66611,1,1,0
2019,Warrant Officer,66619,5,5,0
2019,Warrant Officer,66749,1,1,0
2019,Warrant Officer,67010,1,1,0
2019,Warrant Officer,67219,1,1,0
2019,Warrant Officer,67401,2,2,0
2019,Warrant Officer,67530,1,1,0
2019,Warrant Officer,68508,1,1,0
2019,Warrant Officer,68524,8,8,0
2019,Warrant Officer,68801,1,1,0
2019,Warrant Officer,70401,4,4,0
2019,Warrant Officer,70427,1,1,0
2019,Warrant Officer,70508,2,2,0
2019,Warrant Officer,70721,2,2,0
2019,Warrant Officer,71055,1,1,0
2019,Warrant Officer,71270,1,1,0
2019,Warrant Officer,72199,13,12,1
2019,Warrant Officer,72401,1,1,0
2019,Warrant Officer,72543,1,1,0
2019,Warrant Officer,72744,1,1,0
2019,Warrant Officer,73051,2,2,0
2019,Warrant Officer,73064,1,1,0
2019,Warrant Officer,73069,1,1,0
2019,Warrant Officer,74116,1,1,0
2019,Warrant Officer,75051,2,2,0
2019,Warrant Officer,76108,1,1,0
2019,Warrant Officer,76542,1,1,0
2019,Warrant Officer,77034,2,2,0
2019,Warrant Officer,77067,1,1,0
2019,Warrant Officer,77340,1,1,0
2019,Warrant Officer,78218,3,3,0
2019,Warrant Officer,78219,5,5,0
2019,Warrant Officer,78257,2,2,0
2019,Warrant Officer,78416,1,1,0
2019,Warrant Officer,78617,8,8,0
2019,Warrant Officer,78666,1,1,0
2019,Warrant Officer,78703,4,4,0
2019,Warrant Officer,78731,2,2,0
2019,Warrant Officer,79936,2,2,0
2019,Warrant Officer,80011,8,8,0
2019,Warrant Officer,80216,2,2,0
2019,Warrant Officer,80504,1,1,0
2019,Warrant Officer,80913,3,3,0
2019,Warrant Officer,80916,1,1,0
2019,Warrant Officer,81401,1,1,0
2019,Warrant Officer,82005,4,4,0
2019,Warrant Officer,82201,1,1,0
2019,Warrant Officer,83202,1,1,0
2019,Warrant Officer,83501,1,1,0
2019,Warrant Officer,83705,15,15,0
2019,Warrant Officer,84020,2,2,0
2019,Warrant Officer,84043,1,1,0
2019,Warrant Officer,84058,2,2,0
2019,Warrant Officer,84065,4,4,0
2019,Warrant Officer,84084,12,12,0
2019,Warrant Officer,84321,1,1,0
2019,Warrant Officer,85008,18,18,0
2019,Warrant Officer,85145,5,5,0
2019,Warrant Officer,85260,2,2,0
2019,Warrant Officer,85286,1,1,0
2019,Warrant Officer,86015,1,1,0
2019,Warrant Officer,87144,2,2,0
2019,Warrant Officer,87401,1,1,0
2019,Warrant Officer,87508,3,3,0
2019,Warrant Officer,88007,2,2,0
2019,Warrant Officer,88203,1,1,0
2019,Warrant Officer,89032,1,1,0
2019,Warrant Officer,89506,2,2,0
2019,Warrant Officer,89701,2,2,0
2019,Warrant Officer,90720,10,10,0
2019,Warrant Officer,91205,2,2,0
2019,Warrant Officer,92111,1,1,0
2019,Warrant Officer,93405,1,1,0
2019,Warrant Officer,93451,1,1,0
2019,Warrant Officer,93727,2,2,0
2019,Warrant Officer,95206,4,4,0
2019,Warrant Officer,95655,1,1,0
2019,Warrant Officer,95665,1,1,0
2019,Warrant Officer,95826,1,1,0
2019,Warrant Officer,95832,1,1,0
2019,Warrant Officer,96001,1,1,0
2019,Warrant Officer,96707,4,4,0
2019,Warrant Officer,96720,2,2,0
2019,Warrant Officer,96786,1,1,0
2019,Warrant Officer,96857,3,3,0
2019,Warrant Officer,97116,1,1,0
2019,Warrant Officer,97218,1,1,0
2019,Warrant Officer,97302,1,1,0
2019,Warrant Officer,97309,2,2,0
2019,Warrant Officer,97477,1,1,0
2019,Warrant Officer,97501,1,1,0
2019,Warrant Officer,97801,1,1,0
2019,Warrant Officer,98032,1,1,0
2019,Warrant Officer,98108,2,2,0
2019,Warrant Officer,98119,1,1,0
2019,Warrant Officer,98321,1,1,0
2019,Warrant Officer,98433,10,10,0
2019,Warrant Officer,99011,4,4,0
2019,Warrant Officer,99505,8,8,0
2019,Warrant Officer,99731,1,1,0
2020,Enlisted,     ,113,20,93
2020,Enlisted,00000,58,14,44
2020,Enlisted,00604,29,3,26
2020,Enlisted,00612,18,3,15
2020,Enlisted,00623,14,3,11
2020,Enlisted,00624,14,3,11
2020,Enlisted,00641,8,1,7
2020,Enlisted,00682,42,3,39
2020,Enlisted,00683,3,0,3
2020,Enlisted,00693,29,3,26
2020,Enlisted,00705,22,2,20
2020,Enlisted,00714,14,1,13
2020,Enlisted,00725,15,2,13
2020,Enlisted,00733,3,0,3
2020,Enlisted,00735,14,3,11
2020,Enlisted,00736,52,3,49
2020,Enlisted,00751,17,4,13
2020,Enlisted,00769,24,1,23
2020,Enlisted,00785,14,3,11
2020,Enlisted,00792,34,2,32
2020,Enlisted,00795,133,7,126
2020,Enlisted,00802,21,1,20
2020,Enlisted,00850,11,1,10
2020,Enlisted,00901,9,2,7
2020,Enlisted,00902,2,1,1
2020,Enlisted,00907,5,1,4
2020,Enlisted,00934,115,10,105
2020,Enlisted,00951,10,1,9
2020,Enlisted,01013,16,4,12
2020,Enlisted,01022,2,2,0
2020,Enlisted,01030,20,5,15
2020,Enlisted,01062,7,0,7
2020,Enlisted,01082,28,5,23
2020,Enlisted,01085,14,6,8
2020,Enlisted,01109,24,5,19
2020,Enlisted,01201,7,0,7
2020,Enlisted,01434,40,7,33
2020,Enlisted,01440,10,4,6
2020,Enlisted,01453,7,0,7
2020,Enlisted,01588,5,2,3
2020,Enlisted,01605,61,10,51
2020,Enlisted,01702,19,2,17
2020,Enlisted,01731,4,0,4
2020,Enlisted,01760,21,3,18
2020,Enlisted,01844,19,6,13
2020,Enlisted,01867,68,4,64
2020,Enlisted,01923,9,4,5
2020,Enlisted,01950,12,0,12
2020,Enlisted,02043,24,8,16
2020,Enlisted,02122,17,3,14
2020,Enlisted,02138,24,6,18
2020,Enlisted,02169,14,2,12
2020,Enlisted,02176,26,10,16
2020,Enlisted,02184,15,5,10
2020,Enlisted,02301,14,3,11
2020,Enlisted,02324,9,1,8
2020,Enlisted,02346,11,3,8
2020,Enlisted,02420,6,2,4
2020,Enlisted,02532,21,2,19
2020,Enlisted,02542,93,18,75
2020,Enlisted,02724,9,2,7
2020,Enlisted,02769,14,2,12
2020,Enlisted,02780,50,5,45
2020,Enlisted,02809,10,2,8
2020,Enlisted,02816,1,1,0
2020,Enlisted,02818,134,26,108
2020,Enlisted,02842,10,8,2
2020,Enlisted,02852,18,1,17
2020,Enlisted,02885,29,2,27
2020,Enlisted,02886,13,2,11
2020,Enlisted,02904,29,2,27
2020,Enlisted,02906,1,0,1
2020,Enlisted,02920,6,5,1
2020,Enlisted,03055,31,5,26
2020,Enlisted,03060,8,0,8
2020,Enlisted,03101,28,11,17
2020,Enlisted,03244,22,5,17
2020,Enlisted,03264,9,4,5
2020,Enlisted,03275,4,2,2
2020,Enlisted,03301,35,10,25
2020,Enlisted,03561,5,3,2
2020,Enlisted,03766,11,0,11
2020,Enlisted,03801,1,0,1
2020,Enlisted,03867,34,4,30
2020,Enlisted,03878,6,1,5
2020,Enlisted,03884,2,0,2
2020,Enlisted,04011,20,6,14
2020,Enlisted,04073,10,1,9
2020,Enlisted,04092,3,0,3
2020,Enlisted,04240,13,2,11
2020,Enlisted,04268,15,2,13
2020,Enlisted,04330,24,10,14
2020,Enlisted,04401,35,3,32
2020,Enlisted,04412,19,4,15
2020,Enlisted,04619,4,0,4
2020,Enlisted,04730,9,4,5
2020,Enlisted,04736,4,4,0
2020,Enlisted,04901,25,1,24
2020,Enlisted,04976,7,0,7
2020,Enlisted,05001,4,3,1
2020,Enlisted,05033,11,1,10
2020,Enlisted,05158,2,1,1
2020,Enlisted,05201,4,2,2
2020,Enlisted,05403,7,2,5
2020,Enlisted,05404,11,1,10
2020,Enlisted,05446,53,45,8
2020,Enlisted,05450,5,1,4
2020,Enlisted,05465,18,10,8
2020,Enlisted,05478,7,2,5
2020,Enlisted,05491,8,1,7
2020,Enlisted,05495,16,1,15
2020,Enlisted,05633,10,1,9
2020,Enlisted,05661,2,1,1
2020,Enlisted,05663,16,4,12
2020,Enlisted,05676,1,0,1
2020,Enlisted,05701,5,0,5
2020,Enlisted,05851,3,1,2
2020,Enlisted,05855,6,1,5
2020,Enlisted,06051,29,9,20
2020,Enlisted,06066,1,0,1
2020,Enlisted,06082,24,2,22
2020,Enlisted,06096,87,12,75
2020,Enlisted,06105,6,6,0
2020,Enlisted,06110,46,7,39
2020,Enlisted,06320,39,3,36
2020,Enlisted,06333,1,1,0
2020,Enlisted,06340,19,4,15
2020,Enlisted,06357,12,4,8
2020,Enlisted,06360,31,7,24
2020,Enlisted,06457,84,23,61
2020,Enlisted,06489,15,2,13
2020,Enlisted,06497,28,8,20
2020,Enlisted,06498,11,3,8
2020,Enlisted,06512,49,11,38
2020,Enlisted,06576,13,2,11
2020,Enlisted,06702,11,3,8
2020,Enlisted,06810,36,12,24
2020,Enlisted,07052,36,5,31
2020,Enlisted,07090,37,6,31
2020,Enlisted,07095,30,14,16
2020,Enlisted,07107,12,3,9
2020,Enlisted,07306,37,12,25
2020,Enlisted,07457,24,3,21
2020,Enlisted,07666,79,14,65
2020,Enlisted,07728,38,11,27
2020,Enlisted,07806,44,8,36
2020,Enlisted,07840,6,4,2
2020,Enlisted,07865,18,3,15
2020,Enlisted,07871,14,3,11
2020,Enlisted,07960,38,9,29
2020,Enlisted,08002,16,1,15
2020,Enlisted,08012,13,3,10
2020,Enlisted,08037,45,4,41
2020,Enlisted,08060,9,3,6
2020,Enlisted,08096,27,2,25
2020,Enlisted,08098,8,0,8
2020,Enlisted,08210,15,2,13
2020,Enlisted,08360,19,3,16
2020,Enlisted,08401,6,1,5
2020,Enlisted,08640,7,3,4
2020,Enlisted,08648,12,5,7
2020,Enlisted,08733,49,12,37
2020,Enlisted,08750,22,6,16
2020,Enlisted,08755,19,4,15
2020,Enlisted,08759,13,4,9
2020,Enlisted,08822,7,0,7
2020,Enlisted,08873,71,5,66
2020,Enlisted,10010,103,36,67
2020,Enlisted,10021,1,0,1
2020,Enlisted,10037,87,12,75
2020,Enlisted,10314,33,3,30
2020,Enlisted,10468,24,5,19
2020,Enlisted,10566,68,7,61
2020,Enlisted,10567,84,17,67
2020,Enlisted,10701,38,4,34
2020,Enlisted,10962,37,4,33
2020,Enlisted,11209,35,1,34
2020,Enlisted,11252,72,11,61
2020,Enlisted,11357,16,3,13
2020,Enlisted,11433,92,15,77
2020,Enlisted,11735,65,7,58
2020,Enlisted,11746,13,3,10
2020,Enlisted,11779,29,5,24
2020,Enlisted,12078,17,4,13
2020,Enlisted,12110,90,18,72
2020,Enlisted,12180,3,1,2
2020,Enlisted,12189,8,3,5
2020,Enlisted,12301,15,4,11
2020,Enlisted,12302,20,4,16
2020,Enlisted,12401,8,0,8
2020,Enlisted,12451,7,1,6
2020,Enlisted,12553,69,7,62
2020,Enlisted,12804,40,4,36
2020,Enlisted,12962,19,4,15
2020,Enlisted,13021,21,7,14
2020,Enlisted,13211,59,12,47
2020,Enlisted,13501,38,3,35
2020,Enlisted,13502,7,4,3
2020,Enlisted,13602,12,5,7
2020,Enlisted,13643,3,1,2
2020,Enlisted,13669,4,3,1
2020,Enlisted,13856,10,0,10
2020,Enlisted,13905,20,2,18
2020,Enlisted,14048,1,0,1
2020,Enlisted,14094,20,7,13
2020,Enlisted,14204,90,9,81
2020,Enlisted,14213,52,6,46
2020,Enlisted,14304,10,2,8
2020,Enlisted,14454,16,6,10
2020,Enlisted,14456,20,3,17
2020,Enlisted,14624,84,17,67
2020,Enlisted,14701,12,2,10
2020,Enlisted,14760,2,0,2
2020,Enlisted,14843,12,0,12
2020,Enlisted,14845,22,4,18
2020,Enlisted,14850,14,1,13
2020,Enlisted,15010,22,4,18
2020,Enlisted,15216,31,4,27
2020,Enlisted,15301,22,7,15
2020,Enlisted,15370,16,5,11
2020,Enlisted,15425,15,4,11
2020,Enlisted,15444,19,3,16
2020,Enlisted,15537,6,1,5
2020,Enlisted,15541,6,0,6
2020,Enlisted,15601,24,6,18
2020,Enlisted,15666,27,5,22
2020,Enlisted,15701,30,4,26
2020,Enlisted,15767,16,1,15
2020,Enlisted,15779,11,0,11
2020,Enlisted,15902,11,2,9
2020,Enlisted,15904,61,5,56
2020,Enlisted,16001,33,11,22
2020,Enlisted,16101,23,3,20
2020,Enlisted,16127,12,1,11
2020,Enlisted,16148,6,3,3
2020,Enlisted,16226,13,1,12
2020,Enlisted,16403,55,10,45
2020,Enlisted,16635,10,3,7
2020,Enlisted,16652,6,0,6
2020,Enlisted,16738,2,0,2
2020,Enlisted,16803,22,6,16
2020,Enlisted,16830,14,3,11
2020,Enlisted,16901,7,0,7
2020,Enlisted,17003,250,49,201
2020,Enlisted,17013,21,0,21
2020,Enlisted,17022,36,6,30
2020,Enlisted,17033,12,2,10
2020,Enlisted,17042,20,0,20
2020,Enlisted,17044,23,6,17
2020,Enlisted,17098,3,0,3
2020,Enlisted,17103,70,8,62
2020,Enlisted,17201,21,3,18
2020,Enlisted,17222,12,1,11
2020,Enlisted,17325,11,1,10
2020,Enlisted,17331,12,3,9
2020,Enlisted,17701,20,3,17
2020,Enlisted,17745,12,2,10
2020,Enlisted,17821,15,5,10
2020,Enlisted,17837,8,1,7
2020,Enlisted,18040,18,3,15
2020,Enlisted,18102,21,5,16
2020,Enlisted,18201,14,2,12
2020,Enlisted,18235,8,2,6
2020,Enlisted,18252,1,0,1
2020,Enlisted,18407,10,3,7
2020,Enlisted,18431,12,4,8
2020,Enlisted,18466,14,2,12
2020,Enlisted,18509,41,8,33
2020,Enlisted,18634,6,0,6
2020,Enlisted,18651,2,1,1
2020,Enlisted,18704,27,2,25
2020,Enlisted,18834,3,0,3
2020,Enlisted,19044,58,8,50
2020,Enlisted,19103,8,3,5
2020,Enlisted,19104,16,1,15
2020,Enlisted,19153,51,7,44
2020,Enlisted,19154,149,25,124
2020,Enlisted,19320,24,4,20
2020,Enlisted,19460,12,3,9
2020,Enlisted,19462,37,6,31
2020,Enlisted,19475,25,2,23
2020,Enlisted,19526,10,3,7
2020,Enlisted,19530,39,7,32
2020,Enlisted,19605,34,4,30
2020,Enlisted,19706,50,5,45
2020,Enlisted,19711,39,4,35
2020,Enlisted,19720,34,10,24
2020,Enlisted,19804,7,0,7
2020,Enlisted,19808,5,2,3
2020,Enlisted,19939,46,2,44
2020,Enlisted,19947,6,0,6
2020,Enlisted,19973,41,4,37
2020,Enlisted,19977,7,4,3
2020,Enlisted,20003,38,13,25
2020,Enlisted,20112,56,14,42
2020,Enlisted,20175,17,9,8
2020,Enlisted,20186,9,5,4
2020,Enlisted,20373,34,9,25
2020,Enlisted,20623,8,2,6
2020,Enlisted,20646,13,3,10
2020,Enlisted,20653,2,1,1
2020,Enlisted,20708,41,19,22
2020,Enlisted,20783,6,3,3
2020,Enlisted,20882,22,4,18
2020,Enlisted,20904,14,4,10
2020,Enlisted,21010,68,15,53
2020,Enlisted,21043,19,3,16
2020,Enlisted,21057,16,12,4
2020,Enlisted,21061,15,9,6
2020,Enlisted,21078,8,2,6
2020,Enlisted,21136,49,5,44
2020,Enlisted,21157,16,5,11
2020,Enlisted,21201,3,2,1
2020,Enlisted,21204,16,8,8
2020,Enlisted,21216,19,1,18
2020,Enlisted,21222,49,9,40
2020,Enlisted,21228,33,1,32
2020,Enlisted,21236,10,0,10
2020,Enlisted,21401,21,9,12
2020,Enlisted,21502,2,1,1
2020,Enlisted,21601,6,3,3
2020,Enlisted,21657,2,1,1
2020,Enlisted,21701,13,5,8
2020,Enlisted,21740,6,0,6
2020,Enlisted,21801,8,2,6
2020,Enlisted,22032,17,12,5
2020,Enlisted,22060,67,30,37
2020,Enlisted,22401,51,9,42
2020,Enlisted,22427,8,3,5
2020,Enlisted,22601,16,3,13
2020,Enlisted,22602,22,6,16
2020,Enlisted,22664,10,1,9
2020,Enlisted,22801,8,2,6
2020,Enlisted,22902,27,11,16
2020,Enlisted,23139,12,3,9
2020,Enlisted,23150,63,15,48
2020,Enlisted,23181,10,2,8
2020,Enlisted,23237,15,4,11
2020,Enlisted,23434,8,0,8
2020,Enlisted,23451,72,17,55
2020,Enlisted,23502,45,11,34
2020,Enlisted,23609,13,1,12
2020,Enlisted,23666,21,1,20
2020,Enlisted,23701,29,6,23
2020,Enlisted,23805,22,4,18
2020,Enlisted,23824,39,12,27
2020,Enlisted,23847,16,4,12
2020,Enlisted,23901,9,4,5
2020,Enlisted,24073,16,3,13
2020,Enlisted,24151,18,3,15
2020,Enlisted,24175,3,0,3
2020,Enlisted,24212,9,1,8
2020,Enlisted,24251,26,4,22
2020,Enlisted,24301,11,1,10
2020,Enlisted,24401,8,2,6
2020,Enlisted,24450,7,2,5
2020,Enlisted,24502,42,6,36
2020,Enlisted,24523,15,6,9
2020,Enlisted,24540,12,3,9
2020,Enlisted,24592,6,2,4
2020,Enlisted,24609,18,1,17
2020,Enlisted,24701,13,2,11
2020,Enlisted,24957,14,0,14
2020,Enlisted,25064,2,2,0
2020,Enlisted,25168,55,9,46
2020,Enlisted,25262,1,0,1
2020,Enlisted,25309,5,0,5
2020,Enlisted,25311,70,69,1
2020,Enlisted,25401,8,0,8
2020,Enlisted,25405,4,2,2
2020,Enlisted,25530,33,13,20
2020,Enlisted,25550,9,1,8
2020,Enlisted,25625,19,1,18
2020,Enlisted,25846,55,8,47
2020,Enlisted,26003,10,1,9
2020,Enlisted,26041,15,3,12
2020,Enlisted,26101,14,1,13
2020,Enlisted,26187,11,3,8
2020,Enlisted,26201,9,1,8
2020,Enlisted,26250,9,1,8
2020,Enlisted,26301,5,0,5
2020,Enlisted,26505,10,1,9
2020,Enlisted,26508,1,0,1
2020,Enlisted,26526,6,2,4
2020,Enlisted,26537,32,12,20
2020,Enlisted,26554,25,1,24
2020,Enlisted,26651,12,3,9
2020,Enlisted,26836,25,4,21
2020,Enlisted,27028,5,0,5
2020,Enlisted,27030,1,0,1
2020,Enlisted,27103,64,10,54
2020,Enlisted,27203,4,0,4
2020,Enlisted,27217,42,15,27
2020,Enlisted,27260,17,2,15
2020,Enlisted,27292,26,7,19
2020,Enlisted,27320,18,3,15
2020,Enlisted,27330,8,0,8
2020,Enlisted,27344,13,0,13
2020,Enlisted,27360,4,0,4
2020,Enlisted,27401,46,9,37
2020,Enlisted,27504,15,1,14
2020,Enlisted,27509,16,3,13
2020,Enlisted,27530,36,8,28
2020,Enlisted,27549,3,1,2
2020,Enlisted,27560,107,27,80
2020,Enlisted,27573,7,0,7
2020,Enlisted,27577,26,12,14
2020,Enlisted,27581,6,2,4
2020,Enlisted,27596,17,5,12
2020,Enlisted,27607,13,8,5
2020,Enlisted,27704,31,7,24
2020,Enlisted,27830,1,1,0
2020,Enlisted,27856,3,1,2
2020,Enlisted,27870,22,16,6
2020,Enlisted,27889,5,1,4
2020,Enlisted,28001,13,9,4
2020,Enlisted,28027,23,3,20
2020,Enlisted,28043,2,0,2
2020,Enlisted,28054,31,5,26
2020,Enlisted,28086,8,0,8
2020,Enlisted,28092,6,0,6
2020,Enlisted,28110,3,1,2
2020,Enlisted,28115,4,3,1
2020,Enlisted,28147,16,5,11
2020,Enlisted,28170,3,0,3
2020,Enlisted,28208,49,13,36
2020,Enlisted,28306,10,4,6
2020,Enlisted,28310,29,13,16
2020,Enlisted,28328,14,5,9
2020,Enlisted,28334,7,2,5
2020,Enlisted,28345,3,1,2
2020,Enlisted,28352,20,3,17
2020,Enlisted,28371,5,2,3
2020,Enlisted,28376,33,15,18
2020,Enlisted,28377,10,4,6
2020,Enlisted,28379,12,2,10
2020,Enlisted,28384,21,6,15
2020,Enlisted,28387,3,1,2
2020,Enlisted,28401,8,5,3
2020,Enlisted,28405,23,10,13
2020,Enlisted,28439,6,2,4
2020,Enlisted,28459,8,2,6
2020,Enlisted,28470,2,0,2
2020,Enlisted,28472,23,13,10
2020,Enlisted,28504,40,14,26
2020,Enlisted,28518,2,0,2
2020,Enlisted,28540,41,19,22
2020,Enlisted,28557,2,2,0
2020,Enlisted,28560,14,6,8
2020,Enlisted,28590,11,1,10
2020,Enlisted,28601,5,1,4
2020,Enlisted,28607,3,0,3
2020,Enlisted,28621,5,0,5
2020,Enlisted,28640,5,0,5
2020,Enlisted,28645,25,4,21
2020,Enlisted,28655,11,2,9
2020,Enlisted,28659,13,1,12
2020,Enlisted,28677,13,0,13
2020,Enlisted,28681,5,2,3
2020,Enlisted,28734,18,2,16
2020,Enlisted,28752,6,0,6
2020,Enlisted,28779,2,0,2
2020,Enlisted,28806,16,2,14
2020,Enlisted,29006,12,1,11
2020,Enlisted,29020,14,3,11
2020,Enlisted,29044,138,32,106
2020,Enlisted,29102,6,1,5
2020,Enlisted,29108,35,1,34
2020,Enlisted,29115,14,1,13
2020,Enlisted,29138,12,3,9
2020,Enlisted,29153,18,3,15
2020,Enlisted,29161,31,4,27
2020,Enlisted,29170,36,5,31
2020,Enlisted,29201,4,3,1
2020,Enlisted,29303,5,1,4
2020,Enlisted,29325,12,0,12
2020,Enlisted,29341,4,0,4
2020,Enlisted,29360,38,6,32
2020,Enlisted,29379,16,3,13
2020,Enlisted,29385,27,3,24
2020,Enlisted,29403,2,0,2
2020,Enlisted,29409,24,4,20
2020,Enlisted,29418,66,12,54
2020,Enlisted,29440,10,1,9
2020,Enlisted,29461,30,9,21
2020,Enlisted,29464,30,4,26
2020,Enlisted,29488,20,1,19
2020,Enlisted,29506,8,0,8
2020,Enlisted,29510,6,1,5
2020,Enlisted,29512,27,2,25
2020,Enlisted,29532,10,0,10
2020,Enlisted,29536,3,1,2
2020,Enlisted,29544,1,1,0
2020,Enlisted,29550,13,2,11
2020,Enlisted,29554,7,2,5
2020,Enlisted,29556,22,2,20
2020,Enlisted,29571,17,1,16
2020,Enlisted,29574,22,7,15
2020,Enlisted,29577,4,1,3
2020,Enlisted,29605,38,3,35
2020,Enlisted,29620,21,2,19
2020,Enlisted,29625,24,4,20
2020,Enlisted,29631,28,0,28
2020,Enlisted,29640,13,2,11
2020,Enlisted,29644,16,7,9
2020,Enlisted,29646,22,1,21
2020,Enlisted,29651,27,0,27
2020,Enlisted,29653,24,1,23
2020,Enlisted,29678,11,0,11
2020,Enlisted,29706,4,1,3
2020,Enlisted,29715,11,0,11
2020,Enlisted,29720,29,3,26
2020,Enlisted,29732,11,0,11
2020,Enlisted,29810,8,0,8
2020,Enlisted,29812,6,0,6
2020,Enlisted,29824,12,0,12
2020,Enlisted,29829,25,1,24
2020,Enlisted,29835,3,0,3
2020,Enlisted,29906,26,2,24
2020,Enlisted,29944,5,0,5
2020,Enlisted,30014,14,7,7
2020,Enlisted,30032,10,3,7
2020,Enlisted,30040,91,13,78
2020,Enlisted,30046,17,4,13
2020,Enlisted,30060,192,40,152
2020,Enlisted,30069,70,6,64
2020,Enlisted,30114,26,4,22
2020,Enlisted,30125,21,2,19
2020,Enlisted,30134,18,1,17
2020,Enlisted,30144,23,0,23
2020,Enlisted,30161,30,4,26
2020,Enlisted,30224,18,9,9
2020,Enlisted,30233,20,2,18
2020,Enlisted,30240,28,4,24
2020,Enlisted,30263,7,1,6
2020,Enlisted,30294,14,3,11
2020,Enlisted,30297,63,13,50
2020,Enlisted,30336,50,12,38
2020,Enlisted,30401,17,1,16
2020,Enlisted,30427,10,1,9
2020,Enlisted,30439,24,4,20
2020,Enlisted,30458,14,1,13
2020,Enlisted,30460,6,0,6
2020,Enlisted,30461,14,4,10
2020,Enlisted,30501,12,5,7
2020,Enlisted,30577,18,3,15
2020,Enlisted,30635,16,4,12
2020,Enlisted,30643,2,0,2
2020,Enlisted,30655,31,4,27
2020,Enlisted,30673,27,3,24
2020,Enlisted,30680,81,8,73
2020,Enlisted,30701,54,2,52
2020,Enlisted,30720,17,6,11
2020,Enlisted,30824,11,1,10
2020,Enlisted,30830,1,0,1
2020,Enlisted,30904,41,4,37
2020,Enlisted,30905,24,5,19
2020,Enlisted,31015,6,3,3
2020,Enlisted,31029,49,5,44
2020,Enlisted,31040,20,4,16
2020,Enlisted,31061,18,3,15
2020,Enlisted,31211,60,13,47
2020,Enlisted,31313,76,19,57
2020,Enlisted,31314,29,6,23
2020,Enlisted,31329,17,2,15
2020,Enlisted,31406,67,17,50
2020,Enlisted,31409,14,2,12
2020,Enlisted,31520,5,1,4
2020,Enlisted,31533,7,2,5
2020,Enlisted,31601,10,3,7
2020,Enlisted,31704,13,1,12
2020,Enlisted,31792,6,2,4
2020,Enlisted,31794,3,0,3
2020,Enlisted,31901,3,2,1
2020,Enlisted,31905,29,8,21
2020,Enlisted,32055,23,9,14
2020,Enlisted,32064,10,2,8
2020,Enlisted,32084,37,3,34
2020,Enlisted,32086,13,7,6
2020,Enlisted,32091,167,43,124
2020,Enlisted,32164,40,5,35
2020,Enlisted,32177,5,1,4
2020,Enlisted,32221,140,52,88
2020,Enlisted,32311,17,9,8
2020,Enlisted,32351,27,4,23
2020,Enlisted,32405,13,1,12
2020,Enlisted,32406,1,0,1
2020,Enlisted,32425,18,4,14
2020,Enlisted,32428,9,1,8
2020,Enlisted,32446,4,0,4
2020,Enlisted,32447,1,0,1
2020,Enlisted,32514,30,7,23
2020,Enlisted,32536,3,1,2
2020,Enlisted,32539,15,2,13
2020,Enlisted,32609,4,4,0
2020,Enlisted,32721,8,2,6
2020,Enlisted,32724,17,3,14
2020,Enlisted,32726,11,2,9
2020,Enlisted,32727,2,2,0
2020,Enlisted,32771,29,16,13
2020,Enlisted,32806,40,24,16
2020,Enlisted,32862,16,6,10
2020,Enlisted,32922,16,9,7
2020,Enlisted,32935,38,11,27
2020,Enlisted,33027,107,21,86
2020,Enlisted,33039,15,3,12
2020,Enlisted,33127,29,4,25
2020,Enlisted,33315,60,5,55
2020,Enlisted,33401,2,1,1
2020,Enlisted,33405,48,8,40
2020,Enlisted,33406,10,2,8
2020,Enlisted,33523,9,0,9
2020,Enlisted,33563,25,7,18
2020,Enlisted,33606,21,5,16
2020,Enlisted,33711,13,4,9
2020,Enlisted,33782,117,45,72
2020,Enlisted,33811,19,3,16
2020,Enlisted,33825,1,1,0
2020,Enlisted,33830,24,6,18
2020,Enlisted,33844,11,3,8
2020,Enlisted,33859,26,8,18
2020,Enlisted,33873,2,1,1
2020,Enlisted,33880,15,2,13
2020,Enlisted,33916,9,1,8
2020,Enlisted,34208,15,5,10
2020,Enlisted,34221,8,0,8
2020,Enlisted,34237,19,3,16
2020,Enlisted,34266,12,1,11
2020,Enlisted,34429,16,4,12
2020,Enlisted,34471,1,0,1
2020,Enlisted,34474,28,7,21
2020,Enlisted,34604,9,4,5
2020,Enlisted,34748,23,11,12
2020,Enlisted,34947,23,8,15
2020,Enlisted,35010,30,1,29
2020,Enlisted,35016,4,0,4
2020,Enlisted,35040,13,8,5
2020,Enlisted,35042,20,4,16
2020,Enlisted,35045,19,0,19
2020,Enlisted,35055,28,11,17
2020,Enlisted,35072,6,0,6
2020,Enlisted,35121,27,0,27
2020,Enlisted,35124,24,7,17
2020,Enlisted,35146,13,1,12
2020,Enlisted,35160,23,5,18
2020,Enlisted,35161,3,0,3
2020,Enlisted,35178,12,3,9
2020,Enlisted,35209,14,4,10
2020,Enlisted,35217,69,22,47
2020,Enlisted,35259,3,1,2
2020,Enlisted,35405,22,7,15
2020,Enlisted,35476,9,1,8
2020,Enlisted,35501,2,1,1
2020,Enlisted,35555,2,0,2
2020,Enlisted,35565,25,2,23
2020,Enlisted,35601,51,7,44
2020,Enlisted,35613,4,1,3
2020,Enlisted,35630,18,1,17
2020,Enlisted,35803,30,2,28
2020,Enlisted,35805,34,8,26
2020,Enlisted,35904,52,4,48
2020,Enlisted,35967,10,3,7
2020,Enlisted,36016,20,3,17
2020,Enlisted,36027,9,1,8
2020,Enlisted,36043,41,8,33
2020,Enlisted,36067,7,1,6
2020,Enlisted,36078,28,2,26
2020,Enlisted,36081,15,1,14
2020,Enlisted,36083,7,0,7
2020,Enlisted,36109,116,88,28
2020,Enlisted,36117,19,2,17
2020,Enlisted,36203,14,1,13
2020,Enlisted,36205,48,5,43
2020,Enlisted,36250,4,2,2
2020,Enlisted,36265,41,2,39
2020,Enlisted,36301,25,2,23
2020,Enlisted,36302,1,0,1
2020,Enlisted,36323,10,2,8
2020,Enlisted,36330,24,4,20
2020,Enlisted,36340,21,3,18
2020,Enlisted,36420,10,3,7
2020,Enlisted,36426,11,0,11
2020,Enlisted,36442,4,1,3
2020,Enlisted,36522,25,5,20
2020,Enlisted,36532,16,1,15
2020,Enlisted,36535,28,6,22
2020,Enlisted,36605,58,11,47
2020,Enlisted,36701,2,1,1
2020,Enlisted,36801,6,1,5
2020,Enlisted,36832,18,8,10
2020,Enlisted,36854,16,8,8
2020,Enlisted,36867,4,1,3
2020,Enlisted,37015,10,3,7
2020,Enlisted,37033,10,5,5
2020,Enlisted,37042,16,10,6
2020,Enlisted,37055,17,4,13
2020,Enlisted,37066,16,8,8
2020,Enlisted,37083,1,1,0
2020,Enlisted,37090,24,2,22
2020,Enlisted,37091,8,3,5
2020,Enlisted,37097,3,2,1
2020,Enlisted,37110,33,12,21
2020,Enlisted,37129,30,6,24
2020,Enlisted,37160,8,3,5
2020,Enlisted,37167,57,17,40
2020,Enlisted,37172,15,10,5
2020,Enlisted,37178,5,3,2
2020,Enlisted,37185,13,0,13
2020,Enlisted,37204,143,90,53
2020,Enlisted,37217,38,16,22
2020,Enlisted,37306,3,1,2
2020,Enlisted,37321,11,1,10
2020,Enlisted,37323,16,2,14
2020,Enlisted,37327,10,2,8
2020,Enlisted,37334,4,0,4
2020,Enlisted,37356,11,3,8
2020,Enlisted,37388,29,6,23
2020,Enlisted,37398,13,3,10
2020,Enlisted,37404,31,4,27
2020,Enlisted,37615,5,1,4
2020,Enlisted,37620,14,0,14
2020,Enlisted,37643,1,0,1
2020,Enlisted,37645,10,1,9
2020,Enlisted,37683,4,1,3
2020,Enlisted,37717,13,3,10
2020,Enlisted,37743,9,3,6
2020,Enlisted,37757,4,1,3
2020,Enlisted,37760,8,0,8
2020,Enlisted,37771,15,2,13
2020,Enlisted,37777,41,12,29
2020,Enlisted,37801,13,6,7
2020,Enlisted,37821,18,7,11
2020,Enlisted,37825,6,2,4
2020,Enlisted,37841,8,0,8
2020,Enlisted,37854,13,1,12
2020,Enlisted,37857,5,0,5
2020,Enlisted,37860,8,3,5
2020,Enlisted,37863,7,1,6
2020,Enlisted,37874,9,2,7
2020,Enlisted,37919,30,12,18
2020,Enlisted,38001,19,1,18
2020,Enlisted,38008,8,2,6
2020,Enlisted,38012,8,5,3
2020,Enlisted,38019,4,1,3
2020,Enlisted,38024,1,0,1
2020,Enlisted,38053,19,0,19
2020,Enlisted,38063,3,0,3
2020,Enlisted,38079,2,1,1
2020,Enlisted,38118,61,4,57
2020,Enlisted,38210,20,5,15
2020,Enlisted,38242,10,3,7
2020,Enlisted,38261,21,3,18
2020,Enlisted,38301,6,1,5
2020,Enlisted,38305,6,0,6
2020,Enlisted,38320,7,2,5
2020,Enlisted,38340,13,2,11
2020,Enlisted,38343,8,3,5
2020,Enlisted,38344,19,3,16
2020,Enlisted,38351,25,2,23
2020,Enlisted,38358,4,1,3
2020,Enlisted,38372,8,1,7
2020,Enlisted,38375,17,4,13
2020,Enlisted,38382,9,2,7
2020,Enlisted,38401,11,3,8
2020,Enlisted,38462,1,1,0
2020,Enlisted,38464,4,1,3
2020,Enlisted,38478,9,0,9
2020,Enlisted,38485,4,1,3
2020,Enlisted,38506,9,1,8
2020,Enlisted,38556,27,8,19
2020,Enlisted,38563,2,1,1
2020,Enlisted,38570,16,6,10
2020,Enlisted,38572,9,1,8
2020,Enlisted,38583,10,6,4
2020,Enlisted,38606,12,1,11
2020,Enlisted,38614,6,0,6
2020,Enlisted,38632,12,2,10
2020,Enlisted,38635,7,0,7
2020,Enlisted,38655,18,1,17
2020,Enlisted,38663,4,0,4
2020,Enlisted,38665,1,0,1
2020,Enlisted,38668,27,1,26
2020,Enlisted,38671,25,1,24
2020,Enlisted,38701,3,0,3
2020,Enlisted,38703,12,0,12
2020,Enlisted,38732,7,0,7
2020,Enlisted,38751,5,0,5
2020,Enlisted,38801,43,6,37
2020,Enlisted,38821,14,1,13
2020,Enlisted,38829,15,1,14
2020,Enlisted,38834,7,0,7
2020,Enlisted,38843,13,0,13
2020,Enlisted,38851,13,3,10
2020,Enlisted,38852,1,0,1
2020,Enlisted,38860,2,0,2
2020,Enlisted,38863,5,1,4
2020,Enlisted,38901,20,7,13
2020,Enlisted,38915,18,2,16
2020,Enlisted,38916,22,2,20
2020,Enlisted,38930,13,2,11
2020,Enlisted,38967,6,1,5
2020,Enlisted,39042,30,0,30
2020,Enlisted,39046,10,0,10
2020,Enlisted,39047,17,1,16
2020,Enlisted,39051,11,1,10
2020,Enlisted,39056,19,2,17
2020,Enlisted,39059,21,2,19
2020,Enlisted,39060,6,1,5
2020,Enlisted,39074,7,0,7
2020,Enlisted,39111,17,1,16
2020,Enlisted,39117,4,0,4
2020,Enlisted,39120,10,0,10
2020,Enlisted,39183,7,1,6
2020,Enlisted,39194,10,1,9
2020,Enlisted,39202,17,17,0
2020,Enlisted,39204,27,4,23
2020,Enlisted,39209,24,3,21
2020,Enlisted,39216,15,8,7
2020,Enlisted,39307,21,0,21
2020,Enlisted,39339,8,1,7
2020,Enlisted,39345,25,1,24
2020,Enlisted,39350,18,3,15
2020,Enlisted,39401,39,2,37
2020,Enlisted,39407,23,5,18
2020,Enlisted,39422,3,1,2
2020,Enlisted,39429,5,0,5
2020,Enlisted,39440,11,1,10
2020,Enlisted,39452,8,1,7
2020,Enlisted,39466,28,3,25
2020,Enlisted,39470,11,2,9
2020,Enlisted,39505,26,7,19
2020,Enlisted,39507,20,2,18
2020,Enlisted,39532,20,4,16
2020,Enlisted,39556,5,2,3
2020,Enlisted,39567,21,2,19
2020,Enlisted,39577,19,3,16
2020,Enlisted,39601,8,1,7
2020,Enlisted,39648,21,3,18
2020,Enlisted,39654,9,3,6
2020,Enlisted,39704,9,2,7
2020,Enlisted,39730,8,1,7
2020,Enlisted,39735,1,0,1
2020,Enlisted,39744,8,2,6
2020,Enlisted,39759,12,1,11
2020,Enlisted,39760,3,1,2
2020,Enlisted,39773,4,0,4
2020,Enlisted,40004,13,3,10
2020,Enlisted,40065,25,8,17
2020,Enlisted,40108,12,5,7
2020,Enlisted,40205,28,9,19
2020,Enlisted,40218,39,4,35
2020,Enlisted,40311,9,0,9
2020,Enlisted,40330,6,1,5
2020,Enlisted,40351,11,1,10
2020,Enlisted,40422,3,0,3
2020,Enlisted,40472,32,7,25
2020,Enlisted,40475,75,4,71
2020,Enlisted,40510,31,3,28
2020,Enlisted,40601,94,20,74
2020,Enlisted,40741,17,1,16
2020,Enlisted,40769,9,2,7
2020,Enlisted,40831,1,0,1
2020,Enlisted,40840,16,5,11
2020,Enlisted,40906,22,2,20
2020,Enlisted,40965,19,1,18
2020,Enlisted,41005,79,7,72
2020,Enlisted,41008,10,0,10
2020,Enlisted,41031,7,3,4
2020,Enlisted,41094,27,10,17
2020,Enlisted,41101,15,5,10
2020,Enlisted,41164,12,1,11
2020,Enlisted,41339,14,1,13
2020,Enlisted,41653,25,2,23
2020,Enlisted,41701,16,1,15
2020,Enlisted,42025,13,2,11
2020,Enlisted,42071,2,0,2
2020,Enlisted,42086,17,1,16
2020,Enlisted,42101,3,2,1
2020,Enlisted,42141,14,2,12
2020,Enlisted,42167,14,1,13
2020,Enlisted,42240,15,12,3
2020,Enlisted,42276,11,2,9
2020,Enlisted,42301,35,4,31
2020,Enlisted,42330,21,4,17
2020,Enlisted,42345,28,11,17
2020,Enlisted,42431,18,2,16
2020,Enlisted,42501,20,2,18
2020,Enlisted,42633,9,0,9
2020,Enlisted,42701,6,2,4
2020,Enlisted,42718,14,2,12
2020,Enlisted,42754,23,2,21
2020,Enlisted,43015,31,2,29
2020,Enlisted,43040,28,1,27
2020,Enlisted,43055,29,0,29
2020,Enlisted,43102,17,2,15
2020,Enlisted,43213,81,13,68
2020,Enlisted,43215,17,0,17
2020,Enlisted,43217,71,10,61
2020,Enlisted,43235,1,1,0
2020,Enlisted,43402,37,6,31
2020,Enlisted,43465,92,10,82
2020,Enlisted,43614,28,2,26
2020,Enlisted,43756,35,2,33
2020,Enlisted,43812,20,0,20
2020,Enlisted,44023,7,1,6
2020,Enlisted,44055,17,0,17
2020,Enlisted,44128,9,1,8
2020,Enlisted,44142,24,2,22
2020,Enlisted,44224,39,5,34
2020,Enlisted,44256,21,2,19
2020,Enlisted,44313,11,3,8
2020,Enlisted,44444,57,5,52
2020,Enlisted,44515,27,1,26
2020,Enlisted,44601,23,4,19
2020,Enlisted,44622,16,1,15
2020,Enlisted,44691,15,0,15
2020,Enlisted,44720,52,2,50
2020,Enlisted,44729,4,0,4
2020,Enlisted,44837,1,0,1
2020,Enlisted,44857,36,6,30
2020,Enlisted,44870,24,10,14
2020,Enlisted,44883,31,8,23
2020,Enlisted,44903,56,3,53
2020,Enlisted,45015,38,2,36
2020,Enlisted,45035,10,0,10
2020,Enlisted,45036,11,1,10
2020,Enlisted,45044,19,2,17
2020,Enlisted,45215,54,0,54
2020,Enlisted,45331,18,1,17
2020,Enlisted,45356,40,3,37
2020,Enlisted,45385,17,5,12
2020,Enlisted,45430,59,4,55
2020,Enlisted,45502,64,8,56
2020,Enlisted,45601,31,2,29
2020,Enlisted,45662,17,1,16
2020,Enlisted,45804,20,0,20
2020,Enlisted,45885,16,0,16
2020,Enlisted,46012,11,2,9
2020,Enlisted,46036,3,0,3
2020,Enlisted,46041,16,1,15
2020,Enlisted,46052,8,1,7
2020,Enlisted,46122,9,3,6
2020,Enlisted,46124,45,10,35
2020,Enlisted,46131,66,14,52
2020,Enlisted,46135,16,1,15
2020,Enlisted,46140,26,6,20
2020,Enlisted,46151,16,6,10
2020,Enlisted,46176,32,10,22
2020,Enlisted,46208,2,1,1
2020,Enlisted,46216,29,5,24
2020,Enlisted,46241,151,30,121
2020,Enlisted,46323,20,2,18
2020,Enlisted,46350,13,5,8
2020,Enlisted,46360,2,0,2
2020,Enlisted,46383,17,3,14
2020,Enlisted,46402,4,2,2
2020,Enlisted,46406,26,11,15
2020,Enlisted,46517,14,5,9
2020,Enlisted,46563,36,2,34
2020,Enlisted,46580,2,0,2
2020,Enlisted,46582,15,2,13
2020,Enlisted,46613,40,8,32
2020,Enlisted,46703,6,0,6
2020,Enlisted,46714,7,0,7
2020,Enlisted,46750,6,0,6
2020,Enlisted,46825,56,10,46
2020,Enlisted,46901,13,4,9
2020,Enlisted,46947,19,4,15
2020,Enlisted,46953,10,2,8
2020,Enlisted,46970,2,0,2
2020,Enlisted,47150,17,3,14
2020,Enlisted,47167,14,1,13
2020,Enlisted,47170,14,2,12
2020,Enlisted,47203,38,5,33
2020,Enlisted,47223,1,1,0
2020,Enlisted,47250,12,0,12
2020,Enlisted,47265,18,2,16
2020,Enlisted,47274,34,7,27
2020,Enlisted,47303,19,3,16
2020,Enlisted,47331,7,1,6
2020,Enlisted,47348,12,2,10
2020,Enlisted,47374,12,2,10
2020,Enlisted,47394,16,0,16
2020,Enlisted,47401,61,1,60
2020,Enlisted,47421,12,0,12
2020,Enlisted,47441,13,1,12
2020,Enlisted,47501,12,3,9
2020,Enlisted,47546,29,3,26
2020,Enlisted,47591,4,2,2
2020,Enlisted,47715,52,7,45
2020,Enlisted,47804,19,2,17
2020,Enlisted,47834,23,3,20
2020,Enlisted,47872,7,2,5
2020,Enlisted,47904,6,2,4
2020,Enlisted,47905,29,4,25
2020,Enlisted,47933,8,1,7
2020,Enlisted,47960,24,4,20
2020,Enlisted,47977,18,4,14
2020,Enlisted,47978,3,2,1
2020,Enlisted,48045,1,1,0
2020,Enlisted,48060,12,3,9
2020,Enlisted,48180,50,5,45
2020,Enlisted,48197,62,5,57
2020,Enlisted,48208,26,6,20
2020,Enlisted,48234,96,18,78
2020,Enlisted,48341,28,3,25
2020,Enlisted,48446,21,1,20
2020,Enlisted,48601,74,16,58
2020,Enlisted,48642,33,3,30
2020,Enlisted,48706,16,3,13
2020,Enlisted,48801,15,1,14
2020,Enlisted,48817,23,3,20
2020,Enlisted,48837,89,20,69
2020,Enlisted,48838,24,2,22
2020,Enlisted,48843,14,1,13
2020,Enlisted,48906,47,16,31
2020,Enlisted,48912,10,1,9
2020,Enlisted,48917,7,0,7
2020,Enlisted,49009,27,4,23
2020,Enlisted,49012,84,14,70
2020,Enlisted,49047,26,6,20
2020,Enlisted,49201,36,2,34
2020,Enlisted,49224,13,2,11
2020,Enlisted,49306,5,1,4
2020,Enlisted,49307,14,2,12
2020,Enlisted,49437,32,1,31
2020,Enlisted,49509,108,15,93
2020,Enlisted,49601,9,3,6
2020,Enlisted,49696,25,4,21
2020,Enlisted,49707,3,0,3
2020,Enlisted,49739,23,6,17
2020,Enlisted,49783,28,3,25
2020,Enlisted,49801,19,1,18
2020,Enlisted,49837,12,1,11
2020,Enlisted,49849,4,0,4
2020,Enlisted,49855,18,2,16
2020,Enlisted,49913,8,1,7
2020,Enlisted,50025,7,0,7
2020,Enlisted,50036,27,3,24
2020,Enlisted,50126,10,3,7
2020,Enlisted,50131,346,62,284
2020,Enlisted,50138,10,2,8
2020,Enlisted,50158,19,2,17
2020,Enlisted,50220,14,3,11
2020,Enlisted,50401,12,3,9
2020,Enlisted,50501,13,4,9
2020,Enlisted,50588,14,4,10
2020,Enlisted,50616,4,0,4
2020,Enlisted,50662,14,3,11
2020,Enlisted,50703,81,18,63
2020,Enlisted,50709,1,1,0
2020,Enlisted,51031,20,4,16
2020,Enlisted,51111,43,10,33
2020,Enlisted,51201,25,4,21
2020,Enlisted,51301,9,2,7
2020,Enlisted,51334,14,3,11
2020,Enlisted,51401,1,0,1
2020,Enlisted,51442,8,1,7
2020,Enlisted,51503,30,5,25
2020,Enlisted,51566,17,3,14
2020,Enlisted,51601,4,0,4
2020,Enlisted,52001,23,7,16
2020,Enlisted,52002,12,3,9
2020,Enlisted,52246,68,13,55
2020,Enlisted,52353,14,0,14
2020,Enlisted,52404,71,15,56
2020,Enlisted,52501,12,1,11
2020,Enlisted,52556,18,2,16
2020,Enlisted,52577,3,0,3
2020,Enlisted,52632,17,10,7
2020,Enlisted,52638,23,8,15
2020,Enlisted,52641,11,5,6
2020,Enlisted,52732,11,2,9
2020,Enlisted,52761,12,2,10
2020,Enlisted,52806,73,13,60
2020,Enlisted,53027,3,0,3
2020,Enlisted,53066,12,3,9
2020,Enlisted,53073,6,1,5
2020,Enlisted,53089,25,3,22
2020,Enlisted,53094,18,2,16
2020,Enlisted,53095,12,1,11
2020,Enlisted,53121,7,0,7
2020,Enlisted,53144,33,1,32
2020,Enlisted,53154,10,0,10
2020,Enlisted,53186,17,2,15
2020,Enlisted,53190,22,1,21
2020,Enlisted,53212,30,6,24
2020,Enlisted,53403,14,0,14
2020,Enlisted,53511,16,2,14
2020,Enlisted,53538,18,2,16
2020,Enlisted,53545,11,1,10
2020,Enlisted,53581,13,0,13
2020,Enlisted,53704,107,10,97
2020,Enlisted,53821,9,0,9
2020,Enlisted,53901,7,2,5
2020,Enlisted,53948,7,0,7
2020,Enlisted,53959,16,2,14
2020,Enlisted,53963,9,1,8
2020,Enlisted,54017,9,3,6
2020,Enlisted,54022,8,2,6
2020,Enlisted,54143,4,0,4
2020,Enlisted,54241,3,0,3
2020,Enlisted,54303,32,5,27
2020,Enlisted,54401,13,1,12
2020,Enlisted,54405,5,1,4
2020,Enlisted,54409,12,0,12
2020,Enlisted,54449,6,1,5
2020,Enlisted,54451,19,0,19
2020,Enlisted,54455,14,0,14
2020,Enlisted,54456,16,1,15
2020,Enlisted,54481,12,1,11
2020,Enlisted,54487,3,0,3
2020,Enlisted,54495,12,0,12
2020,Enlisted,54501,5,0,5
2020,Enlisted,54612,4,0,4
2020,Enlisted,54615,20,1,19
2020,Enlisted,54618,17,3,14
2020,Enlisted,54646,3,0,3
2020,Enlisted,54650,30,4,26
2020,Enlisted,54656,8,0,8
2020,Enlisted,54660,7,1,6
2020,Enlisted,54665,4,0,4
2020,Enlisted,54703,8,2,6
2020,Enlisted,54729,8,2,6
2020,Enlisted,54751,21,4,17
2020,Enlisted,54801,5,1,4
2020,Enlisted,54806,7,0,7
2020,Enlisted,54843,7,2,5
2020,Enlisted,54868,3,0,3
2020,Enlisted,54880,22,2,20
2020,Enlisted,54901,25,3,22
2020,Enlisted,54902,18,1,17
2020,Enlisted,54914,39,5,34
2020,Enlisted,54923,1,0,1
2020,Enlisted,54929,5,2,3
2020,Enlisted,54932,2,0,2
2020,Enlisted,54935,36,0,36
2020,Enlisted,54971,18,2,16
2020,Enlisted,54981,10,2,8
2020,Enlisted,55008,44,3,41
2020,Enlisted,55016,33,3,30
2020,Enlisted,55021,24,5,19
2020,Enlisted,55033,10,0,10
2020,Enlisted,55060,4,0,4
2020,Enlisted,55063,21,2,19
2020,Enlisted,55066,28,0,28
2020,Enlisted,55068,36,5,31
2020,Enlisted,55073,5,1,4
2020,Enlisted,55077,23,4,19
2020,Enlisted,55082,49,1,48
2020,Enlisted,55101,1,1,0
2020,Enlisted,55106,37,7,30
2020,Enlisted,55107,15,2,13
2020,Enlisted,55112,48,3,45
2020,Enlisted,55118,32,6,26
2020,Enlisted,55122,9,0,9
2020,Enlisted,55303,17,0,17
2020,Enlisted,55350,20,0,20
2020,Enlisted,55355,31,2,29
2020,Enlisted,55362,33,1,32
2020,Enlisted,55413,1,1,0
2020,Enlisted,55431,33,6,27
2020,Enlisted,55443,47,5,42
2020,Enlisted,55719,3,1,2
2020,Enlisted,55720,19,3,16
2020,Enlisted,55744,6,0,6
2020,Enlisted,55746,12,0,12
2020,Enlisted,55811,70,5,65
2020,Enlisted,55901,7,2,5
2020,Enlisted,55904,5,1,4
2020,Enlisted,55912,23,1,22
2020,Enlisted,55987,20,3,17
2020,Enlisted,56001,26,4,22
2020,Enlisted,56007,15,4,11
2020,Enlisted,56031,9,0,9
2020,Enlisted,56073,5,2,3
2020,Enlisted,56081,6,0,6
2020,Enlisted,56082,16,1,15
2020,Enlisted,56143,7,0,7
2020,Enlisted,56156,10,0,10
2020,Enlisted,56164,9,1,8
2020,Enlisted,56201,35,1,34
2020,Enlisted,56208,15,1,14
2020,Enlisted,56256,16,0,16
2020,Enlisted,56258,20,1,19
2020,Enlisted,56265,14,1,13
2020,Enlisted,56267,5,0,5
2020,Enlisted,56277,17,0,17
2020,Enlisted,56278,17,2,15
2020,Enlisted,56283,6,2,4
2020,Enlisted,56301,18,3,15
2020,Enlisted,56303,26,2,24
2020,Enlisted,56308,19,0,19
2020,Enlisted,56345,177,16,161
2020,Enlisted,56378,13,0,13
2020,Enlisted,56401,41,6,35
2020,Enlisted,56482,16,0,16
2020,Enlisted,56501,18,3,15
2020,Enlisted,56537,12,1,11
2020,Enlisted,56560,27,1,26
2020,Enlisted,56601,29,4,25
2020,Enlisted,56701,13,1,12
2020,Enlisted,56716,24,1,23
2020,Enlisted,57006,1,0,1
2020,Enlisted,57028,9,1,8
2020,Enlisted,57042,18,0,18
2020,Enlisted,57069,22,4,18
2020,Enlisted,57078,9,2,7
2020,Enlisted,57104,28,6,22
2020,Enlisted,57201,20,2,18
2020,Enlisted,57252,6,1,5
2020,Enlisted,57301,35,0,35
2020,Enlisted,57325,8,1,7
2020,Enlisted,57350,10,0,10
2020,Enlisted,57366,17,0,17
2020,Enlisted,57380,4,0,4
2020,Enlisted,57401,12,0,12
2020,Enlisted,57501,10,1,9
2020,Enlisted,57601,8,0,8
2020,Enlisted,57702,20,5,15
2020,Enlisted,57703,12,4,8
2020,Enlisted,57717,8,0,8
2020,Enlisted,57783,8,0,8
2020,Enlisted,57785,2,0,2
2020,Enlisted,58054,1,0,1
2020,Enlisted,58072,9,1,8
2020,Enlisted,58075,18,2,16
2020,Enlisted,58102,65,5,60
2020,Enlisted,58201,53,4,49
2020,Enlisted,58301,31,2,29
2020,Enlisted,58401,13,3,10
2020,Enlisted,58402,3,1,2
2020,Enlisted,58433,4,0,4
2020,Enlisted,58495,6,0,6
2020,Enlisted,58501,63,4,59
2020,Enlisted,58504,4,0,4
2020,Enlisted,58506,27,2,25
2020,Enlisted,58601,15,5,10
2020,Enlisted,58703,26,1,25
2020,Enlisted,58801,4,1,3
2020,Enlisted,59047,5,1,4
2020,Enlisted,59102,49,12,37
2020,Enlisted,59218,6,3,3
2020,Enlisted,59230,2,0,2
2020,Enlisted,59301,3,0,3
2020,Enlisted,59405,3,1,2
2020,Enlisted,59457,6,1,5
2020,Enlisted,59501,4,0,4
2020,Enlisted,59538,8,0,8
2020,Enlisted,59601,10,3,7
2020,Enlisted,59602,42,9,33
2020,Enlisted,59636,36,27,9
2020,Enlisted,59701,8,0,8
2020,Enlisted,59711,4,0,4
2020,Enlisted,59714,37,10,27
2020,Enlisted,59725,6,1,5
2020,Enlisted,59760,5,0,5
2020,Enlisted,59808,28,6,22
2020,Enlisted,59901,20,2,18
2020,Enlisted,59923,9,0,9
2020,Enlisted,60037,30,2,28
2020,Enlisted,60098,15,6,9
2020,Enlisted,60120,35,7,28
2020,Enlisted,60178,16,0,16
2020,Enlisted,60418,13,2,11
2020,Enlisted,60435,36,8,28
2020,Enlisted,60472,68,8,60
2020,Enlisted,60505,18,2,16
2020,Enlisted,60545,30,1,29
2020,Enlisted,60546,102,16,86
2020,Enlisted,60615,88,21,67
2020,Enlisted,60616,26,7,19
2020,Enlisted,60651,40,7,33
2020,Enlisted,60901,25,3,22
2020,Enlisted,61021,18,0,18
2020,Enlisted,61032,21,1,20
2020,Enlisted,61071,33,1,32
2020,Enlisted,61115,82,1,81
2020,Enlisted,61264,48,1,47
2020,Enlisted,61341,17,2,15
2020,Enlisted,61401,32,2,30
2020,Enlisted,61434,11,0,11
2020,Enlisted,61443,19,1,18
2020,Enlisted,61455,24,1,23
2020,Enlisted,61607,89,16,73
2020,Enlisted,61701,27,4,23
2020,Enlisted,61761,24,0,24
2020,Enlisted,61764,15,3,12
2020,Enlisted,61801,16,2,14
2020,Enlisted,61802,3,0,3
2020,Enlisted,61820,14,1,13
2020,Enlisted,61834,14,2,12
2020,Enlisted,61938,19,2,17
2020,Enlisted,61944,10,3,7
2020,Enlisted,61951,5,0,5
2020,Enlisted,62056,22,2,20
2020,Enlisted,62205,27,0,27
2020,Enlisted,62269,13,0,13
2020,Enlisted,62286,18,0,18
2020,Enlisted,62301,17,2,15
2020,Enlisted,62401,14,3,11
2020,Enlisted,62439,23,1,22
2020,Enlisted,62521,60,7,53
2020,Enlisted,62618,11,1,10
2020,Enlisted,62659,4,0,4
2020,Enlisted,62702,119,19,100
2020,Enlisted,62864,28,2,26
2020,Enlisted,62896,27,2,25
2020,Enlisted,62959,35,3,32
2020,Enlisted,62966,20,2,18
2020,Enlisted,63020,9,1,8
2020,Enlisted,63028,29,0,29
2020,Enlisted,63044,118,16,102
2020,Enlisted,63077,5,1,4
2020,Enlisted,63109,1,0,1
2020,Enlisted,63125,99,20,79
2020,Enlisted,63383,2,0,2
2020,Enlisted,63401,2,1,1
2020,Enlisted,63552,16,0,16
2020,Enlisted,63640,14,1,13
2020,Enlisted,63645,3,0,3
2020,Enlisted,63701,6,1,5
2020,Enlisted,63703,19,4,15
2020,Enlisted,63755,26,4,22
2020,Enlisted,63775,25,4,21
2020,Enlisted,63801,10,1,9
2020,Enlisted,63841,25,3,22
2020,Enlisted,63857,12,1,11
2020,Enlisted,63901,7,2,5
2020,Enlisted,64052,3,1,2
2020,Enlisted,64067,45,0,45
2020,Enlisted,64085,20,1,19
2020,Enlisted,64093,17,2,15
2020,Enlisted,64129,88,18,70
2020,Enlisted,64402,4,1,3
2020,Enlisted,64468,15,2,13
2020,Enlisted,64506,43,2,41
2020,Enlisted,64601,17,2,15
2020,Enlisted,64683,18,0,18
2020,Enlisted,64701,19,4,15
2020,Enlisted,64735,29,2,27
2020,Enlisted,64772,23,0,23
2020,Enlisted,64804,23,3,20
2020,Enlisted,64831,22,3,19
2020,Enlisted,64836,17,1,16
2020,Enlisted,64850,2,1,1
2020,Enlisted,65082,1,0,1
2020,Enlisted,65101,12,7,5
2020,Enlisted,65109,23,4,19
2020,Enlisted,65202,30,1,29
2020,Enlisted,65233,35,6,29
2020,Enlisted,65251,9,1,8
2020,Enlisted,65265,2,0,2
2020,Enlisted,65270,10,1,9
2020,Enlisted,65301,14,2,12
2020,Enlisted,65305,20,5,15
2020,Enlisted,65340,19,3,16
2020,Enlisted,65401,29,5,24
2020,Enlisted,65473,22,5,17
2020,Enlisted,65605,30,2,28
2020,Enlisted,65708,18,0,18
2020,Enlisted,65723,16,0,16
2020,Enlisted,65775,8,1,7
2020,Enlisted,65802,85,14,71
2020,Enlisted,65803,37,10,27
2020,Enlisted,66027,14,2,12
2020,Enlisted,66044,5,2,3
2020,Enlisted,66061,32,7,25
2020,Enlisted,66067,16,4,12
2020,Enlisted,66071,6,0,6
2020,Enlisted,66102,24,5,19
2020,Enlisted,66217,5,1,4
2020,Enlisted,66219,35,8,27
2020,Enlisted,66337,8,0,8
2020,Enlisted,66434,7,2,5
2020,Enlisted,66436,8,1,7
2020,Enlisted,66441,14,7,7
2020,Enlisted,66442,15,5,10
2020,Enlisted,66502,42,16,26
2020,Enlisted,66508,8,1,7
2020,Enlisted,66611,5,1,4
2020,Enlisted,66619,63,12,51
2020,Enlisted,66749,25,2,23
2020,Enlisted,66762,33,4,29
2020,Enlisted,66801,14,5,9
2020,Enlisted,66901,12,2,10
2020,Enlisted,66967,4,1,3
2020,Enlisted,67010,26,3,23
2020,Enlisted,67114,6,0,6
2020,Enlisted,67124,9,3,6
2020,Enlisted,67217,16,5,11
2020,Enlisted,67219,80,14,66
2020,Enlisted,67337,1,0,1
2020,Enlisted,67401,9,4,5
2020,Enlisted,67410,10,1,9
2020,Enlisted,67432,6,0,6
2020,Enlisted,67501,8,1,7
2020,Enlisted,67530,31,3,28
2020,Enlisted,67601,11,2,9
2020,Enlisted,67654,1,0,1
2020,Enlisted,67701,3,0,3
2020,Enlisted,67801,3,1,2
2020,Enlisted,67846,7,0,7
2020,Enlisted,67901,2,2,0
2020,Enlisted,68066,14,2,12
2020,Enlisted,68073,89,15,74
2020,Enlisted,68106,16,1,15
2020,Enlisted,68142,24,4,20
2020,Enlisted,68310,18,3,15
2020,Enlisted,68467,13,0,13
2020,Enlisted,68508,23,3,20
2020,Enlisted,68524,75,13,62
2020,Enlisted,68601,13,1,12
2020,Enlisted,68701,6,1,5
2020,Enlisted,68787,5,0,5
2020,Enlisted,68801,21,4,17
2020,Enlisted,68822,3,0,3
2020,Enlisted,68847,21,3,18
2020,Enlisted,68901,36,9,27
2020,Enlisted,69001,1,0,1
2020,Enlisted,69101,11,3,8
2020,Enlisted,69162,2,1,1
2020,Enlisted,69337,13,2,11
2020,Enlisted,69361,11,3,8
2020,Enlisted,70072,35,5,30
2020,Enlisted,70084,22,0,22
2020,Enlisted,70117,159,41,118
2020,Enlisted,70301,9,2,7
2020,Enlisted,70364,47,20,27
2020,Enlisted,70390,25,9,16
2020,Enlisted,70401,47,4,43
2020,Enlisted,70403,18,0,18
2020,Enlisted,70427,9,1,8
2020,Enlisted,70433,43,0,43
2020,Enlisted,70438,11,0,11
2020,Enlisted,70443,3,1,2
2020,Enlisted,70460,44,0,44
2020,Enlisted,70508,26,5,21
2020,Enlisted,70510,25,6,19
2020,Enlisted,70517,16,4,12
2020,Enlisted,70526,14,9,5
2020,Enlisted,70544,42,8,34
2020,Enlisted,70563,24,7,17
2020,Enlisted,70570,14,1,13
2020,Enlisted,70582,12,0,12
2020,Enlisted,70586,4,0,4
2020,Enlisted,70601,36,10,26
2020,Enlisted,70633,26,10,16
2020,Enlisted,70634,4,3,1
2020,Enlisted,70714,24,4,20
2020,Enlisted,70721,72,7,65
2020,Enlisted,70737,18,1,17
2020,Enlisted,70760,18,5,13
2020,Enlisted,70764,26,2,24
2020,Enlisted,70802,1,0,1
2020,Enlisted,70820,71,7,64
2020,Enlisted,71019,18,2,16
2020,Enlisted,71055,40,4,36
2020,Enlisted,71101,46,7,39
2020,Enlisted,71111,22,3,19
2020,Enlisted,71203,23,2,21
2020,Enlisted,71220,3,0,3
2020,Enlisted,71232,9,0,9
2020,Enlisted,71241,13,1,12
2020,Enlisted,71251,2,1,1
2020,Enlisted,71263,4,0,4
2020,Enlisted,71270,37,4,33
2020,Enlisted,71292,29,2,27
2020,Enlisted,71295,10,1,9
2020,Enlisted,71303,20,2,18
2020,Enlisted,71322,6,2,4
2020,Enlisted,71342,10,1,9
2020,Enlisted,71351,13,0,13
2020,Enlisted,71360,101,24,77
2020,Enlisted,71373,4,0,4
2020,Enlisted,71415,5,0,5
2020,Enlisted,71417,18,2,16
2020,Enlisted,71457,18,3,15
2020,Enlisted,71459,16,6,10
2020,Enlisted,71601,8,0,8
2020,Enlisted,71602,9,0,9
2020,Enlisted,71671,10,1,9
2020,Enlisted,71701,19,2,17
2020,Enlisted,71730,4,0,4
2020,Enlisted,71801,5,0,5
2020,Enlisted,71823,4,1,3
2020,Enlisted,71832,2,1,1
2020,Enlisted,71854,20,2,18
2020,Enlisted,71857,6,0,6
2020,Enlisted,71923,11,0,11
2020,Enlisted,71953,24,3,21
2020,Enlisted,72006,3,2,1
2020,Enlisted,72012,11,2,9
2020,Enlisted,72015,30,1,29
2020,Enlisted,72023,6,0,6
2020,Enlisted,72032,4,0,4
2020,Enlisted,72034,7,1,6
2020,Enlisted,72064,3,1,2
2020,Enlisted,72086,10,1,9
2020,Enlisted,72104,11,4,7
2020,Enlisted,72110,13,0,13
2020,Enlisted,72119,12,0,12
2020,Enlisted,72143,35,2,33
2020,Enlisted,72150,14,2,12
2020,Enlisted,72160,2,0,2
2020,Enlisted,72199,192,24,168
2020,Enlisted,72301,6,4,2
2020,Enlisted,72335,6,1,5
2020,Enlisted,72401,41,1,40
2020,Enlisted,72432,14,2,12
2020,Enlisted,72450,22,2,20
2020,Enlisted,72476,25,7,18
2020,Enlisted,72501,30,4,26
2020,Enlisted,72543,14,2,12
2020,Enlisted,72601,15,0,15
2020,Enlisted,72604,3,0,3
2020,Enlisted,72650,6,2,4
2020,Enlisted,72653,10,2,8
2020,Enlisted,72701,26,2,24
2020,Enlisted,72712,36,1,35
2020,Enlisted,72713,8,2,6
2020,Enlisted,72744,23,0,23
2020,Enlisted,72756,56,0,56
2020,Enlisted,72761,11,0,11
2020,Enlisted,72802,27,5,22
2020,Enlisted,72830,7,0,7
2020,Enlisted,72834,4,0,4
2020,Enlisted,72855,12,2,10
2020,Enlisted,72905,16,3,13
2020,Enlisted,72923,38,3,35
2020,Enlisted,72927,9,0,9
2020,Enlisted,72949,4,0,4
2020,Enlisted,73034,42,6,36
2020,Enlisted,73036,18,7,11
2020,Enlisted,73051,38,6,32
2020,Enlisted,73064,71,9,62
2020,Enlisted,73069,106,5,101
2020,Enlisted,73111,52,9,43
2020,Enlisted,73141,2,0,2
2020,Enlisted,73159,1,1,0
2020,Enlisted,73401,14,1,13
2020,Enlisted,73501,5,1,4
2020,Enlisted,73503,46,6,40
2020,Enlisted,73521,11,1,10
2020,Enlisted,73705,20,4,16
2020,Enlisted,74003,9,1,8
2020,Enlisted,74012,19,5,14
2020,Enlisted,74014,56,10,46
2020,Enlisted,74017,5,0,5
2020,Enlisted,74075,18,5,13
2020,Enlisted,74107,48,11,37
2020,Enlisted,74112,8,0,8
2020,Enlisted,74116,6,3,3
2020,Enlisted,74158,3,2,1
2020,Enlisted,74301,10,1,9
2020,Enlisted,74403,51,4,47
2020,Enlisted,74423,12,5,7
2020,Enlisted,74447,31,1,30
2020,Enlisted,74501,22,1,21
2020,Enlisted,74601,9,1,8
2020,Enlisted,74701,24,2,22
2020,Enlisted,74801,2,1,1
2020,Enlisted,74804,6,0,6
2020,Enlisted,74820,14,3,11
2020,Enlisted,74834,38,3,35
2020,Enlisted,74848,10,0,10
2020,Enlisted,75020,26,11,15
2020,Enlisted,75051,156,51,105
2020,Enlisted,75077,6,1,5
2020,Enlisted,75098,31,8,23
2020,Enlisted,75110,31,2,29
2020,Enlisted,75159,87,30,57
2020,Enlisted,75165,14,2,12
2020,Enlisted,75220,18,8,10
2020,Enlisted,75402,31,13,18
2020,Enlisted,75473,1,1,0
2020,Enlisted,75570,1,0,1
2020,Enlisted,75662,62,14,48
2020,Enlisted,75709,28,10,18
2020,Enlisted,75803,38,16,22
2020,Enlisted,75901,44,7,37
2020,Enlisted,76067,2,2,0
2020,Enlisted,76086,23,7,16
2020,Enlisted,76108,67,26,41
2020,Enlisted,76115,6,3,3
2020,Enlisted,76207,20,5,15
2020,Enlisted,76234,4,2,2
2020,Enlisted,76302,24,6,18
2020,Enlisted,76401,31,10,21
2020,Enlisted,76502,60,31,29
2020,Enlisted,76528,39,17,22
2020,Enlisted,76542,62,33,29
2020,Enlisted,76544,16,5,11
2020,Enlisted,76554,1,1,0
2020,Enlisted,76574,18,7,11
2020,Enlisted,76707,73,28,45
2020,Enlisted,76801,42,12,30
2020,Enlisted,76905,30,6,24
2020,Enlisted,77034,174,45,129
2020,Enlisted,77067,89,26,63
2020,Enlisted,77082,105,30,75
2020,Enlisted,77340,37,13,24
2020,Enlisted,77437,51,5,46
2020,Enlisted,77471,9,4,5
2020,Enlisted,77503,8,8,0
2020,Enlisted,77515,43,10,33
2020,Enlisted,77568,16,7,9
2020,Enlisted,77802,26,7,19
2020,Enlisted,77833,29,9,20
2020,Enlisted,77904,28,14,14
2020,Enlisted,78041,28,7,21
2020,Enlisted,78130,10,2,8
2020,Enlisted,78155,2,0,2
2020,Enlisted,78218,66,23,43
2020,Enlisted,78219,88,38,50
2020,Enlisted,78257,146,49,97
2020,Enlisted,78363,53,9,44
2020,Enlisted,78416,23,6,17
2020,Enlisted,78520,33,6,27
2020,Enlisted,78527,19,7,12
2020,Enlisted,78596,55,21,34
2020,Enlisted,78602,104,27,77
2020,Enlisted,78617,102,31,71
2020,Enlisted,78624,47,23,24
2020,Enlisted,78665,49,16,33
2020,Enlisted,78666,58,28,30
2020,Enlisted,78703,140,56,84
2020,Enlisted,78731,36,14,22
2020,Enlisted,78746,8,4,4
2020,Enlisted,78861,44,17,27
2020,Enlisted,79107,23,11,12
2020,Enlisted,79403,44,7,37
2020,Enlisted,79607,33,7,26
2020,Enlisted,79705,15,3,12
2020,Enlisted,79706,8,4,4
2020,Enlisted,79918,1,1,0
2020,Enlisted,79924,36,12,24
2020,Enlisted,79936,100,25,75
2020,Enlisted,80011,63,41,22
2020,Enlisted,80012,13,6,7
2020,Enlisted,80112,2,1,1
2020,Enlisted,80137,63,43,20
2020,Enlisted,80216,51,24,27
2020,Enlisted,80501,6,4,2
2020,Enlisted,80504,11,6,5
2020,Enlisted,80521,6,1,5
2020,Enlisted,80550,8,4,4
2020,Enlisted,80621,32,17,15
2020,Enlisted,80751,3,1,2
2020,Enlisted,80907,18,8,10
2020,Enlisted,80913,29,15,14
2020,Enlisted,80916,14,9,5
2020,Enlisted,80920,79,50,29
2020,Enlisted,81004,25,18,7
2020,Enlisted,81101,5,1,4
2020,Enlisted,81401,24,6,18
2020,Enlisted,81501,21,9,12
2020,Enlisted,82005,17,2,15
2020,Enlisted,82009,43,12,31
2020,Enlisted,82070,14,0,14
2020,Enlisted,82072,4,0,4
2020,Enlisted,82201,4,1,3
2020,Enlisted,82214,15,3,12
2020,Enlisted,82240,16,2,14
2020,Enlisted,82401,6,0,6
2020,Enlisted,82435,9,1,8
2020,Enlisted,82520,9,0,9
2020,Enlisted,82604,20,0,20
2020,Enlisted,82633,10,1,9
2020,Enlisted,82716,10,0,10
2020,Enlisted,82801,10,1,9
2020,Enlisted,82901,16,2,14
2020,Enlisted,82930,17,5,12
2020,Enlisted,83110,16,2,14
2020,Enlisted,83202,38,6,32
2020,Enlisted,83221,4,0,4
2020,Enlisted,83263,2,0,2
2020,Enlisted,83301,12,3,9
2020,Enlisted,83318,4,2,2
2020,Enlisted,83330,5,0,5
2020,Enlisted,83338,23,0,23
2020,Enlisted,83402,13,0,13
2020,Enlisted,83440,3,1,2
2020,Enlisted,83442,3,0,3
2020,Enlisted,83445,1,1,0
2020,Enlisted,83501,9,1,8
2020,Enlisted,83530,6,0,6
2020,Enlisted,83544,4,0,4
2020,Enlisted,83605,48,8,40
2020,Enlisted,83617,12,2,10
2020,Enlisted,83647,12,4,8
2020,Enlisted,83687,10,6,4
2020,Enlisted,83705,178,37,141
2020,Enlisted,83716,4,0,4
2020,Enlisted,83843,13,4,9
2020,Enlisted,83854,23,1,22
2020,Enlisted,84003,25,4,21
2020,Enlisted,84020,55,13,42
2020,Enlisted,84032,6,1,5
2020,Enlisted,84043,48,14,34
2020,Enlisted,84058,19,5,14
2020,Enlisted,84065,109,42,67
2020,Enlisted,84074,27,3,24
2020,Enlisted,84078,9,2,7
2020,Enlisted,84083,1,1,0
2020,Enlisted,84084,74,21,53
2020,Enlisted,84116,14,3,11
2020,Enlisted,84302,15,3,12
2020,Enlisted,84321,13,4,9
2020,Enlisted,84404,11,2,9
2020,Enlisted,84405,40,7,33
2020,Enlisted,84501,7,1,6
2020,Enlisted,84511,10,2,8
2020,Enlisted,84642,7,0,7
2020,Enlisted,84660,52,12,40
2020,Enlisted,84663,2,0,2
2020,Enlisted,84701,11,1,10
2020,Enlisted,84713,9,1,8
2020,Enlisted,84721,15,0,15
2020,Enlisted,84770,2,1,1
2020,Enlisted,84790,30,4,26
2020,Enlisted,85008,212,74,138
2020,Enlisted,85015,1,0,1
2020,Enlisted,85020,24,6,18
2020,Enlisted,85128,6,1,5
2020,Enlisted,85132,87,39,48
2020,Enlisted,85145,23,6,17
2020,Enlisted,85201,17,5,12
2020,Enlisted,85222,11,4,7
2020,Enlisted,85281,9,1,8
2020,Enlisted,85286,7,1,6
2020,Enlisted,85301,4,2,2
2020,Enlisted,85365,8,4,4
2020,Enlisted,85396,18,14,4
2020,Enlisted,85546,2,0,2
2020,Enlisted,85607,8,2,6
2020,Enlisted,85653,8,3,5
2020,Enlisted,85706,37,9,28
2020,Enlisted,85713,31,15,16
2020,Enlisted,85901,10,2,8
2020,Enlisted,86015,80,17,63
2020,Enlisted,86301,57,13,44
2020,Enlisted,87002,18,2,16
2020,Enlisted,87123,61,16,45
2020,Enlisted,87144,97,24,73
2020,Enlisted,87305,2,2,0
2020,Enlisted,87401,12,1,11
2020,Enlisted,87507,2,1,1
2020,Enlisted,87508,11,7,4
2020,Enlisted,87532,1,1,0
2020,Enlisted,87557,3,1,2
2020,Enlisted,88001,21,5,16
2020,Enlisted,88007,63,26,37
2020,Enlisted,88101,8,2,6
2020,Enlisted,88203,39,7,32
2020,Enlisted,88240,2,0,2
2020,Enlisted,88310,3,1,2
2020,Enlisted,89002,3,2,1
2020,Enlisted,89032,3,1,2
2020,Enlisted,89034,2,1,1
2020,Enlisted,89115,16,2,14
2020,Enlisted,89139,86,9,77
2020,Enlisted,89165,178,19,159
2020,Enlisted,89406,31,3,28
2020,Enlisted,89445,2,0,2
2020,Enlisted,89502,2,0,2
2020,Enlisted,89506,59,6,53
2020,Enlisted,89509,3,0,3
2020,Enlisted,89701,21,3,18
2020,Enlisted,89801,3,0,3
2020,Enlisted,90025,19,8,11
2020,Enlisted,90201,86,27,59
2020,Enlisted,90249,8,3,5
2020,Enlisted,90266,11,1,10
2020,Enlisted,90302,29,10,19
2020,Enlisted,90501,19,11,8
2020,Enlisted,90720,269,96,173
2020,Enlisted,90731,14,8,6
2020,Enlisted,90822,61,18,43
2020,Enlisted,91205,44,24,20
2020,Enlisted,91406,40,19,21
2020,Enlisted,91505,46,13,33
2020,Enlisted,91702,62,23,39
2020,Enlisted,91764,51,18,33
2020,Enlisted,91766,24,4,20
2020,Enlisted,91950,54,10,44
2020,Enlisted,92020,18,9,9
2020,Enlisted,92025,12,4,8
2020,Enlisted,92111,57,20,37
2020,Enlisted,92199,1,1,0
2020,Enlisted,92243,15,3,12
2020,Enlisted,92307,8,5,3
2020,Enlisted,92311,18,4,14
2020,Enlisted,92324,42,22,20
2020,Enlisted,92410,44,14,30
2020,Enlisted,92518,56,17,39
2020,Enlisted,92707,11,4,7
2020,Enlisted,92833,30,19,11
2020,Enlisted,92866,50,35,15
2020,Enlisted,93003,8,5,3
2020,Enlisted,93007,2,2,0
2020,Enlisted,93257,2,1,1
2020,Enlisted,93291,18,8,10
2020,Enlisted,93307,39,9,30
2020,Enlisted,93405,8,3,5
2020,Enlisted,93422,3,0,3
2020,Enlisted,93451,28,19,9
2020,Enlisted,93536,19,10,9
2020,Enlisted,93550,17,11,6
2020,Enlisted,93638,7,1,6
2020,Enlisted,93727,82,25,57
2020,Enlisted,93955,11,3,8
2020,Enlisted,94043,4,3,1
2020,Enlisted,94066,5,1,4
2020,Enlisted,94132,11,4,7
2020,Enlisted,94401,8,3,5
2020,Enlisted,94510,8,4,4
2020,Enlisted,94519,26,3,23
2020,Enlisted,94533,9,1,8
2020,Enlisted,94565,8,1,7
2020,Enlisted,94568,31,11,20
2020,Enlisted,94590,19,6,13
2020,Enlisted,94596,9,2,7
2020,Enlisted,94804,18,6,12
2020,Enlisted,94903,11,4,7
2020,Enlisted,94952,15,3,12
2020,Enlisted,95065,1,0,1
2020,Enlisted,95110,13,3,10
2020,Enlisted,95206,62,15,47
2020,Enlisted,95209,2,1,1
2020,Enlisted,95231,12,1,11
2020,Enlisted,95240,21,5,16
2020,Enlisted,95341,21,7,14
2020,Enlisted,95351,34,9,25
2020,Enlisted,95361,12,3,9
2020,Enlisted,95401,28,6,22
2020,Enlisted,95503,5,0,5
2020,Enlisted,95655,11,7,4
2020,Enlisted,95678,14,5,9
2020,Enlisted,95815,4,0,4
2020,Enlisted,95823,4,1,3
2020,Enlisted,95826,8,3,5
2020,Enlisted,95827,3,1,2
2020,Enlisted,95828,87,25,62
2020,Enlisted,95832,15,3,12
2020,Enlisted,95926,21,7,14
2020,Enlisted,95965,6,1,5
2020,Enlisted,96001,12,3,9
2020,Enlisted,96067,2,0,2
2020,Enlisted,96080,2,0,2
2020,Enlisted,96130,2,0,2
2020,Enlisted,96707,168,53,115
2020,Enlisted,96716,14,1,13
2020,Enlisted,96720,21,4,17
2020,Enlisted,96750,8,2,6
2020,Enlisted,96753,14,3,11
2020,Enlisted,96782,31,8,23
2020,Enlisted,96786,10,3,7
2020,Enlisted,96789,47,8,39
2020,Enlisted,96857,18,8,10
2020,Enlisted,96913,96,6,90
2020,Enlisted,97015,74,23,51
2020,Enlisted,97030,32,11,21
2020,Enlisted,97031,7,0,7
2020,Enlisted,97051,3,1,2
2020,Enlisted,97058,7,4,3
2020,Enlisted,97071,34,7,27
2020,Enlisted,97116,28,4,24
2020,Enlisted,97128,7,4,3
2020,Enlisted,97146,11,2,9
2020,Enlisted,97211,36,10,26
2020,Enlisted,97217,15,3,12
2020,Enlisted,97218,54,18,36
2020,Enlisted,97301,44,11,33
2020,Enlisted,97302,18,8,10
2020,Enlisted,97303,19,3,16
2020,Enlisted,97309,16,4,12
2020,Enlisted,97321,11,2,9
2020,Enlisted,97330,27,7,20
2020,Enlisted,97338,20,2,18
2020,Enlisted,97355,5,2,3
2020,Enlisted,97365,13,1,12
2020,Enlisted,97420,7,1,6
2020,Enlisted,97470,3,1,2
2020,Enlisted,97477,36,8,28
2020,Enlisted,97501,26,5,21
2020,Enlisted,97520,19,4,15
2020,Enlisted,97526,9,1,8
2020,Enlisted,97603,6,2,4
2020,Enlisted,97702,25,7,18
2020,Enlisted,97754,9,1,8
2020,Enlisted,97756,23,4,19
2020,Enlisted,97801,13,3,10
2020,Enlisted,97814,2,1,1
2020,Enlisted,97838,21,8,13
2020,Enlisted,97850,17,5,12
2020,Enlisted,97862,4,1,3
2020,Enlisted,97914,4,1,3
2020,Enlisted,98032,83,35,48
2020,Enlisted,98052,13,9,4
2020,Enlisted,98108,26,7,19
2020,Enlisted,98119,89,38,51
2020,Enlisted,98221,25,11,14
2020,Enlisted,98271,27,6,21
2020,Enlisted,98290,13,6,7
2020,Enlisted,98312,17,10,7
2020,Enlisted,98321,16,9,7
2020,Enlisted,98366,1,0,1
2020,Enlisted,98372,10,2,8
2020,Enlisted,98430,86,54,32
2020,Enlisted,98433,94,34,60
2020,Enlisted,98434,1,1,0
2020,Enlisted,98499,1,1,0
2020,Enlisted,98501,25,7,18
2020,Enlisted,98531,9,6,3
2020,Enlisted,98563,13,3,10
2020,Enlisted,98632,9,0,9
2020,Enlisted,98682,31,7,24
2020,Enlisted,98801,2,0,2
2020,Enlisted,98823,9,1,8
2020,Enlisted,98837,13,5,8
2020,Enlisted,98901,25,8,17
2020,Enlisted,98902,8,4,4
2020,Enlisted,98903,24,3,21
2020,Enlisted,98930,8,1,7
2020,Enlisted,99011,39,9,30
2020,Enlisted,99217,16,8,8
2020,Enlisted,99219,12,4,8
2020,Enlisted,99301,3,1,2
2020,Enlisted,99362,9,1,8
2020,Enlisted,99505,120,48,72
2020,Enlisted,99615,1,0,1
2020,Enlisted,99654,13,5,8
2020,Enlisted,99682,12,3,9
2020,Enlisted,99687,19,3,16
2020,Enlisted,99701,9,8,1
2020,Enlisted,99762,1,0,1
2020,Enlisted,99801,1,0,1
2020,Enlisted,99835,1,0,1
2020,Enlisted,99925,1,0,1
2020,Officer,     ,15,13,2
2020,Officer,00000,4,4,0
2020,Officer,00693,1,0,1
2020,Officer,00725,4,3,1
2020,Officer,00736,1,0,1
2020,Officer,00751,1,0,1
2020,Officer,00769,3,1,2
2020,Officer,00795,2,2,0
2020,Officer,00850,4,2,2
2020,Officer,00901,1,0,1
2020,Officer,00934,2,1,1
2020,Officer,00951,1,1,0
2020,Officer,01030,1,1,0
2020,Officer,01082,5,5,0
2020,Officer,01085,1,1,0
2020,Officer,01109,1,1,0
2020,Officer,01434,2,2,0
2020,Officer,01440,1,1,0
2020,Officer,01567,1,1,0
2020,Officer,01588,2,2,0
2020,Officer,01605,4,4,0
2020,Officer,01731,4,3,1
2020,Officer,01760,4,4,0
2020,Officer,01844,8,8,0
2020,Officer,01867,4,4,0
2020,Officer,02043,1,1,0
2020,Officer,02122,6,6,0
2020,Officer,02138,3,3,0
2020,Officer,02169,4,4,0
2020,Officer,02176,4,4,0
2020,Officer,02301,1,1,0
2020,Officer,02420,1,1,0
2020,Officer,02481,1,1,0
2020,Officer,02542,7,7,0
2020,Officer,02780,1,1,0
2020,Officer,02818,5,5,0
2020,Officer,02842,3,3,0
2020,Officer,02852,2,1,1
2020,Officer,02885,3,3,0
2020,Officer,02886,2,2,0
2020,Officer,02904,1,1,0
2020,Officer,02906,1,1,0
2020,Officer,02920,3,2,1
2020,Officer,03060,1,1,0
2020,Officer,03101,2,2,0
2020,Officer,03301,2,1,1
2020,Officer,03766,1,1,0
2020,Officer,03884,1,1,0
2020,Officer,04011,2,2,0
2020,Officer,04268,1,1,0
2020,Officer,04330,4,3,1
2020,Officer,04401,3,3,0
2020,Officer,04736,1,1,0
2020,Officer,04901,1,1,0
2020,Officer,05001,1,1,0
2020,Officer,05403,2,2,0
2020,Officer,05404,1,1,0
2020,Officer,05446,16,14,2
2020,Officer,05465,9,9,0
2020,Officer,05491,1,1,0
2020,Officer,05663,2,2,0
2020,Officer,05701,3,3,0
2020,Officer,05855,1,1,0
2020,Officer,06019,1,0,1
2020,Officer,06051,1,1,0
2020,Officer,06082,1,1,0
2020,Officer,06096,9,7,2
2020,Officer,06105,5,4,1
2020,Officer,06110,2,2,0
2020,Officer,06320,2,2,0
2020,Officer,06340,2,2,0
2020,Officer,06357,8,6,2
2020,Officer,06360,1,1,0
2020,Officer,06457,8,8,0
2020,Officer,06497,3,3,0
2020,Officer,06512,5,5,0
2020,Officer,06576,1,1,0
2020,Officer,06702,1,1,0
2020,Officer,06810,3,3,0
2020,Officer,07052,9,9,0
2020,Officer,07090,3,3,0
2020,Officer,07095,3,3,0
2020,Officer,07306,4,4,0
2020,Officer,07457,3,3,0
2020,Officer,07666,7,7,0
2020,Officer,07728,13,13,0
2020,Officer,07865,5,5,0
2020,Officer,07871,1,1,0
2020,Officer,07960,1,0,1
2020,Officer,08002,2,2,0
2020,Officer,08037,2,2,0
2020,Officer,08060,1,1,0
2020,Officer,08096,1,1,0
2020,Officer,08098,1,1,0
2020,Officer,08360,6,6,0
2020,Officer,08640,5,2,3
2020,Officer,08648,5,4,1
2020,Officer,08733,6,5,1
2020,Officer,08750,3,3,0
2020,Officer,08759,1,1,0
2020,Officer,08873,5,5,0
2020,Officer,10010,7,7,0
2020,Officer,10021,1,1,0
2020,Officer,10037,6,5,1
2020,Officer,10566,4,4,0
2020,Officer,10567,2,2,0
2020,Officer,10701,4,4,0
2020,Officer,10962,1,1,0
2020,Officer,11209,4,4,0
2020,Officer,11252,3,3,0
2020,Officer,11433,2,2,0
2020,Officer,11735,7,7,0
2020,Officer,11779,6,6,0
2020,Officer,12110,13,11,2
2020,Officer,12180,1,1,0
2020,Officer,12189,6,2,4
2020,Officer,12301,1,1,0
2020,Officer,12302,2,2,0
2020,Officer,12553,1,1,0
2020,Officer,12804,2,2,0
2020,Officer,13211,13,11,2
2020,Officer,13501,2,2,0
2020,Officer,13502,2,2,0
2020,Officer,13669,1,1,0
2020,Officer,13856,1,1,0
2020,Officer,13905,2,2,0
2020,Officer,14048,1,1,0
2020,Officer,14204,5,5,0
2020,Officer,14213,6,6,0
2020,Officer,14304,4,4,0
2020,Officer,14624,9,9,0
2020,Officer,14760,1,1,0
2020,Officer,15216,2,1,1
2020,Officer,15301,4,4,0
2020,Officer,15444,2,2,0
2020,Officer,15541,2,2,0
2020,Officer,15601,2,2,0
2020,Officer,15666,1,1,0
2020,Officer,15767,1,1,0
2020,Officer,15779,1,1,0
2020,Officer,15902,1,1,0
2020,Officer,15904,2,2,0
2020,Officer,16001,1,1,0
2020,Officer,16101,4,4,0
2020,Officer,16127,1,1,0
2020,Officer,16226,1,1,0
2020,Officer,16635,2,2,0
2020,Officer,16652,1,1,0
2020,Officer,16738,1,1,0
2020,Officer,16803,1,1,0
2020,Officer,16830,1,1,0
2020,Officer,16901,2,2,0
2020,Officer,17003,23,22,1
2020,Officer,17013,2,2,0
2020,Officer,17022,6,5,1
2020,Officer,17033,1,1,0
2020,Officer,17042,1,1,0
2020,Officer,17103,3,2,1
2020,Officer,17222,1,0,1
2020,Officer,17701,3,3,0
2020,Officer,17821,1,1,0
2020,Officer,18040,3,3,0
2020,Officer,18102,2,2,0
2020,Officer,18431,1,1,0
2020,Officer,18466,1,1,0
2020,Officer,18509,5,4,1
2020,Officer,18634,1,1,0
2020,Officer,18704,4,4,0
2020,Officer,18834,1,1,0
2020,Officer,19044,11,11,0
2020,Officer,19103,1,1,0
2020,Officer,19104,3,2,1
2020,Officer,19153,1,1,0
2020,Officer,19154,6,6,0
2020,Officer,19320,1,1,0
2020,Officer,19462,7,7,0
2020,Officer,19475,1,1,0
2020,Officer,19605,3,3,0
2020,Officer,19706,2,2,0
2020,Officer,19711,1,1,0
2020,Officer,19720,6,5,1
2020,Officer,19977,1,1,0
2020,Officer,20003,18,18,0
2020,Officer,20112,5,5,0
2020,Officer,20175,1,1,0
2020,Officer,20186,3,3,0
2020,Officer,20373,1,1,0
2020,Officer,20653,2,2,0
2020,Officer,20708,8,5,3
2020,Officer,20783,1,1,0
2020,Officer,20882,1,1,0
2020,Officer,21010,11,10,1
2020,Officer,21043,1,1,0
2020,Officer,21057,1,1,0
2020,Officer,21061,1,1,0
2020,Officer,21078,3,0,3
2020,Officer,21136,3,2,1
2020,Officer,21201,3,3,0
2020,Officer,21204,3,3,0
2020,Officer,21216,3,3,0
2020,Officer,21222,4,3,1
2020,Officer,21401,1,1,0
2020,Officer,21701,1,1,0
2020,Officer,22032,4,4,0
2020,Officer,22060,8,7,1
2020,Officer,22401,11,11,0
2020,Officer,22427,4,4,0
2020,Officer,22601,2,1,1
2020,Officer,22602,1,1,0
2020,Officer,22664,3,3,0
2020,Officer,22902,9,7,2
2020,Officer,23150,5,5,0
2020,Officer,23181,1,1,0
2020,Officer,23237,1,1,0
2020,Officer,23451,4,4,0
2020,Officer,23502,2,2,0
2020,Officer,23666,3,3,0
2020,Officer,23701,3,3,0
2020,Officer,23805,5,5,0
2020,Officer,23824,7,6,1
2020,Officer,23847,1,1,0
2020,Officer,23901,1,1,0
2020,Officer,24073,1,1,0
2020,Officer,24151,1,1,0
2020,Officer,24212,1,1,0
2020,Officer,24251,1,1,0
2020,Officer,24301,1,1,0
2020,Officer,24401,7,7,0
2020,Officer,24502,5,5,0
2020,Officer,24609,2,2,0
2020,Officer,24957,1,1,0
2020,Officer,25064,1,1,0
2020,Officer,25168,1,1,0
2020,Officer,25311,2,2,0
2020,Officer,25530,2,2,0
2020,Officer,25846,2,2,0
2020,Officer,26041,1,1,0
2020,Officer,26101,3,3,0
2020,Officer,26187,2,2,0
2020,Officer,26250,1,1,0
2020,Officer,26505,2,2,0
2020,Officer,26537,3,3,0
2020,Officer,26554,2,2,0
2020,Officer,27103,1,1,0
2020,Officer,27260,1,1,0
2020,Officer,27320,1,1,0
2020,Officer,27344,2,2,0
2020,Officer,27401,6,6,0
2020,Officer,27504,2,2,0
2020,Officer,27530,3,3,0
2020,Officer,27560,13,13,0
2020,Officer,27577,1,0,1
2020,Officer,27581,1,1,0
2020,Officer,27596,1,0,1
2020,Officer,27607,6,6,0
2020,Officer,27704,1,1,0
2020,Officer,28054,1,1,0
2020,Officer,28086,1,1,0
2020,Officer,28110,1,1,0
2020,Officer,28115,1,1,0
2020,Officer,28208,5,4,1
2020,Officer,28310,3,3,0
2020,Officer,28328,6,5,1
2020,Officer,28371,2,2,0
2020,Officer,28376,2,2,0
2020,Officer,28377,1,1,0
2020,Officer,28405,2,2,0
2020,Officer,28472,1,1,0
2020,Officer,28504,2,2,0
2020,Officer,28540,1,1,0
2020,Officer,28557,1,1,0
2020,Officer,28560,2,2,0
2020,Officer,28640,1,1,0
2020,Officer,28645,1,1,0
2020,Officer,28734,1,1,0
2020,Officer,29020,1,1,0
2020,Officer,29044,23,23,0
2020,Officer,29102,2,2,0
2020,Officer,29108,5,5,0
2020,Officer,29153,1,1,0
2020,Officer,29161,1,1,0
2020,Officer,29170,1,1,0
2020,Officer,29201,6,6,0
2020,Officer,29303,3,3,0
2020,Officer,29325,1,1,0
2020,Officer,29379,8,8,0
2020,Officer,29385,1,1,0
2020,Officer,29403,2,2,0
2020,Officer,29409,6,6,0
2020,Officer,29418,3,3,0
2020,Officer,29440,1,1,0
2020,Officer,29461,1,1,0
2020,Officer,29464,9,9,0
2020,Officer,29488,1,1,0
2020,Officer,29506,1,1,0
2020,Officer,29510,2,2,0
2020,Officer,29532,3,3,0
2020,Officer,29550,1,1,0
2020,Officer,29556,1,1,0
2020,Officer,29571,1,1,0
2020,Officer,29577,1,1,0
2020,Officer,29625,2,2,0
2020,Officer,29653,2,2,0
2020,Officer,29678,2,2,0
2020,Officer,29732,3,3,0
2020,Officer,29810,1,1,0
2020,Officer,29824,4,4,0
2020,Officer,29829,1,1,0
2020,Officer,29906,2,2,0
2020,Officer,29944,1,1,0
2020,Officer,30014,1,1,0
2020,Officer,30032,1,1,0
2020,Officer,30040,6,6,0
2020,Officer,30046,1,1,0
2020,Officer,30060,6,3,3
2020,Officer,30069,4,4,0
2020,Officer,30125,1,1,0
2020,Officer,30134,1,1,0
2020,Officer,30144,1,1,0
2020,Officer,30161,3,3,0
2020,Officer,30233,1,1,0
2020,Officer,30240,1,1,0
2020,Officer,30294,4,4,0
2020,Officer,30297,4,4,0
2020,Officer,30336,2,2,0
2020,Officer,30401,1,1,0
2020,Officer,30427,2,2,0
2020,Officer,30439,1,1,0
2020,Officer,30461,1,1,0
2020,Officer,30635,2,1,1
2020,Officer,30643,2,2,0
2020,Officer,30655,2,2,0
2020,Officer,30673,2,2,0
2020,Officer,30680,5,5,0
2020,Officer,30701,6,6,0
2020,Officer,30720,1,1,0
2020,Officer,30824,3,3,0
2020,Officer,30904,3,2,1
2020,Officer,31015,2,2,0
2020,Officer,31029,2,2,0
2020,Officer,31040,1,1,0
2020,Officer,31061,11,10,1
2020,Officer,31211,12,10,2
2020,Officer,31313,3,3,0
2020,Officer,31314,4,3,1
2020,Officer,31406,11,8,3
2020,Officer,31520,1,1,0
2020,Officer,31601,1,1,0
2020,Officer,31704,2,2,0
2020,Officer,31901,2,2,0
2020,Officer,32084,3,3,0
2020,Officer,32086,3,2,1
2020,Officer,32091,10,9,1
2020,Officer,32177,1,1,0
2020,Officer,32221,12,12,0
2020,Officer,32311,3,2,1
2020,Officer,32351,2,2,0
2020,Officer,32405,2,2,0
2020,Officer,32425,2,2,0
2020,Officer,32428,1,1,0
2020,Officer,32514,1,1,0
2020,Officer,32539,1,1,0
2020,Officer,32609,2,2,0
2020,Officer,32721,1,1,0
2020,Officer,32724,2,2,0
2020,Officer,32771,1,1,0
2020,Officer,32806,3,3,0
2020,Officer,32922,1,1,0
2020,Officer,33027,3,3,0
2020,Officer,33039,2,2,0
2020,Officer,33127,3,3,0
2020,Officer,33315,1,1,0
2020,Officer,33405,2,2,0
2020,Officer,33523,2,2,0
2020,Officer,33563,2,2,0
2020,Officer,33606,1,1,0
2020,Officer,33782,11,10,1
2020,Officer,33801,1,1,0
2020,Officer,33844,1,1,0
2020,Officer,33859,1,1,0
2020,Officer,33880,1,1,0
2020,Officer,33916,1,1,0
2020,Officer,34208,1,1,0
2020,Officer,34221,1,1,0
2020,Officer,34237,2,2,0
2020,Officer,34429,1,1,0
2020,Officer,34474,1,1,0
2020,Officer,34748,2,2,0
2020,Officer,35016,1,1,0
2020,Officer,35042,2,2,0
2020,Officer,35072,1,0,1
2020,Officer,35121,1,1,0
2020,Officer,35178,2,2,0
2020,Officer,35209,2,2,0
2020,Officer,35217,9,8,1
2020,Officer,35565,6,5,1
2020,Officer,35601,6,5,1
2020,Officer,35613,2,2,0
2020,Officer,35630,1,1,0
2020,Officer,35803,2,2,0
2020,Officer,35904,1,1,0
2020,Officer,35967,3,3,0
2020,Officer,36027,3,3,0
2020,Officer,36043,2,2,0
2020,Officer,36078,2,2,0
2020,Officer,36081,2,2,0
2020,Officer,36109,8,6,2
2020,Officer,36117,3,2,1
2020,Officer,36205,2,2,0
2020,Officer,36301,2,2,0
2020,Officer,36420,2,2,0
2020,Officer,36442,1,1,0
2020,Officer,36522,1,1,0
2020,Officer,36532,1,1,0
2020,Officer,36535,2,2,0
2020,Officer,36605,6,5,1
2020,Officer,36701,1,1,0
2020,Officer,36867,1,1,0
2020,Officer,37015,1,1,0
2020,Officer,37055,1,1,0
2020,Officer,37066,1,1,0
2020,Officer,37083,1,1,0
2020,Officer,37090,1,1,0
2020,Officer,37091,1,1,0
2020,Officer,37097,2,2,0
2020,Officer,37167,10,9,1
2020,Officer,37172,1,1,0
2020,Officer,37204,8,7,1
2020,Officer,37217,6,6,0
2020,Officer,37388,2,2,0
2020,Officer,37398,2,2,0
2020,Officer,37404,4,4,0
2020,Officer,37615,1,1,0
2020,Officer,37643,1,1,0
2020,Officer,37645,2,2,0
2020,Officer,37771,1,1,0
2020,Officer,37777,4,3,1
2020,Officer,37825,1,1,0
2020,Officer,37860,1,1,0
2020,Officer,37863,1,1,0
2020,Officer,37919,4,3,1
2020,Officer,38001,1,1,0
2020,Officer,38024,1,1,0
2020,Officer,38118,1,1,0
2020,Officer,38210,2,2,0
2020,Officer,38301,3,3,0
2020,Officer,38340,3,3,0
2020,Officer,38344,1,1,0
2020,Officer,38358,2,2,0
2020,Officer,38382,2,2,0
2020,Officer,38506,2,1,1
2020,Officer,38556,2,2,0
2020,Officer,38570,1,1,0
2020,Officer,38572,2,2,0
2020,Officer,38583,1,1,0
2020,Officer,38632,1,1,0
2020,Officer,38635,1,1,0
2020,Officer,38668,1,1,0
2020,Officer,38732,1,1,0
2020,Officer,38751,1,1,0
2020,Officer,38801,5,5,0
2020,Officer,38803,1,1,0
2020,Officer,38863,1,1,0
2020,Officer,38901,2,2,0
2020,Officer,38916,2,2,0
2020,Officer,38930,1,1,0
2020,Officer,39042,1,1,0
2020,Officer,39051,1,1,0
2020,Officer,39056,1,1,0
2020,Officer,39059,2,2,0
2020,Officer,39074,1,1,0
2020,Officer,39111,1,1,0
2020,Officer,39183,3,3,0
2020,Officer,39194,2,2,0
2020,Officer,39202,4,3,1
2020,Officer,39204,3,3,0
2020,Officer,39209,4,4,0
2020,Officer,39307,1,1,0
2020,Officer,39350,2,2,0
2020,Officer,39401,3,3,0
2020,Officer,39407,1,1,0
2020,Officer,39429,2,2,0
2020,Officer,39440,2,2,0
2020,Officer,39505,1,1,0
2020,Officer,39507,1,1,0
2020,Officer,39532,1,1,0
2020,Officer,39556,2,2,0
2020,Officer,39601,1,1,0
2020,Officer,39648,2,2,0
2020,Officer,39654,1,1,0
2020,Officer,39704,3,3,0
2020,Officer,40065,1,1,0
2020,Officer,40069,2,2,0
2020,Officer,40205,6,6,0
2020,Officer,40218,1,1,0
2020,Officer,40311,2,2,0
2020,Officer,40330,1,1,0
2020,Officer,40472,1,1,0
2020,Officer,40475,6,6,0
2020,Officer,40510,6,5,1
2020,Officer,40601,14,13,1
2020,Officer,40741,1,1,0
2020,Officer,40906,3,3,0
2020,Officer,40965,1,1,0
2020,Officer,41005,1,1,0
2020,Officer,41008,2,2,0
2020,Officer,41031,2,2,0
2020,Officer,41101,3,3,0
2020,Officer,42086,1,1,0
2020,Officer,42101,5,5,0
2020,Officer,42141,3,3,0
2020,Officer,42167,1,1,0
2020,Officer,42301,1,1,0
2020,Officer,42330,3,3,0
2020,Officer,42431,1,1,0
2020,Officer,42501,1,1,0
2020,Officer,42718,2,2,0
2020,Officer,42754,1,1,0
2020,Officer,43015,1,1,0
2020,Officer,43040,1,1,0
2020,Officer,43102,1,1,0
2020,Officer,43213,10,10,0
2020,Officer,43215,1,1,0
2020,Officer,43217,6,6,0
2020,Officer,43235,3,2,1
2020,Officer,43465,6,5,1
2020,Officer,43756,1,1,0
2020,Officer,44023,1,1,0
2020,Officer,44055,1,1,0
2020,Officer,44128,1,1,0
2020,Officer,44142,2,2,0
2020,Officer,44313,2,2,0
2020,Officer,44444,2,2,0
2020,Officer,44515,3,3,0
2020,Officer,44622,1,1,0
2020,Officer,44691,1,1,0
2020,Officer,44720,2,2,0
2020,Officer,44857,1,1,0
2020,Officer,44883,1,1,0
2020,Officer,44903,1,1,0
2020,Officer,45015,3,3,0
2020,Officer,45044,1,1,0
2020,Officer,45215,2,2,0
2020,Officer,45331,1,1,0
2020,Officer,45356,1,1,0
2020,Officer,45385,2,2,0
2020,Officer,45502,7,7,0
2020,Officer,45601,1,1,0
2020,Officer,45662,1,1,0
2020,Officer,45804,1,1,0
2020,Officer,46012,2,2,0
2020,Officer,46124,2,2,0
2020,Officer,46131,4,3,1
2020,Officer,46135,1,1,0
2020,Officer,46140,1,1,0
2020,Officer,46176,5,4,1
2020,Officer,46216,3,3,0
2020,Officer,46241,15,13,2
2020,Officer,46350,1,1,0
2020,Officer,46383,1,1,0
2020,Officer,46402,1,1,0
2020,Officer,46406,1,1,0
2020,Officer,46517,1,1,0
2020,Officer,46563,1,1,0
2020,Officer,46582,1,1,0
2020,Officer,46613,1,1,0
2020,Officer,46703,1,1,0
2020,Officer,46750,1,1,0
2020,Officer,46825,5,5,0
2020,Officer,46901,1,1,0
2020,Officer,46970,1,1,0
2020,Officer,47150,1,1,0
2020,Officer,47167,1,1,0
2020,Officer,47203,1,1,0
2020,Officer,47250,1,1,0
2020,Officer,47265,1,1,0
2020,Officer,47303,2,2,0
2020,Officer,47331,1,1,0
2020,Officer,47348,1,0,1
2020,Officer,47401,3,3,0
2020,Officer,47501,2,2,0
2020,Officer,47546,3,3,0
2020,Officer,47715,3,2,1
2020,Officer,47834,1,1,0
2020,Officer,47904,1,1,0
2020,Officer,47905,5,5,0
2020,Officer,47933,1,1,0
2020,Officer,47977,1,1,0
2020,Officer,48180,3,3,0
2020,Officer,48197,4,2,2
2020,Officer,48208,1,1,0
2020,Officer,48234,8,5,3
2020,Officer,48601,2,2,0
2020,Officer,48642,1,1,0
2020,Officer,48706,1,1,0
2020,Officer,48801,1,1,0
2020,Officer,48837,6,6,0
2020,Officer,48838,3,3,0
2020,Officer,48906,13,10,3
2020,Officer,48912,2,2,0
2020,Officer,49009,3,3,0
2020,Officer,49012,5,5,0
2020,Officer,49307,1,1,0
2020,Officer,49437,1,1,0
2020,Officer,49509,3,3,0
2020,Officer,49696,1,1,0
2020,Officer,49739,3,3,0
2020,Officer,49783,1,1,0
2020,Officer,49849,2,2,0
2020,Officer,50036,1,1,0
2020,Officer,50126,1,1,0
2020,Officer,50131,27,26,1
2020,Officer,50501,1,1,0
2020,Officer,50588,1,1,0
2020,Officer,50616,1,1,0
2020,Officer,50703,4,4,0
2020,Officer,50709,1,1,0
2020,Officer,51031,2,2,0
2020,Officer,51111,2,2,0
2020,Officer,51301,2,2,0
2020,Officer,51503,2,2,0
2020,Officer,51601,1,1,0
2020,Officer,52001,1,1,0
2020,Officer,52246,3,3,0
2020,Officer,52353,2,2,0
2020,Officer,52404,4,4,0
2020,Officer,52501,1,1,0
2020,Officer,52632,1,1,0
2020,Officer,52641,1,1,0
2020,Officer,52732,1,1,0
2020,Officer,52761,1,1,0
2020,Officer,52806,6,6,0
2020,Officer,53027,2,2,0
2020,Officer,53089,2,2,0
2020,Officer,53094,2,2,0
2020,Officer,53095,2,2,0
2020,Officer,53144,1,1,0
2020,Officer,53154,1,1,0
2020,Officer,53212,3,3,0
2020,Officer,53403,5,4,1
2020,Officer,53511,1,1,0
2020,Officer,53545,1,1,0
2020,Officer,53704,7,4,3
2020,Officer,53821,1,1,0
2020,Officer,53948,1,1,0
2020,Officer,53959,2,2,0
2020,Officer,53963,1,1,0
2020,Officer,54022,1,1,0
2020,Officer,54143,1,1,0
2020,Officer,54303,1,1,0
2020,Officer,54401,2,1,1
2020,Officer,54405,1,1,0
2020,Officer,54409,1,1,0
2020,Officer,54449,1,1,0
2020,Officer,54451,1,1,0
2020,Officer,54455,1,1,0
2020,Officer,54456,1,1,0
2020,Officer,54487,1,1,0
2020,Officer,54615,1,1,0
2020,Officer,54618,8,5,3
2020,Officer,54665,2,2,0
2020,Officer,54703,3,2,1
2020,Officer,54729,3,2,1
2020,Officer,54801,1,1,0
2020,Officer,54806,1,1,0
2020,Officer,54880,3,3,0
2020,Officer,54914,1,1,0
2020,Officer,54929,1,1,0
2020,Officer,54935,1,1,0
2020,Officer,55008,4,3,1
2020,Officer,55016,3,3,0
2020,Officer,55063,1,1,0
2020,Officer,55068,6,6,0
2020,Officer,55073,2,2,0
2020,Officer,55077,2,1,1
2020,Officer,55082,3,3,0
2020,Officer,55101,5,3,2
2020,Officer,55106,1,1,0
2020,Officer,55107,4,4,0
2020,Officer,55112,2,1,1
2020,Officer,55118,1,1,0
2020,Officer,55122,2,2,0
2020,Officer,55303,2,2,0
2020,Officer,55431,3,3,0
2020,Officer,55443,4,4,0
2020,Officer,55720,2,2,0
2020,Officer,55744,2,2,0
2020,Officer,55811,4,4,0
2020,Officer,55904,1,1,0
2020,Officer,55912,1,1,0
2020,Officer,55987,1,1,0
2020,Officer,56001,2,2,0
2020,Officer,56143,2,2,0
2020,Officer,56201,1,0,1
2020,Officer,56258,1,1,0
2020,Officer,56265,1,1,0
2020,Officer,56267,1,0,1
2020,Officer,56277,1,1,0
2020,Officer,56278,1,1,0
2020,Officer,56301,1,1,0
2020,Officer,56303,1,1,0
2020,Officer,56345,12,9,3
2020,Officer,56378,2,2,0
2020,Officer,56401,1,1,0
2020,Officer,56482,1,1,0
2020,Officer,56537,2,2,0
2020,Officer,56560,3,3,0
2020,Officer,56716,1,1,0
2020,Officer,57042,1,1,0
2020,Officer,57078,1,1,0
2020,Officer,57104,4,4,0
2020,Officer,57201,6,6,0
2020,Officer,57252,2,2,0
2020,Officer,57350,1,1,0
2020,Officer,57401,1,1,0
2020,Officer,57501,1,1,0
2020,Officer,57702,7,5,2
2020,Officer,57783,1,1,0
2020,Officer,58072,4,4,0
2020,Officer,58102,16,15,1
2020,Officer,58201,3,3,0
2020,Officer,58301,1,1,0
2020,Officer,58501,8,8,0
2020,Officer,58506,3,2,1
2020,Officer,58703,3,3,0
2020,Officer,59102,3,3,0
2020,Officer,59218,1,1,0
2020,Officer,59301,1,1,0
2020,Officer,59457,1,1,0
2020,Officer,59501,1,1,0
2020,Officer,59602,1,1,0
2020,Officer,59636,11,9,2
2020,Officer,59701,1,1,0
2020,Officer,59711,1,0,1
2020,Officer,59714,1,1,0
2020,Officer,59808,2,2,0
2020,Officer,59901,2,2,0
2020,Officer,59923,1,1,0
2020,Officer,60435,1,1,0
2020,Officer,60472,7,7,0
2020,Officer,60505,1,1,0
2020,Officer,60545,1,1,0
2020,Officer,60546,5,5,0
2020,Officer,60615,5,5,0
2020,Officer,60651,3,3,0
2020,Officer,60901,1,1,0
2020,Officer,61021,1,1,0
2020,Officer,61032,1,1,0
2020,Officer,61071,1,1,0
2020,Officer,61115,2,2,0
2020,Officer,61201,1,1,0
2020,Officer,61264,1,1,0
2020,Officer,61341,4,4,0
2020,Officer,61401,1,1,0
2020,Officer,61443,1,1,0
2020,Officer,61455,1,1,0
2020,Officer,61607,6,6,0
2020,Officer,61701,2,2,0
2020,Officer,61761,2,2,0
2020,Officer,61764,2,2,0
2020,Officer,61801,3,2,1
2020,Officer,61802,1,1,0
2020,Officer,61834,1,1,0
2020,Officer,61938,2,2,0
2020,Officer,61944,1,1,0
2020,Officer,62521,4,4,0
2020,Officer,62659,1,1,0
2020,Officer,62702,6,5,1
2020,Officer,62864,3,3,0
2020,Officer,63028,2,2,0
2020,Officer,63044,1,1,0
2020,Officer,63125,5,4,1
2020,Officer,63383,1,1,0
2020,Officer,63552,2,2,0
2020,Officer,63640,1,1,0
2020,Officer,63645,3,3,0
2020,Officer,63701,2,1,1
2020,Officer,64067,1,0,1
2020,Officer,64085,2,2,0
2020,Officer,64129,8,8,0
2020,Officer,64468,2,2,0
2020,Officer,64601,1,1,0
2020,Officer,64735,1,1,0
2020,Officer,64772,1,1,0
2020,Officer,64804,2,2,0
2020,Officer,65101,5,5,0
2020,Officer,65233,1,1,0
2020,Officer,65251,5,4,1
2020,Officer,65270,1,1,0
2020,Officer,65301,1,0,1
2020,Officer,65305,3,3,0
2020,Officer,65473,4,3,1
2020,Officer,65605,3,3,0
2020,Officer,65775,1,1,0
2020,Officer,65802,6,6,0
2020,Officer,65803,1,1,0
2020,Officer,66027,4,3,1
2020,Officer,66061,1,1,0
2020,Officer,66071,1,1,0
2020,Officer,66102,3,3,0
2020,Officer,66219,10,9,1
2020,Officer,66337,2,2,0
2020,Officer,66434,2,2,0
2020,Officer,66502,1,1,0
2020,Officer,66611,2,1,1
2020,Officer,66619,9,8,1
2020,Officer,66749,1,1,0
2020,Officer,66762,1,1,0
2020,Officer,66801,2,2,0
2020,Officer,67114,1,1,0
2020,Officer,67124,1,1,0
2020,Officer,67219,6,5,1
2020,Officer,67401,1,1,0
2020,Officer,67410,2,2,0
2020,Officer,67501,1,1,0
2020,Officer,67601,1,1,0
2020,Officer,68003,1,1,0
2020,Officer,68073,7,6,1
2020,Officer,68142,1,1,0
2020,Officer,68503,1,1,0
2020,Officer,68508,4,4,0
2020,Officer,68524,11,11,0
2020,Officer,68601,2,2,0
2020,Officer,68801,1,1,0
2020,Officer,68901,1,1,0
2020,Officer,70117,12,10,2
2020,Officer,70401,4,4,0
2020,Officer,70403,1,1,0
2020,Officer,70410,2,2,0
2020,Officer,70460,1,1,0
2020,Officer,70508,2,2,0
2020,Officer,70510,1,1,0
2020,Officer,70563,1,1,0
2020,Officer,70582,1,1,0
2020,Officer,70601,1,1,0
2020,Officer,70714,1,1,0
2020,Officer,70721,1,1,0
2020,Officer,70820,2,2,0
2020,Officer,71055,1,1,0
2020,Officer,71101,1,1,0
2020,Officer,71360,4,4,0
2020,Officer,71601,1,1,0
2020,Officer,71602,1,1,0
2020,Officer,71671,1,1,0
2020,Officer,71701,1,1,0
2020,Officer,71923,1,1,0
2020,Officer,71953,1,1,0
2020,Officer,72012,2,2,0
2020,Officer,72023,2,2,0
2020,Officer,72032,2,2,0
2020,Officer,72034,1,0,1
2020,Officer,72064,1,1,0
2020,Officer,72086,2,2,0
2020,Officer,72110,1,1,0
2020,Officer,72143,2,1,1
2020,Officer,72150,1,1,0
2020,Officer,72199,19,18,1
2020,Officer,72401,2,2,0
2020,Officer,72501,1,1,0
2020,Officer,72543,1,1,0
2020,Officer,72701,2,2,0
2020,Officer,72713,2,2,0
2020,Officer,72923,3,3,0
2020,Officer,73064,2,2,0
2020,Officer,73069,6,6,0
2020,Officer,73111,9,8,1
2020,Officer,73501,1,1,0
2020,Officer,73503,3,3,0
2020,Officer,73705,1,1,0
2020,Officer,74003,1,1,0
2020,Officer,74014,1,1,0
2020,Officer,74107,1,1,0
2020,Officer,74158,1,1,0
2020,Officer,74301,1,1,0
2020,Officer,74501,2,2,0
2020,Officer,74601,1,1,0
2020,Officer,74701,1,1,0
2020,Officer,74834,1,1,0
2020,Officer,75020,4,4,0
2020,Officer,75051,10,9,1
2020,Officer,75077,1,1,0
2020,Officer,75098,5,5,0
2020,Officer,75110,1,1,0
2020,Officer,75159,1,1,0
2020,Officer,75165,3,3,0
2020,Officer,75237,1,1,0
2020,Officer,75402,1,1,0
2020,Officer,75709,2,2,0
2020,Officer,76108,2,2,0
2020,Officer,76115,1,1,0
2020,Officer,76302,1,1,0
2020,Officer,76528,1,1,0
2020,Officer,76542,2,2,0
2020,Officer,76707,8,8,0
2020,Officer,77034,7,6,1
2020,Officer,77067,4,4,0
2020,Officer,77082,9,9,0
2020,Officer,77340,3,3,0
2020,Officer,77568,3,3,0
2020,Officer,77802,1,1,0
2020,Officer,78041,1,1,0
2020,Officer,78218,7,7,0
2020,Officer,78219,3,3,0
2020,Officer,78257,7,6,1
2020,Officer,78416,2,2,0
2020,Officer,78527,1,1,0
2020,Officer,78596,2,2,0
2020,Officer,78602,7,7,0
2020,Officer,78617,3,3,0
2020,Officer,78665,7,7,0
2020,Officer,78666,5,5,0
2020,Officer,78703,24,19,5
2020,Officer,78746,2,2,0
2020,Officer,78861,1,1,0
2020,Officer,79403,1,1,0
2020,Officer,79607,4,4,0
2020,Officer,79705,2,2,0
2020,Officer,79936,6,6,0
2020,Officer,80011,6,6,0
2020,Officer,80012,3,2,1
2020,Officer,80112,3,3,0
2020,Officer,80137,5,5,0
2020,Officer,80216,5,5,0
2020,Officer,80501,4,4,0
2020,Officer,80521,2,2,0
2020,Officer,80550,2,2,0
2020,Officer,80913,1,1,0
2020,Officer,80916,4,3,1
2020,Officer,80920,7,6,1
2020,Officer,81004,1,0,1
2020,Officer,81401,2,2,0
2020,Officer,81501,1,1,0
2020,Officer,82005,2,2,0
2020,Officer,82009,2,2,0
2020,Officer,82070,1,1,0
2020,Officer,82604,1,1,0
2020,Officer,82801,2,1,1
2020,Officer,83440,1,1,0
2020,Officer,83605,1,1,0
2020,Officer,83617,1,0,1
2020,Officer,83647,2,2,0
2020,Officer,83705,19,19,0
2020,Officer,83854,3,3,0
2020,Officer,84003,1,1,0
2020,Officer,84020,10,8,2
2020,Officer,84058,1,1,0
2020,Officer,84065,20,17,3
2020,Officer,84084,7,7,0
2020,Officer,84116,2,2,0
2020,Officer,84405,4,4,0
2020,Officer,84642,1,1,0
2020,Officer,84660,4,4,0
2020,Officer,84663,1,0,1
2020,Officer,84713,1,1,0
2020,Officer,84721,1,1,0
2020,Officer,84770,1,1,0
2020,Officer,84790,1,1,0
2020,Officer,85008,22,20,2
2020,Officer,85020,2,2,0
2020,Officer,85128,3,3,0
2020,Officer,85132,4,4,0
2020,Officer,85281,1,1,0
2020,Officer,85396,2,2,0
2020,Officer,85546,1,1,0
2020,Officer,85706,1,1,0
2020,Officer,85713,2,2,0
2020,Officer,86015,3,3,0
2020,Officer,86301,1,0,1
2020,Officer,87002,1,1,0
2020,Officer,87123,7,5,2
2020,Officer,87144,13,13,0
2020,Officer,87401,3,3,0
2020,Officer,87502,1,1,0
2020,Officer,87508,2,2,0
2020,Officer,88001,6,6,0
2020,Officer,88007,2,2,0
2020,Officer,88203,2,2,0
2020,Officer,88310,2,2,0
2020,Officer,89002,1,1,0
2020,Officer,89115,1,1,0
2020,Officer,89139,6,6,0
2020,Officer,89165,9,8,1
2020,Officer,89406,1,1,0
2020,Officer,89502,1,0,1
2020,Officer,89506,8,8,0
2020,Officer,89509,2,2,0
2020,Officer,89701,2,2,0
2020,Officer,90025,3,3,0
2020,Officer,90201,9,9,0
2020,Officer,90249,1,1,0
2020,Officer,90302,1,1,0
2020,Officer,90501,2,2,0
2020,Officer,90720,19,19,0
2020,Officer,90731,3,2,1
2020,Officer,90822,13,11,2
2020,Officer,91205,2,2,0
2020,Officer,91406,2,2,0
2020,Officer,91505,3,3,0
2020,Officer,91702,5,5,0
2020,Officer,91764,2,2,0
2020,Officer,91766,1,1,0
2020,Officer,91950,1,1,0
2020,Officer,92111,2,2,0
2020,Officer,92243,1,1,0
2020,Officer,92324,2,2,0
2020,Officer,92410,4,4,0
2020,Officer,92707,1,1,0
2020,Officer,92833,2,1,1
2020,Officer,93307,2,2,0
2020,Officer,93405,1,1,0
2020,Officer,93536,1,1,0
2020,Officer,93727,8,8,0
2020,Officer,93955,2,2,0
2020,Officer,94401,1,1,0
2020,Officer,94533,2,2,0
2020,Officer,94590,1,1,0
2020,Officer,94596,1,1,0
2020,Officer,94804,4,4,0
2020,Officer,94952,1,1,0
2020,Officer,95065,3,3,0
2020,Officer,95206,3,2,1
2020,Officer,95240,2,2,0
2020,Officer,95341,3,3,0
2020,Officer,95351,3,3,0
2020,Officer,95401,2,2,0
2020,Officer,95503,1,1,0
2020,Officer,95678,1,1,0
2020,Officer,95827,1,0,1
2020,Officer,95828,5,4,1
2020,Officer,95926,1,1,0
2020,Officer,96707,8,8,0
2020,Officer,96716,1,1,0
2020,Officer,96720,2,2,0
2020,Officer,96782,1,1,0
2020,Officer,96786,2,2,0
2020,Officer,96913,5,5,0
2020,Officer,97015,4,3,1
2020,Officer,97030,1,1,0
2020,Officer,97058,2,2,0
2020,Officer,97116,1,1,0
2020,Officer,97211,1,1,0
2020,Officer,97217,1,1,0
2020,Officer,97218,1,1,0
2020,Officer,97301,5,5,0
2020,Officer,97302,3,3,0
2020,Officer,97303,1,0,1
2020,Officer,97309,1,0,1
2020,Officer,97321,1,0,1
2020,Officer,97330,1,1,0
2020,Officer,97338,1,1,0
2020,Officer,97420,2,2,0
2020,Officer,97477,3,3,0
2020,Officer,97501,1,1,0
2020,Officer,97520,2,2,0
2020,Officer,97603,1,1,0
2020,Officer,97702,1,1,0
2020,Officer,97754,1,1,0
2020,Officer,97756,1,1,0
2020,Officer,97814,1,1,0
2020,Officer,97850,1,1,0
2020,Officer,97914,1,1,0
2020,Officer,98032,6,6,0
2020,Officer,98108,1,1,0
2020,Officer,98119,8,8,0
2020,Officer,98221,1,1,0
2020,Officer,98271,1,1,0
2020,Officer,98372,2,2,0
2020,Officer,98430,11,10,1
2020,Officer,98433,16,16,0
2020,Officer,98501,1,1,0
2020,Officer,98531,1,1,0
2020,Officer,98563,1,1,0
2020,Officer,98682,5,5,0
2020,Officer,98823,1,1,0
2020,Officer,98837,1,1,0
2020,Officer,98901,2,2,0
2020,Officer,98902,1,1,0
2020,Officer,98903,1,0,1
2020,Officer,99011,6,6,0
2020,Officer,99217,3,3,0
2020,Officer,99219,1,1,0
2020,Officer,99505,27,24,3
2020,Officer,99731,5,5,0
2020,Warrant Officer,     ,3,3,0
2020,Warrant Officer,00795,1,1,0
2020,Warrant Officer,00901,1,1,0
2020,Warrant Officer,00902,1,1,0
2020,Warrant Officer,00907,2,2,0
2020,Warrant Officer,00934,1,1,0
2020,Warrant Officer,01013,1,1,0
2020,Warrant Officer,01109,1,1,0
2020,Warrant Officer,01434,1,1,0
2020,Warrant Officer,02481,1,1,0
2020,Warrant Officer,02542,2,2,0
2020,Warrant Officer,02842,1,1,0
2020,Warrant Officer,02852,1,1,0
2020,Warrant Officer,03101,2,2,0
2020,Warrant Officer,03301,4,4,0
2020,Warrant Officer,04330,2,2,0
2020,Warrant Officer,04401,5,5,0
2020,Warrant Officer,05403,1,1,0
2020,Warrant Officer,05446,1,1,0
2020,Warrant Officer,05465,2,2,0
2020,Warrant Officer,05663,1,1,0
2020,Warrant Officer,06096,3,3,0
2020,Warrant Officer,06105,1,1,0
2020,Warrant Officer,06340,1,1,0
2020,Warrant Officer,06497,1,1,0
2020,Warrant Officer,07090,1,1,0
2020,Warrant Officer,07095,2,2,0
2020,Warrant Officer,07865,1,1,0
2020,Warrant Officer,08401,1,1,0
2020,Warrant Officer,08640,2,2,0
2020,Warrant Officer,08648,2,2,0
2020,Warrant Officer,08733,5,5,0
2020,Warrant Officer,08750,1,1,0
2020,Warrant Officer,08873,3,3,0
2020,Warrant Officer,10037,1,1,0
2020,Warrant Officer,10567,1,1,0
2020,Warrant Officer,11779,6,6,0
2020,Warrant Officer,12110,4,4,0
2020,Warrant Officer,13602,1,1,0
2020,Warrant Officer,14624,1,1,0
2020,Warrant Officer,15301,2,2,0
2020,Warrant Officer,15902,4,4,0
2020,Warrant Officer,16830,1,1,0
2020,Warrant Officer,17003,12,12,0
2020,Warrant Officer,17103,1,1,0
2020,Warrant Officer,18509,1,1,0
2020,Warrant Officer,19044,1,1,0
2020,Warrant Officer,19720,2,2,0
2020,Warrant Officer,20003,3,3,0
2020,Warrant Officer,20708,1,1,0
2020,Warrant Officer,20783,1,1,0
2020,Warrant Officer,21010,8,8,0
2020,Warrant Officer,21043,1,1,0
2020,Warrant Officer,21136,1,1,0
2020,Warrant Officer,21201,2,2,0
2020,Warrant Officer,21204,1,1,0
2020,Warrant Officer,21216,1,1,0
2020,Warrant Officer,21401,5,5,0
2020,Warrant Officer,22060,2,2,0
2020,Warrant Officer,23150,4,4,0
2020,Warrant Officer,23451,2,2,0
2020,Warrant Officer,23805,1,1,0
2020,Warrant Officer,24401,1,1,0
2020,Warrant Officer,25064,1,1,0
2020,Warrant Officer,25168,1,1,0
2020,Warrant Officer,26003,1,1,0
2020,Warrant Officer,26187,4,4,0
2020,Warrant Officer,26537,2,2,0
2020,Warrant Officer,26624,1,1,0
2020,Warrant Officer,27401,1,1,0
2020,Warrant Officer,27560,6,6,0
2020,Warrant Officer,27607,1,1,0
2020,Warrant Officer,28147,1,1,0
2020,Warrant Officer,29044,14,14,0
2020,Warrant Officer,29108,1,1,0
2020,Warrant Officer,29153,1,1,0
2020,Warrant Officer,29303,1,1,0
2020,Warrant Officer,29605,1,1,0
2020,Warrant Officer,29625,1,1,0
2020,Warrant Officer,29944,1,1,0
2020,Warrant Officer,30060,14,14,0
2020,Warrant Officer,30069,1,1,0
2020,Warrant Officer,30297,6,6,0
2020,Warrant Officer,30680,1,1,0
2020,Warrant Officer,31211,2,2,0
2020,Warrant Officer,31409,1,1,0
2020,Warrant Officer,31905,1,1,0
2020,Warrant Officer,32091,3,3,0
2020,Warrant Officer,32221,3,3,0
2020,Warrant Officer,33606,1,1,0
2020,Warrant Officer,33711,1,1,0
2020,Warrant Officer,33782,4,4,0
2020,Warrant Officer,33873,3,3,0
2020,Warrant Officer,34604,2,2,0
2020,Warrant Officer,35209,3,3,0
2020,Warrant Officer,35217,5,5,0
2020,Warrant Officer,35565,1,1,0
2020,Warrant Officer,35967,1,1,0
2020,Warrant Officer,36078,1,1,0
2020,Warrant Officer,36205,1,1,0
2020,Warrant Officer,36608,5,5,0
2020,Warrant Officer,36701,1,1,0
2020,Warrant Officer,36801,3,3,0
2020,Warrant Officer,37204,1,1,0
2020,Warrant Officer,37404,2,2,0
2020,Warrant Officer,37777,4,4,0
2020,Warrant Officer,37919,1,1,0
2020,Warrant Officer,38320,1,1,0
2020,Warrant Officer,38671,1,1,0
2020,Warrant Officer,38801,1,1,0
2020,Warrant Officer,38916,1,1,0
2020,Warrant Officer,39202,3,3,0
2020,Warrant Officer,39204,1,1,0
2020,Warrant Officer,39209,4,4,0
2020,Warrant Officer,39339,1,1,0
2020,Warrant Officer,39401,1,1,0
2020,Warrant Officer,39407,1,1,0
2020,Warrant Officer,39505,1,1,0
2020,Warrant Officer,39601,1,1,0
2020,Warrant Officer,40510,2,2,0
2020,Warrant Officer,40601,4,4,0
2020,Warrant Officer,41005,1,1,0
2020,Warrant Officer,41101,1,1,0
2020,Warrant Officer,41701,1,1,0
2020,Warrant Officer,43015,1,1,0
2020,Warrant Officer,43213,3,3,0
2020,Warrant Officer,43215,1,1,0
2020,Warrant Officer,43217,7,7,0
2020,Warrant Officer,43235,1,1,0
2020,Warrant Officer,43465,2,2,0
2020,Warrant Officer,43812,1,1,0
2020,Warrant Officer,44256,3,3,0
2020,Warrant Officer,44444,1,1,0
2020,Warrant Officer,44515,2,2,0
2020,Warrant Officer,45215,1,1,0
2020,Warrant Officer,45430,1,1,0
2020,Warrant Officer,45502,3,3,0
2020,Warrant Officer,46124,2,2,0
2020,Warrant Officer,46176,4,4,0
2020,Warrant Officer,46216,2,2,0
2020,Warrant Officer,46241,1,1,0
2020,Warrant Officer,46406,2,2,0
2020,Warrant Officer,46901,1,1,0
2020,Warrant Officer,47303,1,1,0
2020,Warrant Officer,47715,1,1,0
2020,Warrant Officer,48180,1,1,0
2020,Warrant Officer,48197,1,1,0
2020,Warrant Officer,48234,1,1,0
2020,Warrant Officer,48837,5,5,0
2020,Warrant Officer,48838,1,1,0
2020,Warrant Officer,48906,4,4,0
2020,Warrant Officer,49739,1,1,0
2020,Warrant Officer,49801,1,1,0
2020,Warrant Officer,49849,1,1,0
2020,Warrant Officer,50036,2,2,0
2020,Warrant Officer,50131,4,4,0
2020,Warrant Officer,50709,3,3,0
2020,Warrant Officer,52246,1,1,0
2020,Warrant Officer,52404,1,1,0
2020,Warrant Officer,52806,1,1,0
2020,Warrant Officer,53095,1,1,0
2020,Warrant Officer,53212,2,2,0
2020,Warrant Officer,53704,6,6,0
2020,Warrant Officer,54456,1,1,0
2020,Warrant Officer,54618,2,2,0
2020,Warrant Officer,54656,1,1,0
2020,Warrant Officer,54665,1,1,0
2020,Warrant Officer,54843,1,1,0
2020,Warrant Officer,55066,1,1,0
2020,Warrant Officer,55068,6,6,0
2020,Warrant Officer,55101,1,1,0
2020,Warrant Officer,55107,5,5,0
2020,Warrant Officer,55431,1,1,0
2020,Warrant Officer,55443,1,1,0
2020,Warrant Officer,56208,1,1,0
2020,Warrant Officer,56301,3,3,0
2020,Warrant Officer,56345,1,1,0
2020,Warrant Officer,57201,1,1,0
2020,Warrant Officer,57301,2,2,0
2020,Warrant Officer,57702,6,6,0
2020,Warrant Officer,57703,2,2,0
2020,Warrant Officer,57785,1,1,0
2020,Warrant Officer,58201,1,1,0
2020,Warrant Officer,58504,1,1,0
2020,Warrant Officer,58506,2,2,0
2020,Warrant Officer,58703,1,1,0
2020,Warrant Officer,59102,1,1,0
2020,Warrant Officer,59602,2,2,0
2020,Warrant Officer,59636,3,3,0
2020,Warrant Officer,59701,1,1,0
2020,Warrant Officer,60616,1,1,0
2020,Warrant Officer,60901,5,5,0
2020,Warrant Officer,61115,1,1,0
2020,Warrant Officer,61201,1,1,0
2020,Warrant Officer,61607,1,1,0
2020,Warrant Officer,61701,1,1,0
2020,Warrant Officer,61761,2,2,0
2020,Warrant Officer,61802,1,1,0
2020,Warrant Officer,62205,1,1,0
2020,Warrant Officer,62521,2,2,0
2020,Warrant Officer,62702,1,1,0
2020,Warrant Officer,63125,4,4,0
2020,Warrant Officer,63841,1,1,0
2020,Warrant Officer,64701,1,1,0
2020,Warrant Officer,65082,1,1,0
2020,Warrant Officer,65101,1,1,0
2020,Warrant Officer,65109,1,1,0
2020,Warrant Officer,65251,1,1,0
2020,Warrant Officer,65305,4,4,0
2020,Warrant Officer,65473,5,5,0
2020,Warrant Officer,65803,1,1,0
2020,Warrant Officer,66027,4,4,0
2020,Warrant Officer,66061,1,1,0
2020,Warrant Officer,66502,2,2,0
2020,Warrant Officer,66611,1,1,0
2020,Warrant Officer,66619,4,4,0
2020,Warrant Officer,67401,1,1,0
2020,Warrant Officer,67432,1,1,0
2020,Warrant Officer,67530,1,1,0
2020,Warrant Officer,68106,1,1,0
2020,Warrant Officer,68508,3,3,0
2020,Warrant Officer,68524,6,6,0
2020,Warrant Officer,70117,1,1,0
2020,Warrant Officer,70401,6,6,0
2020,Warrant Officer,70410,4,4,0
2020,Warrant Officer,70433,1,1,0
2020,Warrant Officer,71203,1,1,0
2020,Warrant Officer,71303,2,2,0
2020,Warrant Officer,71360,3,3,0
2020,Warrant Officer,72199,8,8,0
2020,Warrant Officer,72401,1,1,0
2020,Warrant Officer,72701,2,2,0
2020,Warrant Officer,73051,1,1,0
2020,Warrant Officer,73064,1,1,0
2020,Warrant Officer,73069,1,1,0
2020,Warrant Officer,73111,3,3,0
2020,Warrant Officer,73501,1,1,0
2020,Warrant Officer,74107,1,1,0
2020,Warrant Officer,74112,1,1,0
2020,Warrant Officer,74158,1,1,0
2020,Warrant Officer,74403,1,1,0
2020,Warrant Officer,74820,1,1,0
2020,Warrant Officer,75051,4,4,0
2020,Warrant Officer,75237,1,1,0
2020,Warrant Officer,76108,1,1,0
2020,Warrant Officer,76115,3,3,0
2020,Warrant Officer,76502,1,1,0
2020,Warrant Officer,76528,1,1,0
2020,Warrant Officer,77034,5,5,0
2020,Warrant Officer,77067,1,1,0
2020,Warrant Officer,77082,1,1,0
2020,Warrant Officer,78218,1,1,0
2020,Warrant Officer,78219,1,1,0
2020,Warrant Officer,78257,1,1,0
2020,Warrant Officer,78617,3,3,0
2020,Warrant Officer,78703,2,2,0
2020,Warrant Officer,79936,1,1,0
2020,Warrant Officer,80011,4,4,0
2020,Warrant Officer,80112,2,2,0
2020,Warrant Officer,82005,2,2,0
2020,Warrant Officer,82801,1,1,0
2020,Warrant Officer,83705,1,1,0
2020,Warrant Officer,84020,3,3,0
2020,Warrant Officer,84058,2,2,0
2020,Warrant Officer,84065,3,3,0
2020,Warrant Officer,84084,12,12,0
2020,Warrant Officer,84116,2,2,0
2020,Warrant Officer,84321,1,1,0
2020,Warrant Officer,84404,1,1,0
2020,Warrant Officer,84501,1,1,0
2020,Warrant Officer,84770,2,2,0
2020,Warrant Officer,85008,3,3,0
2020,Warrant Officer,85222,1,1,0
2020,Warrant Officer,85653,4,4,0
2020,Warrant Officer,87144,1,1,0
2020,Warrant Officer,87508,1,1,0
2020,Warrant Officer,89032,1,1,0
2020,Warrant Officer,89139,1,1,0
2020,Warrant Officer,89506,4,4,0
2020,Warrant Officer,90201,1,1,0
2020,Warrant Officer,90501,1,1,0
2020,Warrant Officer,90720,15,15,0
2020,Warrant Officer,90822,3,3,0
2020,Warrant Officer,92111,1,1,0
2020,Warrant Officer,92311,1,1,0
2020,Warrant Officer,92707,1,1,0
2020,Warrant Officer,93307,1,1,0
2020,Warrant Officer,93405,1,1,0
2020,Warrant Officer,93536,1,1,0
2020,Warrant Officer,93727,2,2,0
2020,Warrant Officer,94043,1,1,0
2020,Warrant Officer,94590,1,1,0
2020,Warrant Officer,94903,1,1,0
2020,Warrant Officer,95065,1,1,0
2020,Warrant Officer,95206,3,3,0
2020,Warrant Officer,95655,1,1,0
2020,Warrant Officer,95827,1,1,0
2020,Warrant Officer,96707,3,3,0
2020,Warrant Officer,96720,3,3,0
2020,Warrant Officer,96857,6,6,0
2020,Warrant Officer,97301,1,1,0
2020,Warrant Officer,97302,3,3,0
2020,Warrant Officer,97309,2,2,0
2020,Warrant Officer,98108,1,1,0
2020,Warrant Officer,98119,1,1,0
2020,Warrant Officer,98321,1,1,0
2020,Warrant Officer,98430,3,3,0
2020,Warrant Officer,98433,12,12,0
2020,Warrant Officer,98903,2,2,0
2020,Warrant Officer,99505,5,5,0
2020,Warrant Officer,99701,1,1,0
2020,Warrant Officer,99731,1,1,0
2021,Enlisted,     ,11,5,6
2021,Enlisted,00000,133,31,102
2021,Enlisted,00604,32,3,29
2021,Enlisted,00612,23,3,20
2021,Enlisted,00623,7,1,6
2021,Enlisted,00624,7,0,7
2021,Enlisted,00641,12,4,8
2021,Enlisted,00682,50,11,39
2021,Enlisted,00693,19,0,19
2021,Enlisted,00705,12,0,12
2021,Enlisted,00714,10,0,10
2021,Enlisted,00725,7,0,7
2021,Enlisted,00733,2,0,2
2021,Enlisted,00735,19,3,16
2021,Enlisted,00736,30,5,25
2021,Enlisted,00751,5,1,4
2021,Enlisted,00769,15,1,14
2021,Enlisted,00778,25,1,24
2021,Enlisted,00785,17,3,14
2021,Enlisted,00792,9,2,7
2021,Enlisted,00795,82,4,78
2021,Enlisted,00802,24,1,23
2021,Enlisted,00850,6,2,4
2021,Enlisted,00901,1,0,1
2021,Enlisted,00907,13,0,13
2021,Enlisted,00934,193,8,185
2021,Enlisted,00951,9,0,9
2021,Enlisted,01013,12,4,8
2021,Enlisted,01022,2,2,0
2021,Enlisted,01030,25,10,15
2021,Enlisted,01062,2,0,2
2021,Enlisted,01082,28,5,23
2021,Enlisted,01085,15,2,13
2021,Enlisted,01201,5,0,5
2021,Enlisted,01434,48,16,32
2021,Enlisted,01440,6,1,5
2021,Enlisted,01453,9,2,7
2021,Enlisted,01588,5,2,3
2021,Enlisted,01605,40,14,26
2021,Enlisted,01702,15,4,11
2021,Enlisted,01731,4,2,2
2021,Enlisted,01742,1,1,0
2021,Enlisted,01760,25,2,23
2021,Enlisted,01844,27,8,19
2021,Enlisted,01867,50,12,38
2021,Enlisted,01923,14,6,8
2021,Enlisted,01950,19,3,16
2021,Enlisted,02043,28,7,21
2021,Enlisted,02122,12,3,9
2021,Enlisted,02138,37,11,26
2021,Enlisted,02169,20,4,16
2021,Enlisted,02176,23,7,16
2021,Enlisted,02184,20,9,11
2021,Enlisted,02301,13,1,12
2021,Enlisted,02324,4,2,2
2021,Enlisted,02346,18,6,12
2021,Enlisted,02420,9,0,9
2021,Enlisted,02532,9,1,8
2021,Enlisted,02542,61,15,46
2021,Enlisted,02724,8,2,6
2021,Enlisted,02769,14,2,12
2021,Enlisted,02780,27,4,23
2021,Enlisted,02809,5,2,3
2021,Enlisted,02818,129,36,93
2021,Enlisted,02842,17,14,3
2021,Enlisted,02852,29,5,24
2021,Enlisted,02885,1,0,1
2021,Enlisted,02886,43,4,39
2021,Enlisted,02904,14,2,12
2021,Enlisted,02906,3,0,3
2021,Enlisted,02920,5,5,0
2021,Enlisted,03055,23,6,17
2021,Enlisted,03060,16,5,11
2021,Enlisted,03101,30,8,22
2021,Enlisted,03244,25,7,18
2021,Enlisted,03264,10,2,8
2021,Enlisted,03275,2,2,0
2021,Enlisted,03301,50,14,36
2021,Enlisted,03561,5,1,4
2021,Enlisted,03766,7,1,6
2021,Enlisted,03801,8,4,4
2021,Enlisted,03815,1,1,0
2021,Enlisted,03867,25,5,20
2021,Enlisted,03878,4,2,2
2021,Enlisted,03884,2,0,2
2021,Enlisted,04011,16,5,11
2021,Enlisted,04073,11,2,9
2021,Enlisted,04240,15,0,15
2021,Enlisted,04268,18,7,11
2021,Enlisted,04330,30,6,24
2021,Enlisted,04401,60,8,52
2021,Enlisted,04412,19,4,15
2021,Enlisted,04619,3,0,3
2021,Enlisted,04730,9,1,8
2021,Enlisted,04736,3,1,2
2021,Enlisted,04901,27,2,25
2021,Enlisted,04976,10,1,9
2021,Enlisted,05001,6,1,5
2021,Enlisted,05033,13,3,10
2021,Enlisted,05158,5,3,2
2021,Enlisted,05201,3,2,1
2021,Enlisted,05403,9,2,7
2021,Enlisted,05404,7,0,7
2021,Enlisted,05446,61,51,10
2021,Enlisted,05465,9,5,4
2021,Enlisted,05478,3,1,2
2021,Enlisted,05491,15,0,15
2021,Enlisted,05495,2,1,1
2021,Enlisted,05633,6,2,4
2021,Enlisted,05661,3,1,2
2021,Enlisted,05663,8,3,5
2021,Enlisted,05701,4,3,1
2021,Enlisted,05855,5,1,4
2021,Enlisted,06051,35,10,25
2021,Enlisted,06066,3,1,2
2021,Enlisted,06082,21,2,19
2021,Enlisted,06096,45,7,38
2021,Enlisted,06105,2,2,0
2021,Enlisted,06110,39,4,35
2021,Enlisted,06320,55,8,47
2021,Enlisted,06333,3,0,3
2021,Enlisted,06340,14,5,9
2021,Enlisted,06357,31,5,26
2021,Enlisted,06360,6,0,6
2021,Enlisted,06457,61,18,43
2021,Enlisted,06489,13,4,9
2021,Enlisted,06497,21,7,14
2021,Enlisted,06498,29,1,28
2021,Enlisted,06512,18,5,13
2021,Enlisted,06702,13,2,11
2021,Enlisted,06810,37,7,30
2021,Enlisted,07052,29,12,17
2021,Enlisted,07090,28,3,25
2021,Enlisted,07095,42,8,34
2021,Enlisted,07107,34,9,25
2021,Enlisted,07306,41,9,32
2021,Enlisted,07457,23,6,17
2021,Enlisted,07666,54,15,39
2021,Enlisted,07728,25,8,17
2021,Enlisted,07806,20,8,12
2021,Enlisted,07840,12,4,8
2021,Enlisted,07865,48,6,42
2021,Enlisted,07871,20,3,17
2021,Enlisted,07960,33,7,26
2021,Enlisted,08002,5,2,3
2021,Enlisted,08012,13,4,9
2021,Enlisted,08037,17,6,11
2021,Enlisted,08060,36,5,31
2021,Enlisted,08096,29,9,20
2021,Enlisted,08098,5,2,3
2021,Enlisted,08210,19,2,17
2021,Enlisted,08360,24,5,19
2021,Enlisted,08401,9,3,6
2021,Enlisted,08640,11,8,3
2021,Enlisted,08648,18,3,15
2021,Enlisted,08733,47,9,38
2021,Enlisted,08750,44,8,36
2021,Enlisted,08755,14,3,11
2021,Enlisted,08759,7,1,6
2021,Enlisted,08822,8,0,8
2021,Enlisted,08873,28,9,19
2021,Enlisted,10010,81,16,65
2021,Enlisted,10021,1,1,0
2021,Enlisted,10037,106,12,94
2021,Enlisted,10314,41,6,35
2021,Enlisted,10468,18,2,16
2021,Enlisted,10566,80,10,70
2021,Enlisted,10567,82,17,65
2021,Enlisted,10701,53,6,47
2021,Enlisted,10962,29,3,26
2021,Enlisted,11209,52,4,48
2021,Enlisted,11252,46,5,41
2021,Enlisted,11357,15,1,14
2021,Enlisted,11433,80,11,69
2021,Enlisted,11735,57,5,52
2021,Enlisted,11746,27,4,23
2021,Enlisted,11779,37,9,28
2021,Enlisted,12078,13,1,12
2021,Enlisted,12110,62,13,49
2021,Enlisted,12180,33,6,27
2021,Enlisted,12189,4,3,1
2021,Enlisted,12301,41,8,33
2021,Enlisted,12401,15,0,15
2021,Enlisted,12451,9,1,8
2021,Enlisted,12553,56,9,47
2021,Enlisted,12804,44,7,37
2021,Enlisted,12962,31,9,22
2021,Enlisted,13021,17,2,15
2021,Enlisted,13211,41,9,32
2021,Enlisted,13501,45,13,32
2021,Enlisted,13502,15,5,10
2021,Enlisted,13643,8,2,6
2021,Enlisted,13856,1,0,1
2021,Enlisted,13905,25,4,21
2021,Enlisted,14048,3,1,2
2021,Enlisted,14094,18,4,14
2021,Enlisted,14204,60,11,49
2021,Enlisted,14213,41,5,36
2021,Enlisted,14304,8,1,7
2021,Enlisted,14454,25,8,17
2021,Enlisted,14456,19,7,12
2021,Enlisted,14624,79,14,65
2021,Enlisted,14701,10,1,9
2021,Enlisted,14760,8,0,8
2021,Enlisted,14843,5,1,4
2021,Enlisted,14845,19,3,16
2021,Enlisted,14850,21,9,12
2021,Enlisted,15010,13,1,12
2021,Enlisted,15216,28,4,24
2021,Enlisted,15301,26,6,20
2021,Enlisted,15370,25,7,18
2021,Enlisted,15425,7,0,7
2021,Enlisted,15444,9,0,9
2021,Enlisted,15537,5,1,4
2021,Enlisted,15541,10,0,10
2021,Enlisted,15601,6,0,6
2021,Enlisted,15666,20,6,14
2021,Enlisted,15701,28,2,26
2021,Enlisted,15767,14,4,10
2021,Enlisted,15779,7,1,6
2021,Enlisted,15902,9,1,8
2021,Enlisted,15904,56,7,49
2021,Enlisted,16001,39,10,29
2021,Enlisted,16101,22,7,15
2021,Enlisted,16127,12,1,11
2021,Enlisted,16148,8,1,7
2021,Enlisted,16226,6,0,6
2021,Enlisted,16403,62,11,51
2021,Enlisted,16635,10,1,9
2021,Enlisted,16652,8,2,6
2021,Enlisted,16738,13,2,11
2021,Enlisted,16803,15,4,11
2021,Enlisted,16830,8,0,8
2021,Enlisted,16901,1,1,0
2021,Enlisted,17003,244,39,205
2021,Enlisted,17013,29,5,24
2021,Enlisted,17022,39,6,33
2021,Enlisted,17033,21,0,21
2021,Enlisted,17042,34,1,33
2021,Enlisted,17044,31,7,24
2021,Enlisted,17098,6,2,4
2021,Enlisted,17103,55,9,46
2021,Enlisted,17201,15,3,12
2021,Enlisted,17222,9,0,9
2021,Enlisted,17325,10,2,8
2021,Enlisted,17331,8,1,7
2021,Enlisted,17408,2,0,2
2021,Enlisted,17701,14,3,11
2021,Enlisted,17745,7,1,6
2021,Enlisted,17821,21,1,20
2021,Enlisted,17837,10,3,7
2021,Enlisted,18040,17,2,15
2021,Enlisted,18102,8,2,6
2021,Enlisted,18201,16,1,15
2021,Enlisted,18235,6,0,6
2021,Enlisted,18252,20,4,16
2021,Enlisted,18407,8,2,6
2021,Enlisted,18431,8,2,6
2021,Enlisted,18466,15,0,15
2021,Enlisted,18509,58,7,51
2021,Enlisted,18634,6,1,5
2021,Enlisted,18651,9,0,9
2021,Enlisted,18704,38,2,36
2021,Enlisted,18834,3,0,3
2021,Enlisted,18960,7,1,6
2021,Enlisted,19044,64,6,58
2021,Enlisted,19103,7,3,4
2021,Enlisted,19104,18,5,13
2021,Enlisted,19153,32,4,28
2021,Enlisted,19154,161,23,138
2021,Enlisted,19320,34,11,23
2021,Enlisted,19460,4,1,3
2021,Enlisted,19462,22,5,17
2021,Enlisted,19475,22,4,18
2021,Enlisted,19526,17,2,15
2021,Enlisted,19530,30,3,27
2021,Enlisted,19605,21,4,17
2021,Enlisted,19706,29,0,29
2021,Enlisted,19711,12,3,9
2021,Enlisted,19720,9,1,8
2021,Enlisted,19804,23,0,23
2021,Enlisted,19808,2,2,0
2021,Enlisted,19930,2,1,1
2021,Enlisted,19939,15,0,15
2021,Enlisted,19947,9,1,8
2021,Enlisted,19973,34,3,31
2021,Enlisted,19977,4,3,1
2021,Enlisted,20003,33,17,16
2021,Enlisted,20112,43,12,31
2021,Enlisted,20175,20,7,13
2021,Enlisted,20186,10,7,3
2021,Enlisted,20373,26,6,20
2021,Enlisted,20623,16,5,11
2021,Enlisted,20646,14,3,11
2021,Enlisted,20653,6,3,3
2021,Enlisted,20708,30,11,19
2021,Enlisted,20882,12,3,9
2021,Enlisted,20904,12,5,7
2021,Enlisted,21010,73,19,54
2021,Enlisted,21043,16,1,15
2021,Enlisted,21057,8,1,7
2021,Enlisted,21061,25,12,13
2021,Enlisted,21078,22,2,20
2021,Enlisted,21136,54,13,41
2021,Enlisted,21157,16,1,15
2021,Enlisted,21204,8,3,5
2021,Enlisted,21216,15,3,12
2021,Enlisted,21222,20,7,13
2021,Enlisted,21228,17,5,12
2021,Enlisted,21236,8,2,6
2021,Enlisted,21401,8,3,5
2021,Enlisted,21601,14,9,5
2021,Enlisted,21701,16,4,12
2021,Enlisted,21740,5,0,5
2021,Enlisted,21801,12,2,10
2021,Enlisted,22032,16,6,10
2021,Enlisted,22060,51,16,35
2021,Enlisted,22401,51,11,40
2021,Enlisted,22427,25,5,20
2021,Enlisted,22601,7,0,7
2021,Enlisted,22602,21,3,18
2021,Enlisted,22664,7,4,3
2021,Enlisted,22801,13,2,11
2021,Enlisted,22902,15,10,5
2021,Enlisted,23139,15,4,11
2021,Enlisted,23150,54,12,42
2021,Enlisted,23181,27,8,19
2021,Enlisted,23237,12,3,9
2021,Enlisted,23434,20,6,14
2021,Enlisted,23451,95,39,56
2021,Enlisted,23502,41,11,30
2021,Enlisted,23609,18,5,13
2021,Enlisted,23666,21,4,17
2021,Enlisted,23701,23,4,19
2021,Enlisted,23805,15,7,8
2021,Enlisted,23824,33,12,21
2021,Enlisted,23847,6,1,5
2021,Enlisted,23901,10,2,8
2021,Enlisted,24073,24,6,18
2021,Enlisted,24151,20,1,19
2021,Enlisted,24175,9,1,8
2021,Enlisted,24212,4,0,4
2021,Enlisted,24251,28,7,21
2021,Enlisted,24301,13,5,8
2021,Enlisted,24401,7,2,5
2021,Enlisted,24450,5,2,3
2021,Enlisted,24502,36,7,29
2021,Enlisted,24523,7,2,5
2021,Enlisted,24540,17,3,14
2021,Enlisted,24592,10,2,8
2021,Enlisted,24609,10,0,10
2021,Enlisted,24701,8,1,7
2021,Enlisted,24957,10,1,9
2021,Enlisted,25168,41,4,37
2021,Enlisted,25262,10,1,9
2021,Enlisted,25309,8,0,8
2021,Enlisted,25311,59,58,1
2021,Enlisted,25401,18,1,17
2021,Enlisted,25405,20,5,15
2021,Enlisted,25530,32,11,21
2021,Enlisted,25550,7,1,6
2021,Enlisted,25625,11,1,10
2021,Enlisted,25846,47,6,41
2021,Enlisted,26003,15,2,13
2021,Enlisted,26041,15,4,11
2021,Enlisted,26101,18,1,17
2021,Enlisted,26187,17,5,12
2021,Enlisted,26201,20,8,12
2021,Enlisted,26250,13,3,10
2021,Enlisted,26301,17,2,15
2021,Enlisted,26505,18,1,17
2021,Enlisted,26526,1,0,1
2021,Enlisted,26537,28,15,13
2021,Enlisted,26554,17,7,10
2021,Enlisted,26624,3,3,0
2021,Enlisted,26651,11,0,11
2021,Enlisted,26836,15,3,12
2021,Enlisted,27028,4,0,4
2021,Enlisted,27030,3,0,3
2021,Enlisted,27103,35,10,25
2021,Enlisted,27203,4,1,3
2021,Enlisted,27217,17,7,10
2021,Enlisted,27260,28,9,19
2021,Enlisted,27292,10,2,8
2021,Enlisted,27320,22,6,16
2021,Enlisted,27330,8,5,3
2021,Enlisted,27344,11,2,9
2021,Enlisted,27360,6,2,4
2021,Enlisted,27401,23,6,17
2021,Enlisted,27504,15,8,7
2021,Enlisted,27509,11,5,6
2021,Enlisted,27530,15,5,10
2021,Enlisted,27549,7,2,5
2021,Enlisted,27560,85,23,62
2021,Enlisted,27577,30,18,12
2021,Enlisted,27581,2,1,1
2021,Enlisted,27596,12,3,9
2021,Enlisted,27607,23,10,13
2021,Enlisted,27704,55,12,43
2021,Enlisted,27830,4,0,4
2021,Enlisted,27856,2,1,1
2021,Enlisted,27870,24,19,5
2021,Enlisted,27889,4,4,0
2021,Enlisted,27892,4,1,3
2021,Enlisted,28001,8,6,2
2021,Enlisted,28012,6,3,3
2021,Enlisted,28027,16,5,11
2021,Enlisted,28043,6,2,4
2021,Enlisted,28054,15,3,12
2021,Enlisted,28086,13,6,7
2021,Enlisted,28092,8,3,5
2021,Enlisted,28110,12,3,9
2021,Enlisted,28115,7,4,3
2021,Enlisted,28147,21,9,12
2021,Enlisted,28170,15,3,12
2021,Enlisted,28208,35,7,28
2021,Enlisted,28306,36,19,17
2021,Enlisted,28310,22,7,15
2021,Enlisted,28328,12,6,6
2021,Enlisted,28334,17,4,13
2021,Enlisted,28337,6,5,1
2021,Enlisted,28345,10,3,7
2021,Enlisted,28352,14,4,10
2021,Enlisted,28358,6,3,3
2021,Enlisted,28371,10,4,6
2021,Enlisted,28376,13,5,8
2021,Enlisted,28377,12,8,4
2021,Enlisted,28379,12,8,4
2021,Enlisted,28382,10,4,6
2021,Enlisted,28384,11,4,7
2021,Enlisted,28387,1,0,1
2021,Enlisted,28401,7,2,5
2021,Enlisted,28405,17,7,10
2021,Enlisted,28459,8,4,4
2021,Enlisted,28472,31,19,12
2021,Enlisted,28504,6,4,2
2021,Enlisted,28518,3,0,3
2021,Enlisted,28540,27,16,11
2021,Enlisted,28557,10,5,5
2021,Enlisted,28560,17,5,12
2021,Enlisted,28590,27,3,24
2021,Enlisted,28601,7,2,5
2021,Enlisted,28607,4,2,2
2021,Enlisted,28621,1,0,1
2021,Enlisted,28640,3,2,1
2021,Enlisted,28645,9,3,6
2021,Enlisted,28655,2,1,1
2021,Enlisted,28658,1,0,1
2021,Enlisted,28659,7,1,6
2021,Enlisted,28677,10,0,10
2021,Enlisted,28681,8,1,7
2021,Enlisted,28726,2,0,2
2021,Enlisted,28734,23,5,18
2021,Enlisted,28752,3,0,3
2021,Enlisted,28779,6,1,5
2021,Enlisted,28806,8,1,7
2021,Enlisted,29006,12,1,11
2021,Enlisted,29020,13,0,13
2021,Enlisted,29044,137,22,115
2021,Enlisted,29102,4,0,4
2021,Enlisted,29108,24,2,22
2021,Enlisted,29115,9,0,9
2021,Enlisted,29138,7,1,6
2021,Enlisted,29153,12,2,10
2021,Enlisted,29161,19,4,15
2021,Enlisted,29170,26,1,25
2021,Enlisted,29201,99,0,99
2021,Enlisted,29303,6,1,5
2021,Enlisted,29325,11,1,10
2021,Enlisted,29341,5,2,3
2021,Enlisted,29360,26,5,21
2021,Enlisted,29379,43,9,34
2021,Enlisted,29385,21,3,18
2021,Enlisted,29409,35,8,27
2021,Enlisted,29418,32,6,26
2021,Enlisted,29440,7,1,6
2021,Enlisted,29461,20,4,16
2021,Enlisted,29464,24,8,16
2021,Enlisted,29488,18,5,13
2021,Enlisted,29506,4,0,4
2021,Enlisted,29510,3,1,2
2021,Enlisted,29512,20,2,18
2021,Enlisted,29526,3,0,3
2021,Enlisted,29532,11,1,10
2021,Enlisted,29536,4,1,3
2021,Enlisted,29550,14,3,11
2021,Enlisted,29554,7,0,7
2021,Enlisted,29556,13,0,13
2021,Enlisted,29571,11,3,8
2021,Enlisted,29574,16,5,11
2021,Enlisted,29577,4,0,4
2021,Enlisted,29605,12,3,9
2021,Enlisted,29620,16,1,15
2021,Enlisted,29625,30,7,23
2021,Enlisted,29631,15,2,13
2021,Enlisted,29640,6,0,6
2021,Enlisted,29644,25,6,19
2021,Enlisted,29646,7,2,5
2021,Enlisted,29651,17,3,14
2021,Enlisted,29653,12,2,10
2021,Enlisted,29678,5,2,3
2021,Enlisted,29706,2,0,2
2021,Enlisted,29715,3,0,3
2021,Enlisted,29720,13,2,11
2021,Enlisted,29732,13,2,11
2021,Enlisted,29810,13,1,12
2021,Enlisted,29812,4,2,2
2021,Enlisted,29824,12,1,11
2021,Enlisted,29829,29,2,27
2021,Enlisted,29845,3,0,3
2021,Enlisted,29906,24,4,20
2021,Enlisted,29944,5,2,3
2021,Enlisted,30014,31,7,24
2021,Enlisted,30032,3,2,1
2021,Enlisted,30040,100,21,79
2021,Enlisted,30046,27,3,24
2021,Enlisted,30060,351,246,105
2021,Enlisted,30069,35,8,27
2021,Enlisted,30114,18,3,15
2021,Enlisted,30125,13,0,13
2021,Enlisted,30134,15,4,11
2021,Enlisted,30144,18,2,16
2021,Enlisted,30161,31,4,27
2021,Enlisted,30224,13,3,10
2021,Enlisted,30233,15,3,12
2021,Enlisted,30240,22,3,19
2021,Enlisted,30263,26,11,15
2021,Enlisted,30294,16,4,12
2021,Enlisted,30297,45,13,32
2021,Enlisted,30336,70,13,57
2021,Enlisted,30401,13,1,12
2021,Enlisted,30427,16,6,10
2021,Enlisted,30439,20,4,16
2021,Enlisted,30458,4,1,3
2021,Enlisted,30461,8,1,7
2021,Enlisted,30501,17,8,9
2021,Enlisted,30577,17,4,13
2021,Enlisted,30597,1,0,1
2021,Enlisted,30635,7,0,7
2021,Enlisted,30643,7,1,6
2021,Enlisted,30655,14,2,12
2021,Enlisted,30673,15,1,14
2021,Enlisted,30680,50,15,35
2021,Enlisted,30701,25,4,21
2021,Enlisted,30720,9,4,5
2021,Enlisted,30824,10,3,7
2021,Enlisted,30830,3,2,1
2021,Enlisted,30904,41,7,34
2021,Enlisted,30905,33,2,31
2021,Enlisted,31015,11,3,8
2021,Enlisted,31029,31,7,24
2021,Enlisted,31040,20,6,14
2021,Enlisted,31061,47,3,44
2021,Enlisted,31211,60,20,40
2021,Enlisted,31313,33,8,25
2021,Enlisted,31314,45,14,31
2021,Enlisted,31329,15,2,13
2021,Enlisted,31406,73,22,51
2021,Enlisted,31409,29,6,23
2021,Enlisted,31520,6,1,5
2021,Enlisted,31533,23,3,20
2021,Enlisted,31601,10,2,8
2021,Enlisted,31704,14,2,12
2021,Enlisted,31792,45,2,43
2021,Enlisted,31794,12,5,7
2021,Enlisted,31901,3,2,1
2021,Enlisted,31905,35,9,26
2021,Enlisted,32055,17,6,11
2021,Enlisted,32064,26,6,20
2021,Enlisted,32084,21,6,15
2021,Enlisted,32086,8,8,0
2021,Enlisted,32091,156,52,104
2021,Enlisted,32164,26,13,13
2021,Enlisted,32177,6,0,6
2021,Enlisted,32221,96,23,73
2021,Enlisted,32311,32,14,18
2021,Enlisted,32351,20,3,17
2021,Enlisted,32405,17,4,13
2021,Enlisted,32425,22,4,18
2021,Enlisted,32428,17,1,16
2021,Enlisted,32446,24,3,21
2021,Enlisted,32514,31,10,21
2021,Enlisted,32539,12,2,10
2021,Enlisted,32609,9,8,1
2021,Enlisted,32721,4,1,3
2021,Enlisted,32724,8,0,8
2021,Enlisted,32726,17,6,11
2021,Enlisted,32771,31,9,22
2021,Enlisted,32806,42,25,17
2021,Enlisted,32862,14,8,6
2021,Enlisted,32922,27,22,5
2021,Enlisted,32935,29,9,20
2021,Enlisted,33027,163,30,133
2021,Enlisted,33039,15,3,12
2021,Enlisted,33127,23,3,20
2021,Enlisted,33315,19,2,17
2021,Enlisted,33401,7,2,5
2021,Enlisted,33405,75,15,60
2021,Enlisted,33406,3,0,3
2021,Enlisted,33523,13,2,11
2021,Enlisted,33563,46,8,38
2021,Enlisted,33606,28,2,26
2021,Enlisted,33711,16,4,12
2021,Enlisted,33782,101,31,70
2021,Enlisted,33811,25,5,20
2021,Enlisted,33825,9,1,8
2021,Enlisted,33830,18,4,14
2021,Enlisted,33844,18,8,10
2021,Enlisted,33859,19,6,13
2021,Enlisted,33873,3,3,0
2021,Enlisted,33880,18,6,12
2021,Enlisted,33916,7,1,6
2021,Enlisted,34208,16,5,11
2021,Enlisted,34221,2,1,1
2021,Enlisted,34237,12,0,12
2021,Enlisted,34266,26,7,19
2021,Enlisted,34429,27,6,21
2021,Enlisted,34474,44,18,26
2021,Enlisted,34604,10,3,7
2021,Enlisted,34748,24,13,11
2021,Enlisted,34947,13,5,8
2021,Enlisted,35010,26,3,23
2021,Enlisted,35016,2,0,2
2021,Enlisted,35040,10,3,7
2021,Enlisted,35042,25,3,22
2021,Enlisted,35045,11,3,8
2021,Enlisted,35055,23,7,16
2021,Enlisted,35121,32,4,28
2021,Enlisted,35124,26,8,18
2021,Enlisted,35146,20,3,17
2021,Enlisted,35160,20,6,14
2021,Enlisted,35178,15,4,11
2021,Enlisted,35209,17,3,14
2021,Enlisted,35217,65,20,45
2021,Enlisted,35259,3,1,2
2021,Enlisted,35405,40,5,35
2021,Enlisted,35476,10,2,8
2021,Enlisted,35501,3,0,3
2021,Enlisted,35555,35,2,33
2021,Enlisted,35565,47,10,37
2021,Enlisted,35601,49,9,40
2021,Enlisted,35613,6,1,5
2021,Enlisted,35630,12,1,11
2021,Enlisted,35803,32,7,25
2021,Enlisted,35805,25,5,20
2021,Enlisted,35904,51,11,40
2021,Enlisted,35967,12,3,9
2021,Enlisted,36016,37,4,33
2021,Enlisted,36027,9,1,8
2021,Enlisted,36043,43,8,35
2021,Enlisted,36067,6,3,3
2021,Enlisted,36078,18,1,17
2021,Enlisted,36081,24,3,21
2021,Enlisted,36083,5,1,4
2021,Enlisted,36109,270,243,27
2021,Enlisted,36117,33,1,32
2021,Enlisted,36203,10,0,10
2021,Enlisted,36205,37,5,32
2021,Enlisted,36250,6,1,5
2021,Enlisted,36265,36,5,31
2021,Enlisted,36301,22,5,17
2021,Enlisted,36322,2,0,2
2021,Enlisted,36323,12,3,9
2021,Enlisted,36330,27,2,25
2021,Enlisted,36340,15,4,11
2021,Enlisted,36420,4,0,4
2021,Enlisted,36426,8,0,8
2021,Enlisted,36442,2,0,2
2021,Enlisted,36522,29,3,26
2021,Enlisted,36532,19,5,14
2021,Enlisted,36535,17,3,14
2021,Enlisted,36605,61,15,46
2021,Enlisted,36608,3,1,2
2021,Enlisted,36701,1,1,0
2021,Enlisted,36801,9,3,6
2021,Enlisted,36832,10,5,5
2021,Enlisted,36854,13,0,13
2021,Enlisted,36867,8,3,5
2021,Enlisted,37015,12,4,8
2021,Enlisted,37033,7,0,7
2021,Enlisted,37042,8,6,2
2021,Enlisted,37055,13,2,11
2021,Enlisted,37066,10,6,4
2021,Enlisted,37083,5,3,2
2021,Enlisted,37090,15,3,12
2021,Enlisted,37091,4,2,2
2021,Enlisted,37097,3,2,1
2021,Enlisted,37110,17,5,12
2021,Enlisted,37129,24,4,20
2021,Enlisted,37160,3,1,2
2021,Enlisted,37167,51,11,40
2021,Enlisted,37172,12,6,6
2021,Enlisted,37178,7,5,2
2021,Enlisted,37185,2,0,2
2021,Enlisted,37204,128,81,47
2021,Enlisted,37217,28,2,26
2021,Enlisted,37306,3,0,3
2021,Enlisted,37321,9,2,7
2021,Enlisted,37323,8,1,7
2021,Enlisted,37327,15,2,13
2021,Enlisted,37334,2,0,2
2021,Enlisted,37356,5,1,4
2021,Enlisted,37388,18,6,12
2021,Enlisted,37398,22,5,17
2021,Enlisted,37404,13,2,11
2021,Enlisted,37615,3,1,2
2021,Enlisted,37620,5,0,5
2021,Enlisted,37643,6,3,3
2021,Enlisted,37645,10,1,9
2021,Enlisted,37650,3,1,2
2021,Enlisted,37717,4,0,4
2021,Enlisted,37743,9,2,7
2021,Enlisted,37757,7,1,6
2021,Enlisted,37760,5,1,4
2021,Enlisted,37771,15,2,13
2021,Enlisted,37777,26,9,17
2021,Enlisted,37801,4,2,2
2021,Enlisted,37821,17,3,14
2021,Enlisted,37825,5,0,5
2021,Enlisted,37841,1,0,1
2021,Enlisted,37854,4,1,3
2021,Enlisted,37857,4,0,4
2021,Enlisted,37860,10,2,8
2021,Enlisted,37863,7,4,3
2021,Enlisted,37874,19,7,12
2021,Enlisted,37919,24,8,16
2021,Enlisted,38001,11,0,11
2021,Enlisted,38008,2,1,1
2021,Enlisted,38012,7,2,5
2021,Enlisted,38019,10,2,8
2021,Enlisted,38024,3,0,3
2021,Enlisted,38053,8,2,6
2021,Enlisted,38063,1,0,1
2021,Enlisted,38079,2,0,2
2021,Enlisted,38118,31,5,26
2021,Enlisted,38210,14,3,11
2021,Enlisted,38242,15,5,10
2021,Enlisted,38261,6,0,6
2021,Enlisted,38301,19,5,14
2021,Enlisted,38305,21,0,21
2021,Enlisted,38320,8,1,7
2021,Enlisted,38340,14,0,14
2021,Enlisted,38343,7,3,4
2021,Enlisted,38344,7,2,5
2021,Enlisted,38351,8,3,5
2021,Enlisted,38358,14,3,11
2021,Enlisted,38372,4,0,4
2021,Enlisted,38375,17,5,12
2021,Enlisted,38382,13,2,11
2021,Enlisted,38401,6,1,5
2021,Enlisted,38462,4,0,4
2021,Enlisted,38464,1,0,1
2021,Enlisted,38478,1,0,1
2021,Enlisted,38485,4,0,4
2021,Enlisted,38506,25,3,22
2021,Enlisted,38556,7,2,5
2021,Enlisted,38563,2,0,2
2021,Enlisted,38570,8,2,6
2021,Enlisted,38572,9,2,7
2021,Enlisted,38583,13,6,7
2021,Enlisted,38606,1,1,0
2021,Enlisted,38614,1,0,1
2021,Enlisted,38632,21,6,15
2021,Enlisted,38635,2,0,2
2021,Enlisted,38655,13,1,12
2021,Enlisted,38663,2,0,2
2021,Enlisted,38668,17,3,14
2021,Enlisted,38671,21,5,16
2021,Enlisted,38703,17,1,16
2021,Enlisted,38732,12,0,12
2021,Enlisted,38751,3,1,2
2021,Enlisted,38801,28,9,19
2021,Enlisted,38821,11,0,11
2021,Enlisted,38829,7,0,7
2021,Enlisted,38834,6,0,6
2021,Enlisted,38843,1,0,1
2021,Enlisted,38851,13,0,13
2021,Enlisted,38860,2,0,2
2021,Enlisted,38863,10,0,10
2021,Enlisted,38901,12,5,7
2021,Enlisted,38915,13,1,12
2021,Enlisted,38916,13,2,11
2021,Enlisted,38930,14,2,12
2021,Enlisted,38967,3,1,2
2021,Enlisted,39042,18,1,17
2021,Enlisted,39046,18,2,16
2021,Enlisted,39051,7,1,6
2021,Enlisted,39056,16,4,12
2021,Enlisted,39059,16,2,14
2021,Enlisted,39090,4,0,4
2021,Enlisted,39111,18,1,17
2021,Enlisted,39117,5,0,5
2021,Enlisted,39120,6,0,6
2021,Enlisted,39183,9,0,9
2021,Enlisted,39194,2,0,2
2021,Enlisted,39202,67,66,1
2021,Enlisted,39204,25,5,20
2021,Enlisted,39209,25,3,22
2021,Enlisted,39216,9,5,4
2021,Enlisted,39232,1,1,0
2021,Enlisted,39307,13,4,9
2021,Enlisted,39339,5,1,4
2021,Enlisted,39345,16,1,15
2021,Enlisted,39350,14,1,13
2021,Enlisted,39401,25,1,24
2021,Enlisted,39407,21,7,14
2021,Enlisted,39422,1,1,0
2021,Enlisted,39429,11,1,10
2021,Enlisted,39440,11,0,11
2021,Enlisted,39452,6,0,6
2021,Enlisted,39466,21,3,18
2021,Enlisted,39470,18,7,11
2021,Enlisted,39505,23,5,18
2021,Enlisted,39507,22,1,21
2021,Enlisted,39532,17,2,15
2021,Enlisted,39556,8,1,7
2021,Enlisted,39567,16,3,13
2021,Enlisted,39577,11,1,10
2021,Enlisted,39601,14,2,12
2021,Enlisted,39648,7,0,7
2021,Enlisted,39654,5,0,5
2021,Enlisted,39704,12,3,9
2021,Enlisted,39730,6,0,6
2021,Enlisted,39735,1,1,0
2021,Enlisted,39744,4,0,4
2021,Enlisted,39759,11,4,7
2021,Enlisted,39773,2,1,1
2021,Enlisted,40004,30,3,27
2021,Enlisted,40065,13,3,10
2021,Enlisted,40108,23,6,17
2021,Enlisted,40205,35,14,21
2021,Enlisted,40218,45,12,33
2021,Enlisted,40311,23,5,18
2021,Enlisted,40330,7,0,7
2021,Enlisted,40351,21,0,21
2021,Enlisted,40422,6,2,4
2021,Enlisted,40472,31,10,21
2021,Enlisted,40475,55,11,44
2021,Enlisted,40510,27,5,22
2021,Enlisted,40601,78,19,59
2021,Enlisted,40741,10,2,8
2021,Enlisted,40769,6,2,4
2021,Enlisted,40840,15,7,8
2021,Enlisted,40906,14,1,13
2021,Enlisted,40965,22,3,19
2021,Enlisted,41005,54,5,49
2021,Enlisted,41008,19,0,19
2021,Enlisted,41031,6,4,2
2021,Enlisted,41094,13,3,10
2021,Enlisted,41101,15,2,13
2021,Enlisted,41164,12,2,10
2021,Enlisted,41339,17,6,11
2021,Enlisted,41653,11,3,8
2021,Enlisted,41701,6,6,0
2021,Enlisted,42025,1,1,0
2021,Enlisted,42086,16,6,10
2021,Enlisted,42101,9,1,8
2021,Enlisted,42141,9,2,7
2021,Enlisted,42167,14,4,10
2021,Enlisted,42240,13,2,11
2021,Enlisted,42276,10,0,10
2021,Enlisted,42301,19,4,15
2021,Enlisted,42330,22,3,19
2021,Enlisted,42345,20,5,15
2021,Enlisted,42431,9,3,6
2021,Enlisted,42501,15,5,10
2021,Enlisted,42633,9,1,8
2021,Enlisted,42701,19,2,17
2021,Enlisted,42718,8,0,8
2021,Enlisted,42754,19,4,15
2021,Enlisted,43015,23,3,20
2021,Enlisted,43040,8,0,8
2021,Enlisted,43055,23,3,20
2021,Enlisted,43102,21,1,20
2021,Enlisted,43213,69,10,59
2021,Enlisted,43215,15,0,15
2021,Enlisted,43217,71,16,55
2021,Enlisted,43235,1,1,0
2021,Enlisted,43402,21,6,15
2021,Enlisted,43465,71,17,54
2021,Enlisted,43614,37,3,34
2021,Enlisted,43720,3,2,1
2021,Enlisted,43756,23,8,15
2021,Enlisted,43812,11,0,11
2021,Enlisted,44023,28,0,28
2021,Enlisted,44055,15,1,14
2021,Enlisted,44128,18,1,17
2021,Enlisted,44142,15,4,11
2021,Enlisted,44224,54,10,44
2021,Enlisted,44256,18,2,16
2021,Enlisted,44313,17,1,16
2021,Enlisted,44444,32,4,28
2021,Enlisted,44515,32,4,28
2021,Enlisted,44601,18,5,13
2021,Enlisted,44622,6,0,6
2021,Enlisted,44691,17,4,13
2021,Enlisted,44720,99,10,89
2021,Enlisted,44857,15,1,14
2021,Enlisted,44870,15,6,9
2021,Enlisted,44883,43,17,26
2021,Enlisted,44903,32,4,28
2021,Enlisted,45015,35,9,26
2021,Enlisted,45035,15,4,11
2021,Enlisted,45044,26,3,23
2021,Enlisted,45215,43,4,39
2021,Enlisted,45331,23,5,18
2021,Enlisted,45356,29,1,28
2021,Enlisted,45385,13,3,10
2021,Enlisted,45430,31,0,31
2021,Enlisted,45502,40,8,32
2021,Enlisted,45601,35,5,30
2021,Enlisted,45662,14,2,12
2021,Enlisted,45804,29,6,23
2021,Enlisted,46012,7,1,6
2021,Enlisted,46036,2,0,2
2021,Enlisted,46041,9,1,8
2021,Enlisted,46052,16,6,10
2021,Enlisted,46122,19,3,16
2021,Enlisted,46124,46,9,37
2021,Enlisted,46131,123,14,109
2021,Enlisted,46135,13,2,11
2021,Enlisted,46140,14,8,6
2021,Enlisted,46151,17,5,12
2021,Enlisted,46176,48,7,41
2021,Enlisted,46208,6,3,3
2021,Enlisted,46216,43,12,31
2021,Enlisted,46241,182,37,145
2021,Enlisted,46323,8,0,8
2021,Enlisted,46350,17,0,17
2021,Enlisted,46360,3,0,3
2021,Enlisted,46383,18,0,18
2021,Enlisted,46402,19,3,16
2021,Enlisted,46406,46,16,30
2021,Enlisted,46517,18,2,16
2021,Enlisted,46563,18,1,17
2021,Enlisted,46582,15,3,12
2021,Enlisted,46613,34,5,29
2021,Enlisted,46703,3,1,2
2021,Enlisted,46714,3,1,2
2021,Enlisted,46750,7,4,3
2021,Enlisted,46825,56,12,44
2021,Enlisted,46901,8,0,8
2021,Enlisted,46947,14,3,11
2021,Enlisted,46953,5,1,4
2021,Enlisted,46970,3,1,2
2021,Enlisted,47150,11,1,10
2021,Enlisted,47167,5,1,4
2021,Enlisted,47170,9,4,5
2021,Enlisted,47203,34,7,27
2021,Enlisted,47250,21,5,16
2021,Enlisted,47265,10,0,10
2021,Enlisted,47274,42,7,35
2021,Enlisted,47303,22,2,20
2021,Enlisted,47331,20,3,17
2021,Enlisted,47348,6,2,4
2021,Enlisted,47374,10,2,8
2021,Enlisted,47394,19,4,15
2021,Enlisted,47401,33,3,30
2021,Enlisted,47421,8,0,8
2021,Enlisted,47441,22,4,18
2021,Enlisted,47501,11,3,8
2021,Enlisted,47546,19,2,17
2021,Enlisted,47591,4,0,4
2021,Enlisted,47715,43,10,33
2021,Enlisted,47804,13,3,10
2021,Enlisted,47834,10,0,10
2021,Enlisted,47872,14,2,12
2021,Enlisted,47904,16,2,14
2021,Enlisted,47905,29,5,24
2021,Enlisted,47933,13,3,10
2021,Enlisted,47960,30,6,24
2021,Enlisted,47977,13,2,11
2021,Enlisted,47978,3,1,2
2021,Enlisted,48060,10,3,7
2021,Enlisted,48180,40,7,33
2021,Enlisted,48197,44,14,30
2021,Enlisted,48208,52,10,42
2021,Enlisted,48234,75,24,51
2021,Enlisted,48341,36,6,30
2021,Enlisted,48446,6,1,5
2021,Enlisted,48601,33,13,20
2021,Enlisted,48642,16,4,12
2021,Enlisted,48706,21,0,21
2021,Enlisted,48801,7,0,7
2021,Enlisted,48817,40,4,36
2021,Enlisted,48837,57,14,43
2021,Enlisted,48838,11,5,6
2021,Enlisted,48843,10,2,8
2021,Enlisted,48906,64,18,46
2021,Enlisted,48912,11,3,8
2021,Enlisted,49009,24,5,19
2021,Enlisted,49012,66,15,51
2021,Enlisted,49047,28,7,21
2021,Enlisted,49201,17,4,13
2021,Enlisted,49224,5,3,2
2021,Enlisted,49306,2,2,0
2021,Enlisted,49307,9,3,6
2021,Enlisted,49437,13,2,11
2021,Enlisted,49509,86,28,58
2021,Enlisted,49601,11,2,9
2021,Enlisted,49696,10,2,8
2021,Enlisted,49707,4,1,3
2021,Enlisted,49739,18,10,8
2021,Enlisted,49783,15,1,14
2021,Enlisted,49801,6,2,4
2021,Enlisted,49837,7,3,4
2021,Enlisted,49849,10,1,9
2021,Enlisted,49855,9,2,7
2021,Enlisted,49913,7,1,6
2021,Enlisted,50025,6,1,5
2021,Enlisted,50036,45,9,36
2021,Enlisted,50126,13,3,10
2021,Enlisted,50131,253,32,221
2021,Enlisted,50138,9,1,8
2021,Enlisted,50158,12,2,10
2021,Enlisted,50220,16,4,12
2021,Enlisted,50401,14,2,12
2021,Enlisted,50501,9,3,6
2021,Enlisted,50588,23,5,18
2021,Enlisted,50616,4,0,4
2021,Enlisted,50662,11,2,9
2021,Enlisted,50703,62,6,56
2021,Enlisted,50709,3,1,2
2021,Enlisted,51031,9,3,6
2021,Enlisted,51111,33,7,26
2021,Enlisted,51201,13,2,11
2021,Enlisted,51301,8,0,8
2021,Enlisted,51334,12,1,11
2021,Enlisted,51401,7,2,5
2021,Enlisted,51442,8,2,6
2021,Enlisted,51503,30,9,21
2021,Enlisted,51566,19,4,15
2021,Enlisted,51601,2,1,1
2021,Enlisted,52001,8,2,6
2021,Enlisted,52002,5,0,5
2021,Enlisted,52246,55,8,47
2021,Enlisted,52353,7,0,7
2021,Enlisted,52404,43,3,40
2021,Enlisted,52501,31,2,29
2021,Enlisted,52556,11,1,10
2021,Enlisted,52632,11,4,7
2021,Enlisted,52638,14,2,12
2021,Enlisted,52641,8,2,6
2021,Enlisted,52732,5,1,4
2021,Enlisted,52761,7,1,6
2021,Enlisted,52806,64,8,56
2021,Enlisted,53066,11,1,10
2021,Enlisted,53073,3,1,2
2021,Enlisted,53089,17,1,16
2021,Enlisted,53094,20,7,13
2021,Enlisted,53095,14,4,10
2021,Enlisted,53121,8,0,8
2021,Enlisted,53144,23,6,17
2021,Enlisted,53154,6,0,6
2021,Enlisted,53186,17,4,13
2021,Enlisted,53190,11,1,10
2021,Enlisted,53212,32,6,26
2021,Enlisted,53403,12,1,11
2021,Enlisted,53511,8,1,7
2021,Enlisted,53538,14,2,12
2021,Enlisted,53545,5,2,3
2021,Enlisted,53581,13,1,12
2021,Enlisted,53704,80,10,70
2021,Enlisted,53821,12,1,11
2021,Enlisted,53901,8,1,7
2021,Enlisted,53948,14,1,13
2021,Enlisted,53959,12,1,11
2021,Enlisted,53963,5,3,2
2021,Enlisted,54017,4,2,2
2021,Enlisted,54022,4,2,2
2021,Enlisted,54143,5,1,4
2021,Enlisted,54303,25,6,19
2021,Enlisted,54401,4,1,3
2021,Enlisted,54405,8,2,6
2021,Enlisted,54409,17,3,14
2021,Enlisted,54449,12,0,12
2021,Enlisted,54451,18,1,17
2021,Enlisted,54455,14,1,13
2021,Enlisted,54456,13,0,13
2021,Enlisted,54481,11,0,11
2021,Enlisted,54487,2,0,2
2021,Enlisted,54495,11,0,11
2021,Enlisted,54501,12,2,10
2021,Enlisted,54612,6,1,5
2021,Enlisted,54615,6,0,6
2021,Enlisted,54618,15,2,13
2021,Enlisted,54646,9,1,8
2021,Enlisted,54650,10,1,9
2021,Enlisted,54660,12,1,11
2021,Enlisted,54665,5,0,5
2021,Enlisted,54703,16,3,13
2021,Enlisted,54729,10,0,10
2021,Enlisted,54751,10,3,7
2021,Enlisted,54801,10,1,9
2021,Enlisted,54806,10,2,8
2021,Enlisted,54843,11,2,9
2021,Enlisted,54868,8,5,3
2021,Enlisted,54880,17,1,16
2021,Enlisted,54901,22,1,21
2021,Enlisted,54914,16,4,12
2021,Enlisted,54929,18,4,14
2021,Enlisted,54932,3,1,2
2021,Enlisted,54935,22,6,16
2021,Enlisted,54971,20,7,13
2021,Enlisted,54981,16,2,14
2021,Enlisted,55008,23,2,21
2021,Enlisted,55016,33,4,29
2021,Enlisted,55021,22,1,21
2021,Enlisted,55033,15,0,15
2021,Enlisted,55063,17,1,16
2021,Enlisted,55066,19,2,17
2021,Enlisted,55068,23,3,20
2021,Enlisted,55073,27,1,26
2021,Enlisted,55077,11,1,10
2021,Enlisted,55082,85,3,82
2021,Enlisted,55106,14,1,13
2021,Enlisted,55107,24,5,19
2021,Enlisted,55112,116,18,98
2021,Enlisted,55118,20,3,17
2021,Enlisted,55122,22,2,20
2021,Enlisted,55303,22,1,21
2021,Enlisted,55350,15,1,14
2021,Enlisted,55355,16,2,14
2021,Enlisted,55362,35,4,31
2021,Enlisted,55431,16,1,15
2021,Enlisted,55443,9,0,9
2021,Enlisted,55719,16,1,15
2021,Enlisted,55720,11,1,10
2021,Enlisted,55744,3,0,3
2021,Enlisted,55746,26,1,25
2021,Enlisted,55811,55,7,48
2021,Enlisted,55901,23,7,16
2021,Enlisted,55912,36,4,32
2021,Enlisted,55987,21,2,19
2021,Enlisted,56001,33,2,31
2021,Enlisted,56007,14,3,11
2021,Enlisted,56031,22,1,21
2021,Enlisted,56081,12,2,10
2021,Enlisted,56082,22,2,20
2021,Enlisted,56143,11,0,11
2021,Enlisted,56156,7,0,7
2021,Enlisted,56164,5,0,5
2021,Enlisted,56201,8,1,7
2021,Enlisted,56208,10,0,10
2021,Enlisted,56256,13,1,12
2021,Enlisted,56258,13,1,12
2021,Enlisted,56265,11,2,9
2021,Enlisted,56267,12,1,11
2021,Enlisted,56273,22,0,22
2021,Enlisted,56277,14,0,14
2021,Enlisted,56278,12,2,10
2021,Enlisted,56283,6,0,6
2021,Enlisted,56301,9,2,7
2021,Enlisted,56303,10,0,10
2021,Enlisted,56308,17,2,15
2021,Enlisted,56345,122,9,113
2021,Enlisted,56378,9,1,8
2021,Enlisted,56401,19,2,17
2021,Enlisted,56482,16,1,15
2021,Enlisted,56501,14,2,12
2021,Enlisted,56537,16,1,15
2021,Enlisted,56560,26,3,23
2021,Enlisted,56601,14,4,10
2021,Enlisted,56701,5,0,5
2021,Enlisted,56716,16,2,14
2021,Enlisted,57006,1,0,1
2021,Enlisted,57028,3,0,3
2021,Enlisted,57042,9,0,9
2021,Enlisted,57069,7,1,6
2021,Enlisted,57078,10,2,8
2021,Enlisted,57104,36,2,34
2021,Enlisted,57201,21,0,21
2021,Enlisted,57252,3,0,3
2021,Enlisted,57301,21,0,21
2021,Enlisted,57325,5,0,5
2021,Enlisted,57350,3,0,3
2021,Enlisted,57366,11,3,8
2021,Enlisted,57401,10,2,8
2021,Enlisted,57501,24,1,23
2021,Enlisted,57601,9,0,9
2021,Enlisted,57701,9,1,8
2021,Enlisted,57702,28,7,21
2021,Enlisted,57703,10,1,9
2021,Enlisted,57717,10,1,9
2021,Enlisted,57783,7,0,7
2021,Enlisted,57785,5,1,4
2021,Enlisted,58054,5,0,5
2021,Enlisted,58072,9,2,7
2021,Enlisted,58075,15,1,14
2021,Enlisted,58102,57,5,52
2021,Enlisted,58201,46,3,43
2021,Enlisted,58301,43,5,38
2021,Enlisted,58401,22,3,19
2021,Enlisted,58433,10,0,10
2021,Enlisted,58495,3,0,3
2021,Enlisted,58501,52,5,47
2021,Enlisted,58504,2,1,1
2021,Enlisted,58506,11,2,9
2021,Enlisted,58601,10,0,10
2021,Enlisted,58703,25,1,24
2021,Enlisted,58801,11,1,10
2021,Enlisted,59047,17,3,14
2021,Enlisted,59102,50,6,44
2021,Enlisted,59218,8,0,8
2021,Enlisted,59230,3,1,2
2021,Enlisted,59301,9,1,8
2021,Enlisted,59405,8,2,6
2021,Enlisted,59457,3,0,3
2021,Enlisted,59501,5,0,5
2021,Enlisted,59538,10,2,8
2021,Enlisted,59602,30,3,27
2021,Enlisted,59636,32,24,8
2021,Enlisted,59701,1,0,1
2021,Enlisted,59711,5,0,5
2021,Enlisted,59714,25,5,20
2021,Enlisted,59725,5,0,5
2021,Enlisted,59760,6,0,6
2021,Enlisted,59808,33,9,24
2021,Enlisted,59901,24,4,20
2021,Enlisted,59923,3,1,2
2021,Enlisted,60037,30,5,25
2021,Enlisted,60098,9,2,7
2021,Enlisted,60120,22,6,16
2021,Enlisted,60178,8,1,7
2021,Enlisted,60435,17,3,14
2021,Enlisted,60472,75,11,64
2021,Enlisted,60505,6,3,3
2021,Enlisted,60545,23,1,22
2021,Enlisted,60546,64,11,53
2021,Enlisted,60615,84,13,71
2021,Enlisted,60616,20,6,14
2021,Enlisted,60638,1,0,1
2021,Enlisted,60651,29,4,25
2021,Enlisted,60901,44,11,33
2021,Enlisted,61021,26,4,22
2021,Enlisted,61032,27,2,25
2021,Enlisted,61071,29,8,21
2021,Enlisted,61115,66,7,59
2021,Enlisted,61264,30,3,27
2021,Enlisted,61341,26,2,24
2021,Enlisted,61401,27,1,26
2021,Enlisted,61434,9,2,7
2021,Enlisted,61443,13,0,13
2021,Enlisted,61455,22,3,19
2021,Enlisted,61607,76,14,62
2021,Enlisted,61701,25,2,23
2021,Enlisted,61761,16,4,12
2021,Enlisted,61764,9,1,8
2021,Enlisted,61801,19,5,14
2021,Enlisted,61820,15,2,13
2021,Enlisted,61834,15,4,11
2021,Enlisted,61938,20,3,17
2021,Enlisted,61944,21,2,19
2021,Enlisted,61951,10,1,9
2021,Enlisted,62056,28,8,20
2021,Enlisted,62205,22,3,19
2021,Enlisted,62269,17,1,16
2021,Enlisted,62286,68,10,58
2021,Enlisted,62301,13,0,13
2021,Enlisted,62401,20,5,15
2021,Enlisted,62439,18,4,14
2021,Enlisted,62521,45,6,39
2021,Enlisted,62618,6,0,6
2021,Enlisted,62659,8,1,7
2021,Enlisted,62702,100,16,84
2021,Enlisted,62864,25,4,21
2021,Enlisted,62896,13,2,11
2021,Enlisted,62959,26,7,19
2021,Enlisted,62966,18,2,16
2021,Enlisted,63020,14,3,11
2021,Enlisted,63028,31,2,29
2021,Enlisted,63044,77,14,63
2021,Enlisted,63077,13,3,10
2021,Enlisted,63125,75,9,66
2021,Enlisted,63383,4,0,4
2021,Enlisted,63401,10,1,9
2021,Enlisted,63552,30,4,26
2021,Enlisted,63640,23,4,19
2021,Enlisted,63645,1,0,1
2021,Enlisted,63701,13,1,12
2021,Enlisted,63703,19,2,17
2021,Enlisted,63755,19,3,16
2021,Enlisted,63775,22,6,16
2021,Enlisted,63801,9,1,8
2021,Enlisted,63841,15,5,10
2021,Enlisted,63857,17,2,15
2021,Enlisted,63901,8,3,5
2021,Enlisted,64052,11,1,10
2021,Enlisted,64067,23,3,20
2021,Enlisted,64085,29,2,27
2021,Enlisted,64093,23,2,21
2021,Enlisted,64129,97,16,81
2021,Enlisted,64402,8,0,8
2021,Enlisted,64468,10,0,10
2021,Enlisted,64506,22,5,17
2021,Enlisted,64601,16,1,15
2021,Enlisted,64683,18,4,14
2021,Enlisted,64701,15,3,12
2021,Enlisted,64735,17,1,16
2021,Enlisted,64772,8,0,8
2021,Enlisted,64804,18,2,16
2021,Enlisted,64831,4,0,4
2021,Enlisted,64836,25,4,21
2021,Enlisted,64850,2,0,2
2021,Enlisted,65082,2,0,2
2021,Enlisted,65101,12,3,9
2021,Enlisted,65109,28,3,25
2021,Enlisted,65202,16,1,15
2021,Enlisted,65233,11,6,5
2021,Enlisted,65251,13,5,8
2021,Enlisted,65270,15,0,15
2021,Enlisted,65301,8,2,6
2021,Enlisted,65305,32,6,26
2021,Enlisted,65340,33,3,30
2021,Enlisted,65401,8,1,7
2021,Enlisted,65473,21,3,18
2021,Enlisted,65536,1,0,1
2021,Enlisted,65605,13,2,11
2021,Enlisted,65708,15,1,14
2021,Enlisted,65723,32,8,24
2021,Enlisted,65775,14,3,11
2021,Enlisted,65802,51,6,45
2021,Enlisted,65803,51,14,37
2021,Enlisted,66027,18,5,13
2021,Enlisted,66044,16,5,11
2021,Enlisted,66061,23,5,18
2021,Enlisted,66067,11,3,8
2021,Enlisted,66071,5,0,5
2021,Enlisted,66102,16,3,13
2021,Enlisted,66217,7,1,6
2021,Enlisted,66219,22,9,13
2021,Enlisted,66337,10,1,9
2021,Enlisted,66434,7,1,6
2021,Enlisted,66436,4,1,3
2021,Enlisted,66441,17,9,8
2021,Enlisted,66442,16,2,14
2021,Enlisted,66502,52,19,33
2021,Enlisted,66508,7,2,5
2021,Enlisted,66611,2,0,2
2021,Enlisted,66619,90,17,73
2021,Enlisted,66749,25,5,20
2021,Enlisted,66762,23,2,21
2021,Enlisted,66801,8,5,3
2021,Enlisted,66901,7,1,6
2021,Enlisted,66967,11,1,10
2021,Enlisted,67010,13,1,12
2021,Enlisted,67114,8,1,7
2021,Enlisted,67124,11,2,9
2021,Enlisted,67217,16,3,13
2021,Enlisted,67219,68,9,59
2021,Enlisted,67337,3,1,2
2021,Enlisted,67401,9,4,5
2021,Enlisted,67410,7,0,7
2021,Enlisted,67432,3,1,2
2021,Enlisted,67501,20,1,19
2021,Enlisted,67530,35,8,27
2021,Enlisted,67601,10,0,10
2021,Enlisted,67654,3,0,3
2021,Enlisted,67701,5,0,5
2021,Enlisted,67801,2,0,2
2021,Enlisted,67901,6,2,4
2021,Enlisted,68066,15,0,15
2021,Enlisted,68073,81,15,66
2021,Enlisted,68106,5,4,1
2021,Enlisted,68142,13,1,12
2021,Enlisted,68310,8,0,8
2021,Enlisted,68508,12,4,8
2021,Enlisted,68524,66,14,52
2021,Enlisted,68601,6,0,6
2021,Enlisted,68701,17,0,17
2021,Enlisted,68787,7,0,7
2021,Enlisted,68801,33,4,29
2021,Enlisted,68822,5,0,5
2021,Enlisted,68847,19,5,14
2021,Enlisted,68901,30,5,25
2021,Enlisted,69001,2,0,2
2021,Enlisted,69101,7,1,6
2021,Enlisted,69162,6,1,5
2021,Enlisted,69337,14,1,13
2021,Enlisted,69361,5,0,5
2021,Enlisted,70072,31,3,28
2021,Enlisted,70084,24,3,21
2021,Enlisted,70117,178,80,98
2021,Enlisted,70301,16,2,14
2021,Enlisted,70364,27,5,22
2021,Enlisted,70390,17,4,13
2021,Enlisted,70401,59,5,54
2021,Enlisted,70403,14,2,12
2021,Enlisted,70410,2,1,1
2021,Enlisted,70427,8,2,6
2021,Enlisted,70433,35,3,32
2021,Enlisted,70438,14,1,13
2021,Enlisted,70443,3,0,3
2021,Enlisted,70460,47,7,40
2021,Enlisted,70508,23,2,21
2021,Enlisted,70510,26,7,19
2021,Enlisted,70517,21,1,20
2021,Enlisted,70526,4,2,2
2021,Enlisted,70544,24,8,16
2021,Enlisted,70563,13,3,10
2021,Enlisted,70570,5,1,4
2021,Enlisted,70582,9,3,6
2021,Enlisted,70586,4,3,1
2021,Enlisted,70601,24,6,18
2021,Enlisted,70633,23,6,17
2021,Enlisted,70634,4,1,3
2021,Enlisted,70714,9,0,9
2021,Enlisted,70721,62,10,52
2021,Enlisted,70737,12,0,12
2021,Enlisted,70760,23,2,21
2021,Enlisted,70764,29,7,22
2021,Enlisted,70802,9,1,8
2021,Enlisted,70820,55,7,48
2021,Enlisted,71019,9,2,7
2021,Enlisted,71055,26,5,21
2021,Enlisted,71101,24,2,22
2021,Enlisted,71111,7,0,7
2021,Enlisted,71203,18,2,16
2021,Enlisted,71220,5,0,5
2021,Enlisted,71232,4,1,3
2021,Enlisted,71241,17,5,12
2021,Enlisted,71263,4,0,4
2021,Enlisted,71270,21,4,17
2021,Enlisted,71292,10,2,8
2021,Enlisted,71295,7,0,7
2021,Enlisted,71303,11,0,11
2021,Enlisted,71322,9,1,8
2021,Enlisted,71342,15,2,13
2021,Enlisted,71351,21,4,17
2021,Enlisted,71360,134,17,117
2021,Enlisted,71373,7,0,7
2021,Enlisted,71415,11,0,11
2021,Enlisted,71417,10,0,10
2021,Enlisted,71457,20,4,16
2021,Enlisted,71459,5,2,3
2021,Enlisted,71602,17,1,16
2021,Enlisted,71671,21,1,20
2021,Enlisted,71701,26,5,21
2021,Enlisted,71730,18,2,16
2021,Enlisted,71801,2,0,2
2021,Enlisted,71832,1,0,1
2021,Enlisted,71854,11,2,9
2021,Enlisted,71857,1,0,1
2021,Enlisted,71923,18,2,16
2021,Enlisted,71953,18,4,14
2021,Enlisted,72006,12,0,12
2021,Enlisted,72012,16,2,14
2021,Enlisted,72015,12,1,11
2021,Enlisted,72023,12,0,12
2021,Enlisted,72032,4,1,3
2021,Enlisted,72064,18,0,18
2021,Enlisted,72086,11,0,11
2021,Enlisted,72104,14,1,13
2021,Enlisted,72110,9,2,7
2021,Enlisted,72114,5,1,4
2021,Enlisted,72115,1,0,1
2021,Enlisted,72119,9,2,7
2021,Enlisted,72150,7,1,6
2021,Enlisted,72160,7,0,7
2021,Enlisted,72199,152,24,128
2021,Enlisted,72335,15,0,15
2021,Enlisted,72401,42,6,36
2021,Enlisted,72432,16,1,15
2021,Enlisted,72450,18,0,18
2021,Enlisted,72476,13,1,12
2021,Enlisted,72501,15,1,14
2021,Enlisted,72543,21,2,19
2021,Enlisted,72650,4,0,4
2021,Enlisted,72653,15,1,14
2021,Enlisted,72701,16,3,13
2021,Enlisted,72712,27,2,25
2021,Enlisted,72713,27,2,25
2021,Enlisted,72744,14,3,11
2021,Enlisted,72756,35,2,33
2021,Enlisted,72761,10,2,8
2021,Enlisted,72802,19,1,18
2021,Enlisted,72830,15,0,15
2021,Enlisted,72834,8,1,7
2021,Enlisted,72855,23,1,22
2021,Enlisted,72905,16,4,12
2021,Enlisted,72923,31,3,28
2021,Enlisted,72927,17,1,16
2021,Enlisted,72949,11,1,10
2021,Enlisted,73034,53,13,40
2021,Enlisted,73036,11,3,8
2021,Enlisted,73051,8,1,7
2021,Enlisted,73064,66,9,57
2021,Enlisted,73069,102,12,90
2021,Enlisted,73111,29,8,21
2021,Enlisted,73401,28,3,25
2021,Enlisted,73501,4,1,3
2021,Enlisted,73503,44,15,29
2021,Enlisted,73521,6,3,3
2021,Enlisted,73705,28,4,24
2021,Enlisted,74003,17,1,16
2021,Enlisted,74012,14,3,11
2021,Enlisted,74014,68,8,60
2021,Enlisted,74017,3,1,2
2021,Enlisted,74075,34,4,30
2021,Enlisted,74107,50,15,35
2021,Enlisted,74112,30,4,26
2021,Enlisted,74116,14,3,11
2021,Enlisted,74301,12,4,8
2021,Enlisted,74403,62,6,56
2021,Enlisted,74423,8,0,8
2021,Enlisted,74447,9,0,9
2021,Enlisted,74501,23,3,20
2021,Enlisted,74601,6,0,6
2021,Enlisted,74701,14,3,11
2021,Enlisted,74801,16,2,14
2021,Enlisted,74820,15,1,14
2021,Enlisted,74821,4,1,3
2021,Enlisted,74834,41,4,37
2021,Enlisted,74848,11,3,8
2021,Enlisted,75020,18,7,11
2021,Enlisted,75051,151,49,102
2021,Enlisted,75077,92,21,71
2021,Enlisted,75098,56,22,34
2021,Enlisted,75110,15,2,13
2021,Enlisted,75159,76,40,36
2021,Enlisted,75220,24,10,14
2021,Enlisted,75402,20,4,16
2021,Enlisted,75570,12,5,7
2021,Enlisted,75662,17,6,11
2021,Enlisted,75709,48,7,41
2021,Enlisted,75803,24,14,10
2021,Enlisted,75901,13,8,5
2021,Enlisted,76086,25,5,20
2021,Enlisted,76108,76,26,50
2021,Enlisted,76115,9,2,7
2021,Enlisted,76207,20,6,14
2021,Enlisted,76234,21,3,18
2021,Enlisted,76302,29,9,20
2021,Enlisted,76401,25,5,20
2021,Enlisted,76502,93,23,70
2021,Enlisted,76528,30,14,16
2021,Enlisted,76542,43,23,20
2021,Enlisted,76544,20,9,11
2021,Enlisted,76574,9,5,4
2021,Enlisted,76707,59,30,29
2021,Enlisted,76801,33,11,22
2021,Enlisted,76905,25,7,18
2021,Enlisted,77034,99,36,63
2021,Enlisted,77064,1,1,0
2021,Enlisted,77067,102,35,67
2021,Enlisted,77082,84,32,52
2021,Enlisted,77340,45,17,28
2021,Enlisted,77437,29,5,24
2021,Enlisted,77471,11,1,10
2021,Enlisted,77503,1,1,0
2021,Enlisted,77515,25,12,13
2021,Enlisted,77568,10,3,7
2021,Enlisted,77802,22,5,17
2021,Enlisted,77833,17,5,12
2021,Enlisted,77904,7,4,3
2021,Enlisted,78041,36,3,33
2021,Enlisted,78130,15,2,13
2021,Enlisted,78218,84,40,44
2021,Enlisted,78219,55,16,39
2021,Enlisted,78257,139,65,74
2021,Enlisted,78363,47,11,36
2021,Enlisted,78416,27,6,21
2021,Enlisted,78520,26,12,14
2021,Enlisted,78527,7,5,2
2021,Enlisted,78596,40,10,30
2021,Enlisted,78602,26,6,20
2021,Enlisted,78617,119,49,70
2021,Enlisted,78624,53,27,26
2021,Enlisted,78665,58,27,31
2021,Enlisted,78666,82,27,55
2021,Enlisted,78703,97,41,56
2021,Enlisted,78731,5,2,3
2021,Enlisted,78746,3,1,2
2021,Enlisted,78861,29,20,9
2021,Enlisted,79107,25,13,12
2021,Enlisted,79403,44,14,30
2021,Enlisted,79602,8,2,6
2021,Enlisted,79607,23,11,12
2021,Enlisted,79705,19,6,13
2021,Enlisted,79918,1,0,1
2021,Enlisted,79924,25,6,19
2021,Enlisted,79936,78,23,55
2021,Enlisted,80011,71,47,24
2021,Enlisted,80012,9,3,6
2021,Enlisted,80112,6,4,2
2021,Enlisted,80137,63,42,21
2021,Enlisted,80216,50,24,26
2021,Enlisted,80501,8,3,5
2021,Enlisted,80504,19,10,9
2021,Enlisted,80521,7,4,3
2021,Enlisted,80550,11,8,3
2021,Enlisted,80621,18,13,5
2021,Enlisted,80751,4,3,1
2021,Enlisted,80907,16,8,8
2021,Enlisted,80913,21,13,8
2021,Enlisted,80916,7,6,1
2021,Enlisted,80920,73,50,23
2021,Enlisted,81004,16,13,3
2021,Enlisted,81101,5,3,2
2021,Enlisted,81401,19,10,9
2021,Enlisted,81501,17,13,4
2021,Enlisted,82005,23,2,21
2021,Enlisted,82009,19,5,14
2021,Enlisted,82070,12,1,11
2021,Enlisted,82201,5,0,5
2021,Enlisted,82214,14,4,10
2021,Enlisted,82240,13,2,11
2021,Enlisted,82401,3,0,3
2021,Enlisted,82435,16,3,13
2021,Enlisted,82520,19,0,19
2021,Enlisted,82604,13,0,13
2021,Enlisted,82633,8,0,8
2021,Enlisted,82716,14,1,13
2021,Enlisted,82801,9,2,7
2021,Enlisted,82901,7,1,6
2021,Enlisted,82930,18,6,12
2021,Enlisted,83110,13,4,9
2021,Enlisted,83202,32,13,19
2021,Enlisted,83221,4,1,3
2021,Enlisted,83263,4,0,4
2021,Enlisted,83301,10,2,8
2021,Enlisted,83318,7,1,6
2021,Enlisted,83330,3,0,3
2021,Enlisted,83338,17,0,17
2021,Enlisted,83402,24,5,19
2021,Enlisted,83440,7,1,6
2021,Enlisted,83442,10,4,6
2021,Enlisted,83445,5,0,5
2021,Enlisted,83501,8,2,6
2021,Enlisted,83530,9,0,9
2021,Enlisted,83544,3,0,3
2021,Enlisted,83605,24,8,16
2021,Enlisted,83617,7,2,5
2021,Enlisted,83647,20,4,16
2021,Enlisted,83687,10,4,6
2021,Enlisted,83705,170,60,110
2021,Enlisted,83716,6,2,4
2021,Enlisted,83843,5,1,4
2021,Enlisted,83854,29,7,22
2021,Enlisted,84003,16,3,13
2021,Enlisted,84020,51,5,46
2021,Enlisted,84043,42,25,17
2021,Enlisted,84058,16,6,10
2021,Enlisted,84065,126,45,81
2021,Enlisted,84074,14,4,10
2021,Enlisted,84078,4,1,3
2021,Enlisted,84083,2,1,1
2021,Enlisted,84084,87,19,68
2021,Enlisted,84116,22,12,10
2021,Enlisted,84302,12,1,11
2021,Enlisted,84321,10,0,10
2021,Enlisted,84404,10,2,8
2021,Enlisted,84405,36,9,27
2021,Enlisted,84501,8,0,8
2021,Enlisted,84511,1,0,1
2021,Enlisted,84642,16,0,16
2021,Enlisted,84647,3,0,3
2021,Enlisted,84660,40,4,36
2021,Enlisted,84663,10,0,10
2021,Enlisted,84701,10,2,8
2021,Enlisted,84713,13,0,13
2021,Enlisted,84721,8,4,4
2021,Enlisted,84790,32,9,23
2021,Enlisted,85008,146,46,100
2021,Enlisted,85020,12,3,9
2021,Enlisted,85128,5,3,2
2021,Enlisted,85132,98,47,51
2021,Enlisted,85145,1,1,0
2021,Enlisted,85201,13,5,8
2021,Enlisted,85222,8,5,3
2021,Enlisted,85281,11,6,5
2021,Enlisted,85286,4,1,3
2021,Enlisted,85301,1,1,0
2021,Enlisted,85365,4,1,3
2021,Enlisted,85396,8,4,4
2021,Enlisted,85546,6,0,6
2021,Enlisted,85607,10,3,7
2021,Enlisted,85653,34,12,22
2021,Enlisted,85706,40,9,31
2021,Enlisted,85713,25,10,15
2021,Enlisted,85756,6,3,3
2021,Enlisted,85901,1,1,0
2021,Enlisted,86015,38,10,28
2021,Enlisted,86301,31,18,13
2021,Enlisted,87002,24,2,22
2021,Enlisted,87123,57,11,46
2021,Enlisted,87144,101,37,64
2021,Enlisted,87301,2,1,1
2021,Enlisted,87401,14,4,10
2021,Enlisted,87507,10,3,7
2021,Enlisted,87508,17,7,10
2021,Enlisted,87532,2,1,1
2021,Enlisted,87557,3,0,3
2021,Enlisted,87701,1,0,1
2021,Enlisted,88001,42,16,26
2021,Enlisted,88007,45,19,26
2021,Enlisted,88101,5,0,5
2021,Enlisted,88203,30,4,26
2021,Enlisted,88240,7,2,5
2021,Enlisted,88310,11,2,9
2021,Enlisted,88435,3,0,3
2021,Enlisted,89034,3,0,3
2021,Enlisted,89115,20,7,13
2021,Enlisted,89139,65,14,51
2021,Enlisted,89165,126,19,107
2021,Enlisted,89406,18,3,15
2021,Enlisted,89445,1,0,1
2021,Enlisted,89502,4,0,4
2021,Enlisted,89506,67,6,61
2021,Enlisted,89701,39,11,28
2021,Enlisted,89801,3,0,3
2021,Enlisted,89822,1,0,1
2021,Enlisted,90025,25,11,14
2021,Enlisted,90201,74,31,43
2021,Enlisted,90249,16,3,13
2021,Enlisted,90266,7,2,5
2021,Enlisted,90302,34,14,20
2021,Enlisted,90501,19,7,12
2021,Enlisted,90720,240,73,167
2021,Enlisted,90731,15,7,8
2021,Enlisted,90822,70,32,38
2021,Enlisted,91205,32,16,16
2021,Enlisted,91406,34,11,23
2021,Enlisted,91505,25,7,18
2021,Enlisted,91702,68,20,48
2021,Enlisted,91764,72,24,48
2021,Enlisted,91766,43,14,29
2021,Enlisted,91950,74,28,46
2021,Enlisted,92020,40,25,15
2021,Enlisted,92025,6,4,2
2021,Enlisted,92111,45,15,30
2021,Enlisted,92199,1,0,1
2021,Enlisted,92243,8,3,5
2021,Enlisted,92307,6,6,0
2021,Enlisted,92311,16,6,10
2021,Enlisted,92324,43,25,18
2021,Enlisted,92410,40,21,19
2021,Enlisted,92518,52,24,28
2021,Enlisted,92707,11,5,6
2021,Enlisted,92833,30,14,16
2021,Enlisted,92866,38,29,9
2021,Enlisted,93003,12,9,3
2021,Enlisted,93007,3,2,1
2021,Enlisted,93257,4,4,0
2021,Enlisted,93291,14,6,8
2021,Enlisted,93307,40,17,23
2021,Enlisted,93405,2,1,1
2021,Enlisted,93422,3,0,3
2021,Enlisted,93451,15,10,5
2021,Enlisted,93536,16,6,10
2021,Enlisted,93550,12,4,8
2021,Enlisted,93638,15,3,12
2021,Enlisted,93727,54,19,35
2021,Enlisted,93955,7,4,3
2021,Enlisted,94043,6,4,2
2021,Enlisted,94066,7,3,4
2021,Enlisted,94132,8,3,5
2021,Enlisted,94510,2,1,1
2021,Enlisted,94519,22,3,19
2021,Enlisted,94533,6,3,3
2021,Enlisted,94565,8,2,6
2021,Enlisted,94568,37,17,20
2021,Enlisted,94590,15,2,13
2021,Enlisted,94596,13,3,10
2021,Enlisted,94804,24,10,14
2021,Enlisted,94903,14,10,4
2021,Enlisted,94952,5,2,3
2021,Enlisted,95023,6,1,5
2021,Enlisted,95110,20,4,16
2021,Enlisted,95206,47,14,33
2021,Enlisted,95209,4,2,2
2021,Enlisted,95231,6,1,5
2021,Enlisted,95240,15,3,12
2021,Enlisted,95341,7,2,5
2021,Enlisted,95347,2,1,1
2021,Enlisted,95351,33,12,21
2021,Enlisted,95361,13,4,9
2021,Enlisted,95401,20,2,18
2021,Enlisted,95503,4,0,4
2021,Enlisted,95655,6,1,5
2021,Enlisted,95678,7,4,3
2021,Enlisted,95815,4,0,4
2021,Enlisted,95823,7,1,6
2021,Enlisted,95827,3,3,0
2021,Enlisted,95828,98,31,67
2021,Enlisted,95832,8,4,4
2021,Enlisted,95926,10,1,9
2021,Enlisted,95965,6,2,4
2021,Enlisted,96001,12,2,10
2021,Enlisted,96067,1,0,1
2021,Enlisted,96080,3,0,3
2021,Enlisted,96707,168,56,112
2021,Enlisted,96716,22,12,10
2021,Enlisted,96720,54,17,37
2021,Enlisted,96748,5,1,4
2021,Enlisted,96750,11,1,10
2021,Enlisted,96753,19,2,17
2021,Enlisted,96782,39,7,32
2021,Enlisted,96789,83,15,68
2021,Enlisted,96820,11,2,9
2021,Enlisted,96857,44,13,31
2021,Enlisted,96913,87,12,75
2021,Enlisted,97015,58,13,45
2021,Enlisted,97030,23,8,15
2021,Enlisted,97031,6,0,6
2021,Enlisted,97051,21,2,19
2021,Enlisted,97058,6,3,3
2021,Enlisted,97071,18,4,14
2021,Enlisted,97116,24,2,22
2021,Enlisted,97128,7,4,3
2021,Enlisted,97140,2,0,2
2021,Enlisted,97146,8,1,7
2021,Enlisted,97211,27,2,25
2021,Enlisted,97217,8,0,8
2021,Enlisted,97218,24,8,16
2021,Enlisted,97301,56,19,37
2021,Enlisted,97302,36,8,28
2021,Enlisted,97321,5,1,4
2021,Enlisted,97322,5,1,4
2021,Enlisted,97330,29,9,20
2021,Enlisted,97338,14,4,10
2021,Enlisted,97355,5,0,5
2021,Enlisted,97365,9,3,6
2021,Enlisted,97420,5,2,3
2021,Enlisted,97470,3,0,3
2021,Enlisted,97477,42,8,34
2021,Enlisted,97501,27,5,22
2021,Enlisted,97520,10,0,10
2021,Enlisted,97526,7,0,7
2021,Enlisted,97603,4,1,3
2021,Enlisted,97702,8,2,6
2021,Enlisted,97754,6,1,5
2021,Enlisted,97756,17,4,13
2021,Enlisted,97801,9,2,7
2021,Enlisted,97814,1,0,1
2021,Enlisted,97838,12,3,9
2021,Enlisted,97850,16,2,14
2021,Enlisted,97862,12,1,11
2021,Enlisted,97914,8,2,6
2021,Enlisted,98032,62,29,33
2021,Enlisted,98052,12,7,5
2021,Enlisted,98108,27,14,13
2021,Enlisted,98119,43,19,24
2021,Enlisted,98221,10,5,5
2021,Enlisted,98271,21,4,17
2021,Enlisted,98290,17,4,13
2021,Enlisted,98312,5,4,1
2021,Enlisted,98321,16,13,3
2021,Enlisted,98372,15,8,7
2021,Enlisted,98430,50,28,22
2021,Enlisted,98433,103,46,57
2021,Enlisted,98499,1,1,0
2021,Enlisted,98501,23,7,16
2021,Enlisted,98531,41,21,20
2021,Enlisted,98563,6,2,4
2021,Enlisted,98632,4,2,2
2021,Enlisted,98682,35,7,28
2021,Enlisted,98801,4,2,2
2021,Enlisted,98823,2,2,0
2021,Enlisted,98837,9,4,5
2021,Enlisted,98901,37,9,28
2021,Enlisted,98903,19,5,14
2021,Enlisted,98930,6,0,6
2021,Enlisted,99011,44,10,34
2021,Enlisted,99217,15,2,13
2021,Enlisted,99219,13,2,11
2021,Enlisted,99301,5,0,5
2021,Enlisted,99362,4,0,4
2021,Enlisted,99505,133,55,78
2021,Enlisted,99654,34,9,25
2021,Enlisted,99701,3,2,1
2021,Enlisted,99901,3,2,1
2021,Officer,     ,8,8,0
2021,Officer,00000,11,11,0
2021,Officer,00682,2,2,0
2021,Officer,00693,3,2,1
2021,Officer,00725,3,2,1
2021,Officer,00735,2,2,0
2021,Officer,00736,1,1,0
2021,Officer,00751,2,2,0
2021,Officer,00769,1,0,1
2021,Officer,00778,1,1,0
2021,Officer,00795,11,10,1
2021,Officer,00802,1,1,0
2021,Officer,00850,2,2,0
2021,Officer,00934,15,9,6
2021,Officer,00951,1,1,0
2021,Officer,01013,2,2,0
2021,Officer,01082,1,1,0
2021,Officer,01085,1,1,0
2021,Officer,01434,8,8,0
2021,Officer,01453,1,1,0
2021,Officer,01567,1,1,0
2021,Officer,01588,1,1,0
2021,Officer,01605,6,6,0
2021,Officer,01702,2,2,0
2021,Officer,01731,11,5,6
2021,Officer,01760,7,6,1
2021,Officer,01844,9,9,0
2021,Officer,01867,6,6,0
2021,Officer,02043,3,3,0
2021,Officer,02122,3,3,0
2021,Officer,02169,10,10,0
2021,Officer,02176,3,3,0
2021,Officer,02184,2,2,0
2021,Officer,02346,1,1,0
2021,Officer,02420,3,3,0
2021,Officer,02481,1,1,0
2021,Officer,02542,15,15,0
2021,Officer,02769,1,1,0
2021,Officer,02809,1,1,0
2021,Officer,02816,2,2,0
2021,Officer,02818,5,5,0
2021,Officer,02842,4,4,0
2021,Officer,02852,4,4,0
2021,Officer,02886,2,2,0
2021,Officer,02904,3,3,0
2021,Officer,02920,1,0,1
2021,Officer,03055,2,2,0
2021,Officer,03101,5,5,0
2021,Officer,03235,2,2,0
2021,Officer,03264,1,1,0
2021,Officer,03275,3,3,0
2021,Officer,03301,15,13,2
2021,Officer,03561,1,1,0
2021,Officer,03801,2,2,0
2021,Officer,04011,6,5,1
2021,Officer,04240,1,1,0
2021,Officer,04268,2,2,0
2021,Officer,04330,3,3,0
2021,Officer,04401,4,4,0
2021,Officer,04730,1,1,0
2021,Officer,04736,2,2,0
2021,Officer,04901,1,1,0
2021,Officer,05403,1,1,0
2021,Officer,05404,3,2,1
2021,Officer,05446,19,16,3
2021,Officer,05465,6,5,1
2021,Officer,05478,7,2,5
2021,Officer,05491,1,0,1
2021,Officer,05495,3,2,1
2021,Officer,05633,1,1,0
2021,Officer,05661,1,1,0
2021,Officer,05663,2,1,1
2021,Officer,05701,4,3,1
2021,Officer,06019,1,1,0
2021,Officer,06082,2,2,0
2021,Officer,06096,5,5,0
2021,Officer,06105,2,2,0
2021,Officer,06110,3,3,0
2021,Officer,06320,4,4,0
2021,Officer,06340,6,5,1
2021,Officer,06357,5,2,3
2021,Officer,06360,1,1,0
2021,Officer,06457,3,3,0
2021,Officer,06497,1,1,0
2021,Officer,06498,2,2,0
2021,Officer,06512,9,9,0
2021,Officer,06702,3,3,0
2021,Officer,06810,1,1,0
2021,Officer,07052,8,8,0
2021,Officer,07090,2,2,0
2021,Officer,07095,1,1,0
2021,Officer,07306,9,6,3
2021,Officer,07457,2,2,0
2021,Officer,07666,4,4,0
2021,Officer,07728,3,3,0
2021,Officer,07806,4,4,0
2021,Officer,07865,2,2,0
2021,Officer,07960,1,1,0
2021,Officer,08002,1,1,0
2021,Officer,08037,1,1,0
2021,Officer,08096,1,1,0
2021,Officer,08098,1,1,0
2021,Officer,08360,3,3,0
2021,Officer,08640,8,4,4
2021,Officer,08648,3,3,0
2021,Officer,08733,5,5,0
2021,Officer,08750,5,4,1
2021,Officer,08759,5,5,0
2021,Officer,08822,1,1,0
2021,Officer,08873,5,5,0
2021,Officer,10010,4,4,0
2021,Officer,10037,3,2,1
2021,Officer,10314,4,3,1
2021,Officer,10468,2,2,0
2021,Officer,10566,5,4,1
2021,Officer,10567,5,5,0
2021,Officer,10701,2,2,0
2021,Officer,10962,2,2,0
2021,Officer,11209,2,2,0
2021,Officer,11252,4,4,0
2021,Officer,11357,8,8,0
2021,Officer,11433,7,6,1
2021,Officer,11735,2,2,0
2021,Officer,11746,1,1,0
2021,Officer,11779,2,2,0
2021,Officer,12078,1,0,1
2021,Officer,12110,6,5,1
2021,Officer,12180,4,1,3
2021,Officer,12189,9,2,7
2021,Officer,12301,3,3,0
2021,Officer,12401,1,1,0
2021,Officer,12553,2,2,0
2021,Officer,12962,1,1,0
2021,Officer,13021,1,1,0
2021,Officer,13211,8,7,1
2021,Officer,13501,4,3,1
2021,Officer,13905,4,4,0
2021,Officer,14094,1,1,0
2021,Officer,14204,2,2,0
2021,Officer,14213,5,4,1
2021,Officer,14304,1,1,0
2021,Officer,14454,1,1,0
2021,Officer,14456,1,1,0
2021,Officer,14624,4,4,0
2021,Officer,14850,2,2,0
2021,Officer,15010,2,2,0
2021,Officer,15216,3,3,0
2021,Officer,15301,6,5,1
2021,Officer,15370,2,2,0
2021,Officer,15425,1,1,0
2021,Officer,15666,7,7,0
2021,Officer,15767,1,1,0
2021,Officer,15902,3,2,1
2021,Officer,15904,8,8,0
2021,Officer,16101,3,3,0
2021,Officer,16148,2,2,0
2021,Officer,16403,8,7,1
2021,Officer,16652,2,2,0
2021,Officer,16738,2,2,0
2021,Officer,16830,1,1,0
2021,Officer,17003,16,14,2
2021,Officer,17013,4,4,0
2021,Officer,17022,12,11,1
2021,Officer,17042,2,0,2
2021,Officer,17044,5,5,0
2021,Officer,17103,12,10,2
2021,Officer,17201,1,1,0
2021,Officer,17325,1,1,0
2021,Officer,17331,1,1,0
2021,Officer,17701,3,2,1
2021,Officer,17745,1,1,0
2021,Officer,18040,1,1,0
2021,Officer,18102,4,2,2
2021,Officer,18509,6,6,0
2021,Officer,18634,1,1,0
2021,Officer,18651,1,0,1
2021,Officer,18704,3,3,0
2021,Officer,18834,1,1,0
2021,Officer,18960,1,1,0
2021,Officer,19044,3,3,0
2021,Officer,19103,1,1,0
2021,Officer,19104,1,1,0
2021,Officer,19153,2,2,0
2021,Officer,19154,13,13,0
2021,Officer,19320,2,2,0
2021,Officer,19462,4,3,1
2021,Officer,19526,1,1,0
2021,Officer,19530,1,1,0
2021,Officer,19605,3,3,0
2021,Officer,19706,1,1,0
2021,Officer,19720,5,4,1
2021,Officer,19804,2,2,0
2021,Officer,19930,1,1,0
2021,Officer,19939,1,1,0
2021,Officer,19973,2,2,0
2021,Officer,19977,4,4,0
2021,Officer,20003,25,25,0
2021,Officer,20112,3,3,0
2021,Officer,20186,1,1,0
2021,Officer,20623,1,1,0
2021,Officer,20646,1,1,0
2021,Officer,20653,1,1,0
2021,Officer,20708,3,3,0
2021,Officer,20783,1,1,0
2021,Officer,20882,1,1,0
2021,Officer,20904,1,1,0
2021,Officer,21010,3,3,0
2021,Officer,21043,2,2,0
2021,Officer,21057,1,1,0
2021,Officer,21078,2,2,0
2021,Officer,21136,8,7,1
2021,Officer,21157,1,1,0
2021,Officer,21201,5,3,2
2021,Officer,21204,3,2,1
2021,Officer,21216,1,1,0
2021,Officer,21222,2,2,0
2021,Officer,21228,3,2,1
2021,Officer,21236,2,2,0
2021,Officer,21401,1,1,0
2021,Officer,21601,1,1,0
2021,Officer,21801,1,1,0
2021,Officer,22032,6,6,0
2021,Officer,22060,5,4,1
2021,Officer,22401,6,6,0
2021,Officer,22427,4,3,1
2021,Officer,22601,3,3,0
2021,Officer,22602,3,3,0
2021,Officer,22902,7,5,2
2021,Officer,23139,1,1,0
2021,Officer,23150,5,5,0
2021,Officer,23237,1,1,0
2021,Officer,23434,1,1,0
2021,Officer,23451,9,9,0
2021,Officer,23502,4,4,0
2021,Officer,23609,3,3,0
2021,Officer,23666,6,6,0
2021,Officer,23701,1,1,0
2021,Officer,23805,1,1,0
2021,Officer,23824,8,5,3
2021,Officer,23847,2,2,0
2021,Officer,23901,1,1,0
2021,Officer,24151,1,1,0
2021,Officer,24212,1,1,0
2021,Officer,24401,3,3,0
2021,Officer,24450,2,2,0
2021,Officer,24502,1,1,0
2021,Officer,24540,2,2,0
2021,Officer,24609,1,1,0
2021,Officer,24701,1,1,0
2021,Officer,24957,2,2,0
2021,Officer,25168,4,3,1
2021,Officer,25309,2,2,0
2021,Officer,25311,1,1,0
2021,Officer,25405,1,1,0
2021,Officer,25530,2,2,0
2021,Officer,25550,2,2,0
2021,Officer,25846,4,4,0
2021,Officer,26041,2,2,0
2021,Officer,26101,3,3,0
2021,Officer,26187,1,1,0
2021,Officer,26201,2,2,0
2021,Officer,26301,1,1,0
2021,Officer,26505,1,1,0
2021,Officer,26537,4,4,0
2021,Officer,26624,1,1,0
2021,Officer,27030,1,1,0
2021,Officer,27103,3,2,1
2021,Officer,27203,1,1,0
2021,Officer,27205,2,1,1
2021,Officer,27217,2,2,0
2021,Officer,27260,2,2,0
2021,Officer,27292,1,1,0
2021,Officer,27330,2,2,0
2021,Officer,27344,1,1,0
2021,Officer,27360,1,1,0
2021,Officer,27401,3,2,1
2021,Officer,27504,1,0,1
2021,Officer,27530,6,5,1
2021,Officer,27549,4,3,1
2021,Officer,27560,7,6,1
2021,Officer,27573,1,1,0
2021,Officer,27577,2,2,0
2021,Officer,27607,7,7,0
2021,Officer,27704,5,4,1
2021,Officer,27889,2,2,0
2021,Officer,28012,3,3,0
2021,Officer,28027,2,1,1
2021,Officer,28054,6,4,2
2021,Officer,28092,1,0,1
2021,Officer,28110,1,1,0
2021,Officer,28170,3,2,1
2021,Officer,28208,10,10,0
2021,Officer,28306,2,2,0
2021,Officer,28310,1,1,0
2021,Officer,28328,9,9,0
2021,Officer,28334,3,2,1
2021,Officer,28345,1,1,0
2021,Officer,28352,1,1,0
2021,Officer,28377,1,1,0
2021,Officer,28379,1,0,1
2021,Officer,28405,6,5,1
2021,Officer,28459,1,0,1
2021,Officer,28472,1,1,0
2021,Officer,28560,2,2,0
2021,Officer,28590,1,1,0
2021,Officer,28601,1,1,0
2021,Officer,28655,1,1,0
2021,Officer,28658,1,1,0
2021,Officer,28681,1,0,1
2021,Officer,28726,1,1,0
2021,Officer,28734,1,1,0
2021,Officer,28779,1,1,0
2021,Officer,29044,21,21,0
2021,Officer,29108,10,10,0
2021,Officer,29138,1,1,0
2021,Officer,29161,3,3,0
2021,Officer,29201,8,7,1
2021,Officer,29325,1,1,0
2021,Officer,29360,2,2,0
2021,Officer,29379,1,1,0
2021,Officer,29385,1,1,0
2021,Officer,29409,5,5,0
2021,Officer,29464,8,8,0
2021,Officer,29488,1,1,0
2021,Officer,29510,3,3,0
2021,Officer,29512,2,2,0
2021,Officer,29532,1,1,0
2021,Officer,29536,2,2,0
2021,Officer,29556,1,1,0
2021,Officer,29605,2,2,0
2021,Officer,29625,1,1,0
2021,Officer,29631,3,3,0
2021,Officer,29640,1,1,0
2021,Officer,29644,1,1,0
2021,Officer,29651,1,1,0
2021,Officer,29653,1,1,0
2021,Officer,29678,2,2,0
2021,Officer,29720,1,1,0
2021,Officer,29732,1,1,0
2021,Officer,29810,2,2,0
2021,Officer,29824,2,2,0
2021,Officer,29829,1,1,0
2021,Officer,29906,1,1,0
2021,Officer,30014,2,2,0
2021,Officer,30032,2,2,0
2021,Officer,30040,6,6,0
2021,Officer,30046,1,1,0
2021,Officer,30060,24,18,6
2021,Officer,30069,2,2,0
2021,Officer,30114,4,4,0
2021,Officer,30125,3,3,0
2021,Officer,30134,1,1,0
2021,Officer,30144,1,1,0
2021,Officer,30224,2,2,0
2021,Officer,30263,3,3,0
2021,Officer,30297,5,5,0
2021,Officer,30336,4,4,0
2021,Officer,30461,2,1,1
2021,Officer,30501,3,3,0
2021,Officer,30635,1,1,0
2021,Officer,30643,2,2,0
2021,Officer,30655,3,3,0
2021,Officer,30673,3,2,1
2021,Officer,30680,4,4,0
2021,Officer,30701,3,3,0
2021,Officer,30824,3,3,0
2021,Officer,30830,1,1,0
2021,Officer,30904,2,2,0
2021,Officer,31029,3,3,0
2021,Officer,31061,29,29,0
2021,Officer,31211,6,5,1
2021,Officer,31313,2,2,0
2021,Officer,31314,2,2,0
2021,Officer,31329,2,2,0
2021,Officer,31406,3,2,1
2021,Officer,31409,2,2,0
2021,Officer,31520,1,1,0
2021,Officer,31704,1,1,0
2021,Officer,31794,1,1,0
2021,Officer,31901,3,3,0
2021,Officer,31905,2,2,0
2021,Officer,32055,1,1,0
2021,Officer,32064,4,4,0
2021,Officer,32084,5,5,0
2021,Officer,32086,5,4,1
2021,Officer,32091,15,13,2
2021,Officer,32164,3,3,0
2021,Officer,32177,1,1,0
2021,Officer,32221,11,11,0
2021,Officer,32311,3,3,0
2021,Officer,32351,2,2,0
2021,Officer,32405,2,2,0
2021,Officer,32425,1,1,0
2021,Officer,32428,1,1,0
2021,Officer,32514,1,1,0
2021,Officer,32721,2,2,0
2021,Officer,32724,2,2,0
2021,Officer,32771,2,2,0
2021,Officer,32806,5,4,1
2021,Officer,32862,3,3,0
2021,Officer,32922,2,2,0
2021,Officer,32935,1,1,0
2021,Officer,33027,7,7,0
2021,Officer,33039,2,2,0
2021,Officer,33127,5,5,0
2021,Officer,33315,2,2,0
2021,Officer,33405,2,2,0
2021,Officer,33563,3,3,0
2021,Officer,33627,1,1,0
2021,Officer,33711,4,4,0
2021,Officer,33782,7,7,0
2021,Officer,33811,2,2,0
2021,Officer,33830,1,1,0
2021,Officer,33859,1,1,0
2021,Officer,33880,1,1,0
2021,Officer,33916,2,2,0
2021,Officer,34208,3,3,0
2021,Officer,34221,3,3,0
2021,Officer,34237,6,6,0
2021,Officer,34748,2,2,0
2021,Officer,35010,2,2,0
2021,Officer,35040,3,3,0
2021,Officer,35042,2,2,0
2021,Officer,35045,2,2,0
2021,Officer,35055,2,2,0
2021,Officer,35121,3,2,1
2021,Officer,35124,2,2,0
2021,Officer,35160,3,3,0
2021,Officer,35209,3,3,0
2021,Officer,35217,10,9,1
2021,Officer,35405,2,2,0
2021,Officer,35476,3,2,1
2021,Officer,35555,1,1,0
2021,Officer,35565,6,4,2
2021,Officer,35601,10,8,2
2021,Officer,35613,1,1,0
2021,Officer,35803,2,2,0
2021,Officer,35805,3,3,0
2021,Officer,35904,2,2,0
2021,Officer,35967,2,2,0
2021,Officer,36016,2,2,0
2021,Officer,36027,2,2,0
2021,Officer,36043,5,5,0
2021,Officer,36067,1,1,0
2021,Officer,36078,1,1,0
2021,Officer,36081,1,1,0
2021,Officer,36083,1,1,0
2021,Officer,36109,8,7,1
2021,Officer,36117,3,3,0
2021,Officer,36205,6,5,1
2021,Officer,36265,2,2,0
2021,Officer,36301,1,1,0
2021,Officer,36330,1,1,0
2021,Officer,36420,4,4,0
2021,Officer,36522,1,1,0
2021,Officer,36532,1,1,0
2021,Officer,36605,9,7,2
2021,Officer,36801,1,1,0
2021,Officer,36832,1,1,0
2021,Officer,36867,1,1,0
2021,Officer,37033,1,1,0
2021,Officer,37055,3,3,0
2021,Officer,37066,1,1,0
2021,Officer,37090,5,5,0
2021,Officer,37091,1,1,0
2021,Officer,37110,1,1,0
2021,Officer,37129,1,1,0
2021,Officer,37160,1,1,0
2021,Officer,37167,8,7,1
2021,Officer,37172,1,1,0
2021,Officer,37204,8,6,2
2021,Officer,37217,4,4,0
2021,Officer,37321,2,2,0
2021,Officer,37323,1,1,0
2021,Officer,37327,2,2,0
2021,Officer,37334,2,2,0
2021,Officer,37356,1,1,0
2021,Officer,37388,2,2,0
2021,Officer,37398,4,4,0
2021,Officer,37404,5,4,1
2021,Officer,37620,2,2,0
2021,Officer,37643,2,2,0
2021,Officer,37645,4,3,1
2021,Officer,37757,2,2,0
2021,Officer,37760,2,2,0
2021,Officer,37777,3,2,1
2021,Officer,37825,2,2,0
2021,Officer,37854,2,2,0
2021,Officer,37857,2,2,0
2021,Officer,37860,1,1,0
2021,Officer,37863,1,1,0
2021,Officer,37874,1,1,0
2021,Officer,37919,6,6,0
2021,Officer,38019,1,1,0
2021,Officer,38024,2,1,1
2021,Officer,38079,2,2,0
2021,Officer,38118,2,2,0
2021,Officer,38261,1,1,0
2021,Officer,38301,1,1,0
2021,Officer,38305,1,1,0
2021,Officer,38320,1,1,0
2021,Officer,38340,2,2,0
2021,Officer,38358,2,2,0
2021,Officer,38375,2,2,0
2021,Officer,38382,3,3,0
2021,Officer,38401,2,2,0
2021,Officer,38478,1,1,0
2021,Officer,38485,1,1,0
2021,Officer,38506,2,1,1
2021,Officer,38563,1,1,0
2021,Officer,38572,1,1,0
2021,Officer,38583,1,1,0
2021,Officer,38614,1,1,0
2021,Officer,38632,2,2,0
2021,Officer,38655,1,1,0
2021,Officer,38671,2,2,0
2021,Officer,38703,1,1,0
2021,Officer,38751,1,1,0
2021,Officer,38801,4,3,1
2021,Officer,38821,2,2,0
2021,Officer,38843,1,1,0
2021,Officer,38851,1,1,0
2021,Officer,38916,1,1,0
2021,Officer,39042,3,3,0
2021,Officer,39046,1,1,0
2021,Officer,39056,1,1,0
2021,Officer,39059,1,1,0
2021,Officer,39111,1,1,0
2021,Officer,39120,1,1,0
2021,Officer,39183,2,2,0
2021,Officer,39202,3,1,2
2021,Officer,39204,8,7,1
2021,Officer,39209,3,3,0
2021,Officer,39216,1,1,0
2021,Officer,39307,2,2,0
2021,Officer,39339,1,1,0
2021,Officer,39345,1,1,0
2021,Officer,39350,2,2,0
2021,Officer,39429,1,1,0
2021,Officer,39452,1,1,0
2021,Officer,39466,1,1,0
2021,Officer,39505,2,2,0
2021,Officer,39507,2,2,0
2021,Officer,39567,1,1,0
2021,Officer,39577,2,2,0
2021,Officer,39648,1,1,0
2021,Officer,39654,4,3,1
2021,Officer,39759,1,1,0
2021,Officer,40004,2,2,0
2021,Officer,40065,3,3,0
2021,Officer,40205,4,3,1
2021,Officer,40218,4,4,0
2021,Officer,40311,1,1,0
2021,Officer,40351,2,2,0
2021,Officer,40472,2,2,0
2021,Officer,40475,9,9,0
2021,Officer,40510,7,7,0
2021,Officer,40601,16,16,0
2021,Officer,40741,1,1,0
2021,Officer,40840,2,2,0
2021,Officer,40906,4,3,1
2021,Officer,40965,2,2,0
2021,Officer,41005,7,7,0
2021,Officer,41008,1,1,0
2021,Officer,41031,3,3,0
2021,Officer,41101,3,2,1
2021,Officer,41164,1,1,0
2021,Officer,41653,1,1,0
2021,Officer,41701,1,1,0
2021,Officer,42086,1,1,0
2021,Officer,42101,1,1,0
2021,Officer,42141,5,5,0
2021,Officer,42240,1,1,0
2021,Officer,42301,4,4,0
2021,Officer,42330,2,2,0
2021,Officer,42345,1,1,0
2021,Officer,42501,2,2,0
2021,Officer,42633,2,2,0
2021,Officer,42754,1,1,0
2021,Officer,43015,6,6,0
2021,Officer,43040,1,1,0
2021,Officer,43055,2,2,0
2021,Officer,43102,2,2,0
2021,Officer,43213,4,4,0
2021,Officer,43217,9,9,0
2021,Officer,43235,6,3,3
2021,Officer,43402,1,1,0
2021,Officer,43465,1,1,0
2021,Officer,43756,7,7,0
2021,Officer,44128,2,1,1
2021,Officer,44142,2,2,0
2021,Officer,44224,1,1,0
2021,Officer,44313,2,2,0
2021,Officer,44444,3,3,0
2021,Officer,44691,2,2,0
2021,Officer,44720,3,3,0
2021,Officer,44870,1,1,0
2021,Officer,44903,1,1,0
2021,Officer,45015,3,3,0
2021,Officer,45035,3,3,0
2021,Officer,45215,5,4,1
2021,Officer,45331,1,1,0
2021,Officer,45356,1,1,0
2021,Officer,45385,2,2,0
2021,Officer,45430,2,2,0
2021,Officer,45502,3,3,0
2021,Officer,45662,1,0,1
2021,Officer,45804,1,1,0
2021,Officer,46012,3,3,0
2021,Officer,46041,2,2,0
2021,Officer,46124,2,2,0
2021,Officer,46131,16,12,4
2021,Officer,46151,1,1,0
2021,Officer,46176,6,6,0
2021,Officer,46216,7,7,0
2021,Officer,46241,15,14,1
2021,Officer,46383,1,1,0
2021,Officer,46402,1,1,0
2021,Officer,46406,6,6,0
2021,Officer,46517,1,1,0
2021,Officer,46563,1,1,0
2021,Officer,46613,1,1,0
2021,Officer,46703,1,1,0
2021,Officer,46825,3,3,0
2021,Officer,47150,1,1,0
2021,Officer,47203,2,2,0
2021,Officer,47250,1,1,0
2021,Officer,47401,2,2,0
2021,Officer,47421,2,2,0
2021,Officer,47501,1,1,0
2021,Officer,47546,3,3,0
2021,Officer,47591,3,3,0
2021,Officer,47715,1,1,0
2021,Officer,47804,1,1,0
2021,Officer,47872,2,2,0
2021,Officer,47905,3,3,0
2021,Officer,47933,1,1,0
2021,Officer,47960,1,1,0
2021,Officer,48045,1,1,0
2021,Officer,48060,1,1,0
2021,Officer,48180,9,9,0
2021,Officer,48197,1,1,0
2021,Officer,48208,5,5,0
2021,Officer,48234,10,9,1
2021,Officer,48446,1,1,0
2021,Officer,48601,5,5,0
2021,Officer,48706,3,3,0
2021,Officer,48801,1,1,0
2021,Officer,48817,2,2,0
2021,Officer,48837,7,7,0
2021,Officer,48838,2,2,0
2021,Officer,48843,1,1,0
2021,Officer,48906,9,9,0
2021,Officer,48912,1,1,0
2021,Officer,49009,6,6,0
2021,Officer,49012,8,7,1
2021,Officer,49307,1,1,0
2021,Officer,49509,5,4,1
2021,Officer,49601,1,1,0
2021,Officer,49696,1,1,0
2021,Officer,49739,2,2,0
2021,Officer,49783,2,1,1
2021,Officer,49855,2,1,1
2021,Officer,49913,2,2,0
2021,Officer,50025,1,1,0
2021,Officer,50036,5,5,0
2021,Officer,50131,28,26,2
2021,Officer,50401,1,1,0
2021,Officer,50501,1,1,0
2021,Officer,50616,1,1,0
2021,Officer,50703,2,2,0
2021,Officer,50709,2,2,0
2021,Officer,51111,4,4,0
2021,Officer,51201,2,1,1
2021,Officer,51301,1,1,0
2021,Officer,51442,1,1,0
2021,Officer,51503,1,1,0
2021,Officer,51566,2,2,0
2021,Officer,51601,2,2,0
2021,Officer,52001,1,1,0
2021,Officer,52246,2,2,0
2021,Officer,52353,2,1,1
2021,Officer,52404,1,1,0
2021,Officer,52501,1,1,0
2021,Officer,52556,2,2,0
2021,Officer,52638,1,1,0
2021,Officer,52761,1,1,0
2021,Officer,52806,10,10,0
2021,Officer,53066,1,1,0
2021,Officer,53089,2,2,0
2021,Officer,53095,1,1,0
2021,Officer,53154,4,3,1
2021,Officer,53186,2,1,1
2021,Officer,53212,9,8,1
2021,Officer,53403,1,0,1
2021,Officer,53538,1,1,0
2021,Officer,53545,1,1,0
2021,Officer,53704,15,13,2
2021,Officer,53821,1,1,0
2021,Officer,53948,1,1,0
2021,Officer,54017,1,1,0
2021,Officer,54143,2,2,0
2021,Officer,54303,1,1,0
2021,Officer,54401,1,1,0
2021,Officer,54451,2,2,0
2021,Officer,54481,1,1,0
2021,Officer,54615,1,1,0
2021,Officer,54618,6,5,1
2021,Officer,54646,1,1,0
2021,Officer,54650,1,1,0
2021,Officer,54703,2,1,1
2021,Officer,54729,1,1,0
2021,Officer,54806,2,2,0
2021,Officer,54843,1,1,0
2021,Officer,54914,3,3,0
2021,Officer,54932,9,9,0
2021,Officer,54981,1,1,0
2021,Officer,55008,2,2,0
2021,Officer,55016,3,3,0
2021,Officer,55033,1,1,0
2021,Officer,55066,1,1,0
2021,Officer,55068,4,4,0
2021,Officer,55073,3,3,0
2021,Officer,55077,3,3,0
2021,Officer,55082,4,4,0
2021,Officer,55101,6,6,0
2021,Officer,55106,1,1,0
2021,Officer,55107,2,2,0
2021,Officer,55112,21,17,4
2021,Officer,55118,2,2,0
2021,Officer,55303,3,2,1
2021,Officer,55350,2,2,0
2021,Officer,55355,1,1,0
2021,Officer,55362,2,2,0
2021,Officer,55431,2,2,0
2021,Officer,55443,4,4,0
2021,Officer,55719,1,1,0
2021,Officer,55720,1,1,0
2021,Officer,55744,3,3,0
2021,Officer,55746,1,1,0
2021,Officer,55811,5,5,0
2021,Officer,55901,2,2,0
2021,Officer,55912,2,2,0
2021,Officer,55987,2,2,0
2021,Officer,56001,5,5,0
2021,Officer,56081,1,1,0
2021,Officer,56201,4,4,0
2021,Officer,56208,1,1,0
2021,Officer,56256,3,3,0
2021,Officer,56258,1,1,0
2021,Officer,56265,1,1,0
2021,Officer,56267,1,1,0
2021,Officer,56273,1,1,0
2021,Officer,56278,3,3,0
2021,Officer,56308,2,2,0
2021,Officer,56345,10,8,2
2021,Officer,56401,1,1,0
2021,Officer,56560,1,1,0
2021,Officer,56601,4,4,0
2021,Officer,57006,2,2,0
2021,Officer,57042,1,1,0
2021,Officer,57069,4,4,0
2021,Officer,57104,3,3,0
2021,Officer,57201,1,1,0
2021,Officer,57325,2,2,0
2021,Officer,57350,3,3,0
2021,Officer,57501,1,1,0
2021,Officer,57702,8,7,1
2021,Officer,57703,1,1,0
2021,Officer,57783,1,1,0
2021,Officer,58072,2,2,0
2021,Officer,58075,2,2,0
2021,Officer,58102,7,7,0
2021,Officer,58201,2,2,0
2021,Officer,58301,3,3,0
2021,Officer,58401,2,2,0
2021,Officer,58501,5,5,0
2021,Officer,58506,4,4,0
2021,Officer,58703,6,5,1
2021,Officer,58801,1,1,0
2021,Officer,59047,1,1,0
2021,Officer,59102,3,3,0
2021,Officer,59301,1,1,0
2021,Officer,59405,2,2,0
2021,Officer,59457,1,1,0
2021,Officer,59501,1,1,0
2021,Officer,59538,1,1,0
2021,Officer,59602,1,1,0
2021,Officer,59636,7,5,2
2021,Officer,59701,2,1,1
2021,Officer,59714,2,2,0
2021,Officer,59760,3,3,0
2021,Officer,59808,1,1,0
2021,Officer,59901,2,2,0
2021,Officer,60037,1,1,0
2021,Officer,60120,1,1,0
2021,Officer,60178,1,1,0
2021,Officer,60435,1,1,0
2021,Officer,60472,6,4,2
2021,Officer,60546,4,4,0
2021,Officer,60615,6,6,0
2021,Officer,60616,2,2,0
2021,Officer,60651,5,4,1
2021,Officer,60901,1,1,0
2021,Officer,61071,2,2,0
2021,Officer,61115,5,5,0
2021,Officer,61201,2,1,1
2021,Officer,61264,4,4,0
2021,Officer,61341,1,1,0
2021,Officer,61401,1,1,0
2021,Officer,61434,2,2,0
2021,Officer,61443,4,4,0
2021,Officer,61607,7,5,2
2021,Officer,61701,5,4,1
2021,Officer,61761,4,3,1
2021,Officer,61801,2,2,0
2021,Officer,61820,1,1,0
2021,Officer,61834,1,1,0
2021,Officer,61938,1,1,0
2021,Officer,62205,1,1,0
2021,Officer,62269,3,3,0
2021,Officer,62286,2,1,1
2021,Officer,62301,3,3,0
2021,Officer,62401,3,2,1
2021,Officer,62439,1,1,0
2021,Officer,62521,2,2,0
2021,Officer,62659,1,1,0
2021,Officer,62702,14,10,4
2021,Officer,62864,3,3,0
2021,Officer,62896,1,0,1
2021,Officer,62959,3,3,0
2021,Officer,62966,8,5,3
2021,Officer,63020,1,1,0
2021,Officer,63044,4,4,0
2021,Officer,63125,7,7,0
2021,Officer,63401,1,1,0
2021,Officer,63552,1,1,0
2021,Officer,63645,1,1,0
2021,Officer,63701,1,1,0
2021,Officer,63755,1,1,0
2021,Officer,63857,1,1,0
2021,Officer,64093,2,2,0
2021,Officer,64129,11,10,1
2021,Officer,64601,1,1,0
2021,Officer,64735,1,1,0
2021,Officer,64804,2,2,0
2021,Officer,64850,1,1,0
2021,Officer,65101,6,4,2
2021,Officer,65109,2,2,0
2021,Officer,65251,1,0,1
2021,Officer,65265,1,1,0
2021,Officer,65301,5,4,1
2021,Officer,65305,2,2,0
2021,Officer,65401,1,1,0
2021,Officer,65536,1,1,0
2021,Officer,65605,1,1,0
2021,Officer,65775,1,1,0
2021,Officer,65802,2,2,0
2021,Officer,65803,1,1,0
2021,Officer,66027,5,5,0
2021,Officer,66044,2,2,0
2021,Officer,66061,2,2,0
2021,Officer,66071,1,1,0
2021,Officer,66102,2,2,0
2021,Officer,66219,6,6,0
2021,Officer,66434,3,1,2
2021,Officer,66502,2,2,0
2021,Officer,66619,9,9,0
2021,Officer,67010,1,1,0
2021,Officer,67217,1,1,0
2021,Officer,67219,3,3,0
2021,Officer,67410,1,1,0
2021,Officer,67501,1,1,0
2021,Officer,67601,1,1,0
2021,Officer,67801,1,1,0
2021,Officer,68073,6,6,0
2021,Officer,68142,2,2,0
2021,Officer,68310,2,2,0
2021,Officer,68508,1,1,0
2021,Officer,68524,10,8,2
2021,Officer,68601,1,1,0
2021,Officer,68801,3,3,0
2021,Officer,68822,1,1,0
2021,Officer,68847,2,2,0
2021,Officer,68901,1,1,0
2021,Officer,69337,1,1,0
2021,Officer,70084,1,1,0
2021,Officer,70117,11,10,1
2021,Officer,70301,1,1,0
2021,Officer,70401,4,4,0
2021,Officer,70427,3,3,0
2021,Officer,70433,1,1,0
2021,Officer,70460,1,1,0
2021,Officer,70508,8,8,0
2021,Officer,70510,2,2,0
2021,Officer,70563,2,2,0
2021,Officer,70570,1,1,0
2021,Officer,70601,2,2,0
2021,Officer,70633,1,1,0
2021,Officer,70714,1,1,0
2021,Officer,70721,8,8,0
2021,Officer,70737,2,2,0
2021,Officer,70760,1,1,0
2021,Officer,70820,2,2,0
2021,Officer,71055,2,2,0
2021,Officer,71101,5,5,0
2021,Officer,71111,1,1,0
2021,Officer,71203,1,1,0
2021,Officer,71220,2,2,0
2021,Officer,71270,1,1,0
2021,Officer,71292,1,1,0
2021,Officer,71351,2,2,0
2021,Officer,71360,8,7,1
2021,Officer,71415,1,1,0
2021,Officer,71459,1,1,0
2021,Officer,71602,3,3,0
2021,Officer,71730,2,2,0
2021,Officer,71832,1,1,0
2021,Officer,71913,1,0,1
2021,Officer,71923,1,1,0
2021,Officer,72006,1,1,0
2021,Officer,72012,3,3,0
2021,Officer,72032,3,3,0
2021,Officer,72086,1,1,0
2021,Officer,72119,3,3,0
2021,Officer,72199,20,12,8
2021,Officer,72335,2,2,0
2021,Officer,72401,3,3,0
2021,Officer,72432,1,1,0
2021,Officer,72653,2,2,0
2021,Officer,72701,1,1,0
2021,Officer,72712,1,1,0
2021,Officer,72713,1,1,0
2021,Officer,72744,1,1,0
2021,Officer,72756,1,1,0
2021,Officer,72761,2,2,0
2021,Officer,72802,2,2,0
2021,Officer,72830,1,1,0
2021,Officer,72855,6,6,0
2021,Officer,72923,5,5,0
2021,Officer,72949,3,3,0
2021,Officer,73034,2,2,0
2021,Officer,73036,2,2,0
2021,Officer,73051,3,2,1
2021,Officer,73064,8,8,0
2021,Officer,73069,11,6,5
2021,Officer,73111,12,9,3
2021,Officer,73401,2,1,1
2021,Officer,73501,2,2,0
2021,Officer,73503,3,3,0
2021,Officer,73521,1,1,0
2021,Officer,73705,2,2,0
2021,Officer,74012,2,2,0
2021,Officer,74014,5,4,1
2021,Officer,74017,2,2,0
2021,Officer,74107,6,5,1
2021,Officer,74116,1,1,0
2021,Officer,74403,1,1,0
2021,Officer,74447,1,1,0
2021,Officer,74501,1,1,0
2021,Officer,74601,2,2,0
2021,Officer,74701,1,1,0
2021,Officer,75051,14,13,1
2021,Officer,75077,2,2,0
2021,Officer,75098,3,3,0
2021,Officer,75159,2,2,0
2021,Officer,75570,1,1,0
2021,Officer,75662,1,1,0
2021,Officer,75709,1,1,0
2021,Officer,75803,2,2,0
2021,Officer,75901,1,1,0
2021,Officer,76115,2,2,0
2021,Officer,76207,1,1,0
2021,Officer,76302,3,3,0
2021,Officer,76502,4,4,0
2021,Officer,76528,1,1,0
2021,Officer,76542,1,1,0
2021,Officer,76574,1,1,0
2021,Officer,76707,8,8,0
2021,Officer,77034,12,11,1
2021,Officer,77067,5,5,0
2021,Officer,77082,6,6,0
2021,Officer,77515,1,1,0
2021,Officer,77568,3,1,2
2021,Officer,77802,2,2,0
2021,Officer,77833,2,2,0
2021,Officer,77904,1,1,0
2021,Officer,78041,2,2,0
2021,Officer,78130,2,2,0
2021,Officer,78218,10,9,1
2021,Officer,78219,5,4,1
2021,Officer,78257,9,8,1
2021,Officer,78416,4,4,0
2021,Officer,78520,1,1,0
2021,Officer,78596,5,5,0
2021,Officer,78602,5,5,0
2021,Officer,78617,6,6,0
2021,Officer,78624,2,2,0
2021,Officer,78665,3,3,0
2021,Officer,78666,9,8,1
2021,Officer,78703,21,13,8
2021,Officer,78731,2,2,0
2021,Officer,78746,1,1,0
2021,Officer,79107,1,1,0
2021,Officer,79403,8,6,2
2021,Officer,79607,3,3,0
2021,Officer,79918,1,1,0
2021,Officer,79924,2,2,0
2021,Officer,79936,4,4,0
2021,Officer,80011,12,11,1
2021,Officer,80012,1,1,0
2021,Officer,80112,4,1,3
2021,Officer,80137,5,5,0
2021,Officer,80216,3,3,0
2021,Officer,80501,1,1,0
2021,Officer,80504,1,1,0
2021,Officer,80521,4,4,0
2021,Officer,80907,1,1,0
2021,Officer,80913,4,4,0
2021,Officer,80916,6,6,0
2021,Officer,80920,12,12,0
2021,Officer,81401,1,1,0
2021,Officer,82005,1,1,0
2021,Officer,82009,1,1,0
2021,Officer,82520,1,1,0
2021,Officer,82604,1,1,0
2021,Officer,82716,1,1,0
2021,Officer,82930,1,1,0
2021,Officer,83202,4,3,1
2021,Officer,83221,1,1,0
2021,Officer,83301,3,3,0
2021,Officer,83318,2,2,0
2021,Officer,83338,1,1,0
2021,Officer,83440,1,1,0
2021,Officer,83530,1,1,0
2021,Officer,83605,2,1,1
2021,Officer,83617,1,1,0
2021,Officer,83647,1,1,0
2021,Officer,83687,5,4,1
2021,Officer,83705,27,26,1
2021,Officer,83854,2,2,0
2021,Officer,84003,3,3,0
2021,Officer,84020,9,7,2
2021,Officer,84043,4,4,0
2021,Officer,84058,4,4,0
2021,Officer,84065,19,17,2
2021,Officer,84084,8,8,0
2021,Officer,84302,1,1,0
2021,Officer,84404,2,2,0
2021,Officer,84405,1,1,0
2021,Officer,84501,1,1,0
2021,Officer,84660,1,1,0
2021,Officer,84701,3,3,0
2021,Officer,84721,3,3,0
2021,Officer,84790,2,1,1
2021,Officer,85008,31,29,2
2021,Officer,85020,2,2,0
2021,Officer,85128,2,2,0
2021,Officer,85132,6,6,0
2021,Officer,85201,3,3,0
2021,Officer,85222,1,1,0
2021,Officer,85281,3,3,0
2021,Officer,85301,1,1,0
2021,Officer,85396,2,2,0
2021,Officer,85546,1,1,0
2021,Officer,85713,1,1,0
2021,Officer,86015,6,6,0
2021,Officer,86301,2,2,0
2021,Officer,87002,1,1,0
2021,Officer,87123,9,5,4
2021,Officer,87144,8,7,1
2021,Officer,87502,3,2,1
2021,Officer,87507,1,1,0
2021,Officer,87508,6,6,0
2021,Officer,88001,4,4,0
2021,Officer,88007,2,2,0
2021,Officer,88203,2,2,0
2021,Officer,88240,1,1,0
2021,Officer,88310,2,2,0
2021,Officer,88435,1,1,0
2021,Officer,89002,1,1,0
2021,Officer,89139,5,5,0
2021,Officer,89165,6,6,0
2021,Officer,89406,1,1,0
2021,Officer,89502,1,1,0
2021,Officer,89506,2,2,0
2021,Officer,89701,4,4,0
2021,Officer,90025,2,1,1
2021,Officer,90201,3,2,1
2021,Officer,90249,2,2,0
2021,Officer,90266,2,2,0
2021,Officer,90302,3,2,1
2021,Officer,90720,17,16,1
2021,Officer,90731,2,2,0
2021,Officer,90822,5,5,0
2021,Officer,91205,1,1,0
2021,Officer,91406,1,1,0
2021,Officer,91505,5,4,1
2021,Officer,91702,4,4,0
2021,Officer,91764,2,2,0
2021,Officer,92020,1,1,0
2021,Officer,92025,1,1,0
2021,Officer,92111,2,2,0
2021,Officer,92243,1,1,0
2021,Officer,92311,1,1,0
2021,Officer,92324,3,3,0
2021,Officer,92518,1,1,0
2021,Officer,92707,1,1,0
2021,Officer,92866,1,1,0
2021,Officer,93003,2,2,0
2021,Officer,93307,3,3,0
2021,Officer,93405,2,2,0
2021,Officer,93451,3,3,0
2021,Officer,93536,1,0,1
2021,Officer,93727,2,2,0
2021,Officer,94043,1,1,0
2021,Officer,94510,3,3,0
2021,Officer,94519,2,2,0
2021,Officer,94533,1,0,1
2021,Officer,94590,1,1,0
2021,Officer,94804,3,3,0
2021,Officer,94952,3,2,1
2021,Officer,95110,2,2,0
2021,Officer,95206,5,5,0
2021,Officer,95240,1,1,0
2021,Officer,95341,1,1,0
2021,Officer,95351,1,0,1
2021,Officer,95401,3,3,0
2021,Officer,95655,1,1,0
2021,Officer,95827,6,3,3
2021,Officer,95828,10,7,3
2021,Officer,95832,1,1,0
2021,Officer,96067,1,1,0
2021,Officer,96707,12,12,0
2021,Officer,96720,5,5,0
2021,Officer,96753,1,0,1
2021,Officer,96782,1,0,1
2021,Officer,96857,4,3,1
2021,Officer,96913,16,15,1
2021,Officer,97015,6,6,0
2021,Officer,97051,1,1,0
2021,Officer,97058,1,1,0
2021,Officer,97211,6,5,1
2021,Officer,97217,1,1,0
2021,Officer,97301,21,17,4
2021,Officer,97302,3,3,0
2021,Officer,97477,2,2,0
2021,Officer,97501,2,2,0
2021,Officer,97520,2,2,0
2021,Officer,97702,2,2,0
2021,Officer,97756,1,1,0
2021,Officer,97850,2,2,0
2021,Officer,97914,1,1,0
2021,Officer,98032,4,4,0
2021,Officer,98052,1,1,0
2021,Officer,98108,1,1,0
2021,Officer,98119,12,11,1
2021,Officer,98271,4,4,0
2021,Officer,98290,1,1,0
2021,Officer,98312,1,1,0
2021,Officer,98321,2,2,0
2021,Officer,98372,1,1,0
2021,Officer,98430,17,17,0
2021,Officer,98433,11,11,0
2021,Officer,98501,6,6,0
2021,Officer,98563,4,4,0
2021,Officer,98823,1,1,0
2021,Officer,98837,1,1,0
2021,Officer,98901,2,2,0
2021,Officer,98903,3,3,0
2021,Officer,99011,1,1,0
2021,Officer,99217,4,3,1
2021,Officer,99301,4,4,0
2021,Officer,99505,13,13,0
2021,Officer,99654,2,2,0
2021,Officer,99731,3,3,0
2021,Warrant Officer,00751,1,1,0
2021,Warrant Officer,00795,1,1,0
2021,Warrant Officer,00907,4,4,0
2021,Warrant Officer,00951,1,1,0
2021,Warrant Officer,01434,1,1,0
2021,Warrant Officer,01731,1,1,0
2021,Warrant Officer,01867,1,1,0
2021,Warrant Officer,02542,9,9,0
2021,Warrant Officer,02818,1,1,0
2021,Warrant Officer,02852,2,2,0
2021,Warrant Officer,02886,2,2,0
2021,Warrant Officer,03244,1,1,0
2021,Warrant Officer,03301,7,7,0
2021,Warrant Officer,04011,2,2,0
2021,Warrant Officer,04330,1,1,0
2021,Warrant Officer,04401,5,5,0
2021,Warrant Officer,05403,4,4,0
2021,Warrant Officer,05446,1,1,0
2021,Warrant Officer,06066,1,1,0
2021,Warrant Officer,06096,4,4,0
2021,Warrant Officer,06105,3,3,0
2021,Warrant Officer,06340,5,5,0
2021,Warrant Officer,06457,1,1,0
2021,Warrant Officer,06702,1,1,0
2021,Warrant Officer,08210,1,1,0
2021,Warrant Officer,08640,4,4,0
2021,Warrant Officer,08648,2,2,0
2021,Warrant Officer,08733,8,8,0
2021,Warrant Officer,08759,1,1,0
2021,Warrant Officer,08873,1,1,0
2021,Warrant Officer,10037,2,2,0
2021,Warrant Officer,10314,1,1,0
2021,Warrant Officer,10566,1,1,0
2021,Warrant Officer,10567,1,1,0
2021,Warrant Officer,10701,1,1,0
2021,Warrant Officer,11433,1,1,0
2021,Warrant Officer,11735,1,1,0
2021,Warrant Officer,12110,6,6,0
2021,Warrant Officer,12180,1,1,0
2021,Warrant Officer,14624,6,6,0
2021,Warrant Officer,15301,1,1,0
2021,Warrant Officer,15902,5,5,0
2021,Warrant Officer,17003,12,12,0
2021,Warrant Officer,17042,1,1,0
2021,Warrant Officer,17103,2,2,0
2021,Warrant Officer,18509,1,1,0
2021,Warrant Officer,19044,1,1,0
2021,Warrant Officer,19104,1,1,0
2021,Warrant Officer,19720,4,4,0
2021,Warrant Officer,19977,1,1,0
2021,Warrant Officer,20003,2,2,0
2021,Warrant Officer,20653,1,1,0
2021,Warrant Officer,20783,1,1,0
2021,Warrant Officer,21010,12,12,0
2021,Warrant Officer,21136,1,1,0
2021,Warrant Officer,21204,2,2,0
2021,Warrant Officer,21401,3,3,0
2021,Warrant Officer,22060,1,1,0
2021,Warrant Officer,22401,1,1,0
2021,Warrant Officer,22427,1,1,0
2021,Warrant Officer,23139,1,1,0
2021,Warrant Officer,23150,8,8,0
2021,Warrant Officer,23451,1,1,0
2021,Warrant Officer,23824,2,2,0
2021,Warrant Officer,24401,1,1,0
2021,Warrant Officer,25064,1,1,0
2021,Warrant Officer,25530,2,2,0
2021,Warrant Officer,26003,3,3,0
2021,Warrant Officer,26187,5,5,0
2021,Warrant Officer,26301,1,1,0
2021,Warrant Officer,26537,2,2,0
2021,Warrant Officer,27401,2,2,0
2021,Warrant Officer,27560,16,16,0
2021,Warrant Officer,27607,1,1,0
2021,Warrant Officer,28054,1,1,0
2021,Warrant Officer,28147,1,1,0
2021,Warrant Officer,28208,1,1,0
2021,Warrant Officer,28310,1,1,0
2021,Warrant Officer,28328,1,1,0
2021,Warrant Officer,28334,1,1,0
2021,Warrant Officer,28658,1,1,0
2021,Warrant Officer,29044,14,14,0
2021,Warrant Officer,29138,1,1,0
2021,Warrant Officer,29153,1,1,0
2021,Warrant Officer,29201,2,2,0
2021,Warrant Officer,29303,1,1,0
2021,Warrant Officer,29360,1,1,0
2021,Warrant Officer,29409,1,1,0
2021,Warrant Officer,29605,1,1,0
2021,Warrant Officer,29631,1,1,0
2021,Warrant Officer,30060,13,13,0
2021,Warrant Officer,30240,1,1,0
2021,Warrant Officer,30294,2,2,0
2021,Warrant Officer,30297,2,2,0
2021,Warrant Officer,30680,2,2,0
2021,Warrant Officer,31211,2,2,0
2021,Warrant Officer,31406,1,1,0
2021,Warrant Officer,31409,1,1,0
2021,Warrant Officer,31792,1,1,0
2021,Warrant Officer,31905,2,2,0
2021,Warrant Officer,32064,1,1,0
2021,Warrant Officer,32084,2,2,0
2021,Warrant Officer,32086,1,1,0
2021,Warrant Officer,32091,3,3,0
2021,Warrant Officer,32221,2,2,0
2021,Warrant Officer,32311,1,1,0
2021,Warrant Officer,33027,1,1,0
2021,Warrant Officer,33315,1,1,0
2021,Warrant Officer,33606,1,1,0
2021,Warrant Officer,33711,1,1,0
2021,Warrant Officer,33782,3,3,0
2021,Warrant Officer,33873,1,1,0
2021,Warrant Officer,34266,1,1,0
2021,Warrant Officer,34604,4,4,0
2021,Warrant Officer,35121,1,1,0
2021,Warrant Officer,35209,3,3,0
2021,Warrant Officer,35217,4,4,0
2021,Warrant Officer,35565,1,1,0
2021,Warrant Officer,35601,3,3,0
2021,Warrant Officer,36043,6,6,0
2021,Warrant Officer,36109,2,2,0
2021,Warrant Officer,36205,3,3,0
2021,Warrant Officer,36608,5,5,0
2021,Warrant Officer,37090,1,1,0
2021,Warrant Officer,37217,1,1,0
2021,Warrant Officer,37404,1,1,0
2021,Warrant Officer,37777,3,3,0
2021,Warrant Officer,38261,1,1,0
2021,Warrant Officer,38301,1,1,0
2021,Warrant Officer,38671,1,1,0
2021,Warrant Officer,38930,1,1,0
2021,Warrant Officer,39194,1,1,0
2021,Warrant Officer,39202,2,2,0
2021,Warrant Officer,39204,1,1,0
2021,Warrant Officer,39209,4,4,0
2021,Warrant Officer,39216,1,1,0
2021,Warrant Officer,39307,1,1,0
2021,Warrant Officer,39401,2,2,0
2021,Warrant Officer,39407,3,3,0
2021,Warrant Officer,39440,3,3,0
2021,Warrant Officer,39466,2,2,0
2021,Warrant Officer,39505,1,1,0
2021,Warrant Officer,39654,3,3,0
2021,Warrant Officer,40205,3,3,0
2021,Warrant Officer,40213,1,1,0
2021,Warrant Officer,40475,1,1,0
2021,Warrant Officer,40510,1,1,0
2021,Warrant Officer,40601,5,5,0
2021,Warrant Officer,42101,2,2,0
2021,Warrant Officer,42141,1,1,0
2021,Warrant Officer,42301,2,2,0
2021,Warrant Officer,42330,1,1,0
2021,Warrant Officer,43055,1,1,0
2021,Warrant Officer,43213,1,1,0
2021,Warrant Officer,43217,5,5,0
2021,Warrant Officer,43235,2,2,0
2021,Warrant Officer,44128,1,1,0
2021,Warrant Officer,44720,1,1,0
2021,Warrant Officer,44857,1,1,0
2021,Warrant Officer,45502,1,1,0
2021,Warrant Officer,46124,1,1,0
2021,Warrant Officer,46176,4,4,0
2021,Warrant Officer,46216,3,3,0
2021,Warrant Officer,46241,8,8,0
2021,Warrant Officer,46402,1,1,0
2021,Warrant Officer,46406,4,4,0
2021,Warrant Officer,46825,1,1,0
2021,Warrant Officer,46901,1,1,0
2021,Warrant Officer,47303,1,1,0
2021,Warrant Officer,47374,1,1,0
2021,Warrant Officer,47421,1,1,0
2021,Warrant Officer,47715,1,1,0
2021,Warrant Officer,48045,1,1,0
2021,Warrant Officer,48208,1,1,0
2021,Warrant Officer,48234,2,2,0
2021,Warrant Officer,48837,9,9,0
2021,Warrant Officer,48906,7,7,0
2021,Warrant Officer,49012,2,2,0
2021,Warrant Officer,49739,1,1,0
2021,Warrant Officer,49801,1,1,0
2021,Warrant Officer,49855,1,1,0
2021,Warrant Officer,50036,1,1,0
2021,Warrant Officer,50131,6,6,0
2021,Warrant Officer,50501,1,1,0
2021,Warrant Officer,51201,1,1,0
2021,Warrant Officer,52002,1,1,0
2021,Warrant Officer,52246,1,1,0
2021,Warrant Officer,52556,1,1,0
2021,Warrant Officer,52732,1,1,0
2021,Warrant Officer,53089,1,1,0
2021,Warrant Officer,53095,5,5,0
2021,Warrant Officer,53212,3,3,0
2021,Warrant Officer,53704,4,4,0
2021,Warrant Officer,54618,3,3,0
2021,Warrant Officer,54932,1,1,0
2021,Warrant Officer,55008,1,1,0
2021,Warrant Officer,55021,3,3,0
2021,Warrant Officer,55068,2,2,0
2021,Warrant Officer,55077,1,1,0
2021,Warrant Officer,55107,3,2,1
2021,Warrant Officer,55112,1,1,0
2021,Warrant Officer,55431,1,1,0
2021,Warrant Officer,56273,1,1,0
2021,Warrant Officer,56301,2,2,0
2021,Warrant Officer,56303,1,1,0
2021,Warrant Officer,56345,3,3,0
2021,Warrant Officer,57201,1,1,0
2021,Warrant Officer,57501,1,1,0
2021,Warrant Officer,57703,2,2,0
2021,Warrant Officer,58072,1,1,0
2021,Warrant Officer,58075,1,1,0
2021,Warrant Officer,58102,2,2,0
2021,Warrant Officer,58201,1,1,0
2021,Warrant Officer,58501,2,2,0
2021,Warrant Officer,58504,1,1,0
2021,Warrant Officer,58506,1,1,0
2021,Warrant Officer,59602,4,4,0
2021,Warrant Officer,59636,1,1,0
2021,Warrant Officer,59923,1,1,0
2021,Warrant Officer,60546,2,2,0
2021,Warrant Officer,60615,1,1,0
2021,Warrant Officer,60651,2,2,0
2021,Warrant Officer,60901,3,3,0
2021,Warrant Officer,61607,3,3,0
2021,Warrant Officer,61701,1,1,0
2021,Warrant Officer,62521,2,2,0
2021,Warrant Officer,62966,1,1,0
2021,Warrant Officer,64129,1,1,0
2021,Warrant Officer,64506,2,2,0
2021,Warrant Officer,65101,1,1,0
2021,Warrant Officer,65301,2,2,0
2021,Warrant Officer,65305,8,8,0
2021,Warrant Officer,65473,3,3,0
2021,Warrant Officer,65536,1,1,0
2021,Warrant Officer,65605,2,2,0
2021,Warrant Officer,65708,1,1,0
2021,Warrant Officer,66619,3,3,0
2021,Warrant Officer,68524,4,4,0
2021,Warrant Officer,68801,1,1,0
2021,Warrant Officer,68847,1,1,0
2021,Warrant Officer,68901,2,2,0
2021,Warrant Officer,70117,1,1,0
2021,Warrant Officer,70401,5,5,0
2021,Warrant Officer,70410,2,2,0
2021,Warrant Officer,70508,1,1,0
2021,Warrant Officer,71270,1,1,0
2021,Warrant Officer,71303,2,2,0
2021,Warrant Officer,71360,3,3,0
2021,Warrant Officer,72064,1,1,0
2021,Warrant Officer,72199,12,12,0
2021,Warrant Officer,72543,1,1,0
2021,Warrant Officer,72701,1,1,0
2021,Warrant Officer,72923,1,1,0
2021,Warrant Officer,73064,2,2,0
2021,Warrant Officer,73069,3,3,0
2021,Warrant Officer,73111,1,1,0
2021,Warrant Officer,73141,1,1,0
2021,Warrant Officer,73501,3,3,0
2021,Warrant Officer,74014,2,2,0
2021,Warrant Officer,74112,1,1,0
2021,Warrant Officer,74116,6,6,0
2021,Warrant Officer,75051,3,3,0
2021,Warrant Officer,76108,1,1,0
2021,Warrant Officer,76115,2,2,0
2021,Warrant Officer,76528,1,1,0
2021,Warrant Officer,77034,5,5,0
2021,Warrant Officer,77067,2,2,0
2021,Warrant Officer,77082,2,2,0
2021,Warrant Officer,78218,2,2,0
2021,Warrant Officer,78219,4,4,0
2021,Warrant Officer,78617,8,8,0
2021,Warrant Officer,78665,1,1,0
2021,Warrant Officer,78703,3,3,0
2021,Warrant Officer,78731,1,1,0
2021,Warrant Officer,79936,1,1,0
2021,Warrant Officer,80011,10,10,0
2021,Warrant Officer,80112,2,2,0
2021,Warrant Officer,80216,2,2,0
2021,Warrant Officer,80907,1,1,0
2021,Warrant Officer,80913,1,1,0
2021,Warrant Officer,80916,1,1,0
2021,Warrant Officer,82005,2,2,0
2021,Warrant Officer,82009,1,1,0
2021,Warrant Officer,82240,1,1,0
2021,Warrant Officer,83202,1,1,0
2021,Warrant Officer,83338,1,1,0
2021,Warrant Officer,83501,1,1,0
2021,Warrant Officer,83705,12,12,0
2021,Warrant Officer,84020,3,3,0
2021,Warrant Officer,84065,5,5,0
2021,Warrant Officer,84084,5,5,0
2021,Warrant Officer,84116,1,1,0
2021,Warrant Officer,84660,1,1,0
2021,Warrant Officer,85008,5,5,0
2021,Warrant Officer,85132,1,1,0
2021,Warrant Officer,85653,4,4,0
2021,Warrant Officer,86015,1,1,0
2021,Warrant Officer,87502,1,1,0
2021,Warrant Officer,87507,1,1,0
2021,Warrant Officer,87508,2,2,0
2021,Warrant Officer,88001,2,2,0
2021,Warrant Officer,89034,1,1,0
2021,Warrant Officer,89139,2,2,0
2021,Warrant Officer,89506,2,2,0
2021,Warrant Officer,89701,4,4,0
2021,Warrant Officer,90249,1,1,0
2021,Warrant Officer,90720,12,12,0
2021,Warrant Officer,90822,3,3,0
2021,Warrant Officer,91205,1,1,0
2021,Warrant Officer,92111,2,2,0
2021,Warrant Officer,93405,4,4,0
2021,Warrant Officer,93422,1,1,0
2021,Warrant Officer,93727,3,3,0
2021,Warrant Officer,94903,2,2,0
2021,Warrant Officer,95206,1,1,0
2021,Warrant Officer,95655,3,3,0
2021,Warrant Officer,95827,1,1,0
2021,Warrant Officer,96707,1,1,0
2021,Warrant Officer,96720,1,1,0
2021,Warrant Officer,96857,2,2,0
2021,Warrant Officer,96913,1,1,0
2021,Warrant Officer,97217,1,1,0
2021,Warrant Officer,97218,1,1,0
2021,Warrant Officer,97301,2,2,0
2021,Warrant Officer,97302,3,3,0
2021,Warrant Officer,97801,3,3,0
2021,Warrant Officer,98119,2,2,0
2021,Warrant Officer,98433,9,9,0
2021,Warrant Officer,98501,3,3,0
2021,Warrant Officer,99011,1,1,0
2021,Warrant Officer,99505,7,7,0
2022,Enlisted,     ,14,2,12
2022,Enlisted,00000,78,19,59
2022,Enlisted,00604,15,2,13
2022,Enlisted,00612,11,0,11
2022,Enlisted,00623,12,1,11
2022,Enlisted,00624,7,0,7
2022,Enlisted,00641,9,0,9
2022,Enlisted,00682,43,2,41
2022,Enlisted,00693,23,5,18
2022,Enlisted,00705,9,0,9
2022,Enlisted,00714,2,0,2
2022,Enlisted,00725,12,0,12
2022,Enlisted,00733,3,0,3
2022,Enlisted,00735,7,1,6
2022,Enlisted,00736,22,0,22
2022,Enlisted,00751,6,0,6
2022,Enlisted,00769,24,0,24
2022,Enlisted,00778,20,1,19
2022,Enlisted,00785,6,1,5
2022,Enlisted,00792,6,0,6
2022,Enlisted,00795,45,1,44
2022,Enlisted,00802,21,0,21
2022,Enlisted,00820,1,0,1
2022,Enlisted,00840,2,0,2
2022,Enlisted,00850,3,0,3
2022,Enlisted,00901,1,0,1
2022,Enlisted,00907,9,2,7
2022,Enlisted,00934,126,6,120
2022,Enlisted,01013,8,6,2
2022,Enlisted,01022,2,2,0
2022,Enlisted,01030,10,3,7
2022,Enlisted,01062,4,0,4
2022,Enlisted,01082,16,0,16
2022,Enlisted,01085,9,1,8
2022,Enlisted,01109,8,2,6
2022,Enlisted,01201,8,0,8
2022,Enlisted,01434,36,11,25
2022,Enlisted,01440,8,6,2
2022,Enlisted,01453,8,1,7
2022,Enlisted,01588,6,3,3
2022,Enlisted,01605,46,8,38
2022,Enlisted,01702,9,0,9
2022,Enlisted,01731,12,0,12
2022,Enlisted,01742,2,2,0
2022,Enlisted,01760,31,7,24
2022,Enlisted,01844,14,1,13
2022,Enlisted,01867,49,6,43
2022,Enlisted,01923,8,2,6
2022,Enlisted,01950,15,2,13
2022,Enlisted,02043,29,4,25
2022,Enlisted,02122,16,1,15
2022,Enlisted,02138,18,8,10
2022,Enlisted,02169,18,7,11
2022,Enlisted,02176,21,2,19
2022,Enlisted,02184,9,5,4
2022,Enlisted,02301,13,1,12
2022,Enlisted,02324,4,2,2
2022,Enlisted,02346,19,7,12
2022,Enlisted,02532,14,3,11
2022,Enlisted,02542,38,7,31
2022,Enlisted,02724,13,0,13
2022,Enlisted,02769,21,1,20
2022,Enlisted,02780,17,1,16
2022,Enlisted,02809,1,0,1
2022,Enlisted,02818,110,34,76
2022,Enlisted,02842,12,8,4
2022,Enlisted,02852,21,2,19
2022,Enlisted,02886,12,3,9
2022,Enlisted,02904,10,1,9
2022,Enlisted,02906,3,0,3
2022,Enlisted,02920,1,0,1
2022,Enlisted,03055,21,7,14
2022,Enlisted,03060,8,3,5
2022,Enlisted,03101,25,4,21
2022,Enlisted,03244,11,1,10
2022,Enlisted,03264,3,0,3
2022,Enlisted,03275,26,5,21
2022,Enlisted,03301,12,5,7
2022,Enlisted,03561,4,1,3
2022,Enlisted,03766,4,0,4
2022,Enlisted,03801,6,0,6
2022,Enlisted,03815,1,1,0
2022,Enlisted,03867,6,0,6
2022,Enlisted,03884,3,1,2
2022,Enlisted,04011,14,2,12
2022,Enlisted,04073,3,0,3
2022,Enlisted,04092,6,0,6
2022,Enlisted,04240,13,1,12
2022,Enlisted,04268,6,2,4
2022,Enlisted,04330,13,5,8
2022,Enlisted,04401,26,6,20
2022,Enlisted,04412,18,2,16
2022,Enlisted,04619,6,2,4
2022,Enlisted,04730,1,0,1
2022,Enlisted,04736,7,3,4
2022,Enlisted,04901,14,0,14
2022,Enlisted,04976,8,0,8
2022,Enlisted,05001,8,2,6
2022,Enlisted,05033,15,1,14
2022,Enlisted,05158,4,0,4
2022,Enlisted,05403,9,1,8
2022,Enlisted,05404,5,0,5
2022,Enlisted,05446,15,10,5
2022,Enlisted,05465,10,2,8
2022,Enlisted,05478,1,0,1
2022,Enlisted,05491,6,0,6
2022,Enlisted,05495,9,3,6
2022,Enlisted,05633,6,0,6
2022,Enlisted,05661,3,1,2
2022,Enlisted,05663,12,8,4
2022,Enlisted,05701,3,1,2
2022,Enlisted,05851,1,1,0
2022,Enlisted,05855,2,1,1
2022,Enlisted,06051,8,1,7
2022,Enlisted,06066,1,0,1
2022,Enlisted,06082,17,1,16
2022,Enlisted,06096,30,9,21
2022,Enlisted,06105,1,0,1
2022,Enlisted,06110,12,4,8
2022,Enlisted,06320,20,5,15
2022,Enlisted,06333,1,0,1
2022,Enlisted,06340,18,8,10
2022,Enlisted,06357,13,4,9
2022,Enlisted,06360,18,1,17
2022,Enlisted,06457,44,6,38
2022,Enlisted,06489,17,3,14
2022,Enlisted,06497,18,7,11
2022,Enlisted,06498,19,3,16
2022,Enlisted,06512,17,4,13
2022,Enlisted,06702,5,1,4
2022,Enlisted,06810,12,7,5
2022,Enlisted,07052,57,12,45
2022,Enlisted,07090,21,0,21
2022,Enlisted,07095,33,4,29
2022,Enlisted,07107,26,8,18
2022,Enlisted,07306,35,10,25
2022,Enlisted,07457,14,3,11
2022,Enlisted,07666,51,4,47
2022,Enlisted,07728,27,3,24
2022,Enlisted,07806,31,7,24
2022,Enlisted,07840,5,0,5
2022,Enlisted,07865,23,4,19
2022,Enlisted,07871,8,2,6
2022,Enlisted,07960,36,5,31
2022,Enlisted,08002,28,3,25
2022,Enlisted,08012,18,3,15
2022,Enlisted,08037,18,1,17
2022,Enlisted,08060,17,4,13
2022,Enlisted,08063,1,0,1
2022,Enlisted,08096,20,2,18
2022,Enlisted,08098,8,1,7
2022,Enlisted,08210,13,1,12
2022,Enlisted,08360,19,2,17
2022,Enlisted,08401,7,0,7
2022,Enlisted,08640,3,2,1
2022,Enlisted,08648,16,5,11
2022,Enlisted,08733,36,8,28
2022,Enlisted,08750,32,5,27
2022,Enlisted,08755,9,2,7
2022,Enlisted,08759,14,4,10
2022,Enlisted,08822,5,0,5
2022,Enlisted,08873,35,1,34
2022,Enlisted,10010,77,13,64
2022,Enlisted,10021,3,0,3
2022,Enlisted,10037,95,9,86
2022,Enlisted,10314,38,3,35
2022,Enlisted,10468,15,0,15
2022,Enlisted,10566,48,6,42
2022,Enlisted,10567,95,12,83
2022,Enlisted,10701,25,1,24
2022,Enlisted,10962,23,1,22
2022,Enlisted,11209,75,5,70
2022,Enlisted,11252,52,13,39
2022,Enlisted,11357,8,0,8
2022,Enlisted,11433,70,8,62
2022,Enlisted,11735,33,5,28
2022,Enlisted,11746,17,3,14
2022,Enlisted,11779,48,1,47
2022,Enlisted,12078,8,4,4
2022,Enlisted,12110,88,10,78
2022,Enlisted,12180,21,6,15
2022,Enlisted,12189,7,1,6
2022,Enlisted,12301,26,2,24
2022,Enlisted,12401,9,2,7
2022,Enlisted,12451,4,2,2
2022,Enlisted,12553,33,2,31
2022,Enlisted,12804,20,3,17
2022,Enlisted,12962,4,3,1
2022,Enlisted,13021,14,4,10
2022,Enlisted,13211,28,4,24
2022,Enlisted,13501,27,5,22
2022,Enlisted,13502,10,5,5
2022,Enlisted,13643,8,3,5
2022,Enlisted,13856,12,1,11
2022,Enlisted,13905,14,0,14
2022,Enlisted,14048,16,0,16
2022,Enlisted,14094,9,0,9
2022,Enlisted,14204,50,15,35
2022,Enlisted,14213,35,3,32
2022,Enlisted,14304,3,1,2
2022,Enlisted,14454,11,4,7
2022,Enlisted,14456,15,2,13
2022,Enlisted,14624,74,7,67
2022,Enlisted,14701,1,0,1
2022,Enlisted,14760,3,1,2
2022,Enlisted,14843,5,1,4
2022,Enlisted,14845,9,0,9
2022,Enlisted,14850,11,1,10
2022,Enlisted,15010,16,2,14
2022,Enlisted,15216,25,3,22
2022,Enlisted,15301,16,3,13
2022,Enlisted,15370,19,8,11
2022,Enlisted,15425,6,3,3
2022,Enlisted,15444,19,4,15
2022,Enlisted,15537,5,3,2
2022,Enlisted,15541,7,1,6
2022,Enlisted,15601,14,3,11
2022,Enlisted,15666,18,5,13
2022,Enlisted,15701,15,2,13
2022,Enlisted,15767,10,2,8
2022,Enlisted,15779,4,0,4
2022,Enlisted,15902,15,1,14
2022,Enlisted,15904,43,6,37
2022,Enlisted,16001,28,6,22
2022,Enlisted,16101,11,3,8
2022,Enlisted,16127,17,1,16
2022,Enlisted,16148,17,1,16
2022,Enlisted,16226,7,0,7
2022,Enlisted,16403,57,7,50
2022,Enlisted,16635,15,4,11
2022,Enlisted,16652,6,2,4
2022,Enlisted,16738,8,2,6
2022,Enlisted,16803,15,3,12
2022,Enlisted,16830,6,0,6
2022,Enlisted,16901,3,1,2
2022,Enlisted,17003,171,23,148
2022,Enlisted,17013,20,4,16
2022,Enlisted,17022,26,4,22
2022,Enlisted,17033,6,1,5
2022,Enlisted,17042,24,3,21
2022,Enlisted,17044,11,1,10
2022,Enlisted,17098,3,1,2
2022,Enlisted,17103,20,6,14
2022,Enlisted,17201,3,0,3
2022,Enlisted,17222,3,2,1
2022,Enlisted,17325,14,1,13
2022,Enlisted,17331,4,1,3
2022,Enlisted,17408,7,2,5
2022,Enlisted,17701,16,4,12
2022,Enlisted,17745,2,0,2
2022,Enlisted,17821,1,1,0
2022,Enlisted,17837,5,1,4
2022,Enlisted,18040,17,4,13
2022,Enlisted,18102,28,2,26
2022,Enlisted,18201,11,0,11
2022,Enlisted,18235,7,2,5
2022,Enlisted,18252,9,0,9
2022,Enlisted,18407,5,1,4
2022,Enlisted,18431,5,1,4
2022,Enlisted,18466,2,1,1
2022,Enlisted,18509,41,3,38
2022,Enlisted,18634,2,2,0
2022,Enlisted,18651,5,2,3
2022,Enlisted,18704,26,3,23
2022,Enlisted,18834,7,3,4
2022,Enlisted,18960,15,0,15
2022,Enlisted,19044,42,1,41
2022,Enlisted,19103,7,2,5
2022,Enlisted,19104,12,0,12
2022,Enlisted,19153,39,1,38
2022,Enlisted,19154,125,15,110
2022,Enlisted,19320,32,11,21
2022,Enlisted,19460,8,2,6
2022,Enlisted,19462,26,5,21
2022,Enlisted,19475,22,5,17
2022,Enlisted,19526,4,1,3
2022,Enlisted,19530,23,6,17
2022,Enlisted,19605,18,2,16
2022,Enlisted,19706,15,2,13
2022,Enlisted,19711,8,0,8
2022,Enlisted,19720,14,2,12
2022,Enlisted,19804,11,4,7
2022,Enlisted,19808,2,0,2
2022,Enlisted,19930,2,1,1
2022,Enlisted,19939,7,1,6
2022,Enlisted,19947,5,0,5
2022,Enlisted,19973,14,3,11
2022,Enlisted,19977,5,2,3
2022,Enlisted,20003,27,12,15
2022,Enlisted,20112,34,11,23
2022,Enlisted,20175,23,13,10
2022,Enlisted,20186,12,8,4
2022,Enlisted,20373,21,6,15
2022,Enlisted,20623,10,1,9
2022,Enlisted,20653,6,2,4
2022,Enlisted,20708,35,18,17
2022,Enlisted,20882,13,1,12
2022,Enlisted,20904,19,7,12
2022,Enlisted,21010,38,4,34
2022,Enlisted,21043,1,0,1
2022,Enlisted,21057,13,9,4
2022,Enlisted,21061,10,3,7
2022,Enlisted,21078,16,4,12
2022,Enlisted,21136,30,6,24
2022,Enlisted,21157,7,2,5
2022,Enlisted,21201,3,3,0
2022,Enlisted,21204,10,5,5
2022,Enlisted,21216,16,1,15
2022,Enlisted,21222,19,6,13
2022,Enlisted,21228,16,7,9
2022,Enlisted,21236,5,2,3
2022,Enlisted,21401,10,2,8
2022,Enlisted,21601,4,0,4
2022,Enlisted,21657,1,1,0
2022,Enlisted,21701,6,2,4
2022,Enlisted,21740,2,1,1
2022,Enlisted,21784,8,1,7
2022,Enlisted,21801,7,0,7
2022,Enlisted,22032,8,4,4
2022,Enlisted,22060,43,17,26
2022,Enlisted,22401,39,6,33
2022,Enlisted,22427,8,1,7
2022,Enlisted,22601,7,2,5
2022,Enlisted,22602,12,2,10
2022,Enlisted,22664,8,3,5
2022,Enlisted,22801,7,1,6
2022,Enlisted,22902,20,5,15
2022,Enlisted,23139,15,4,11
2022,Enlisted,23150,32,6,26
2022,Enlisted,23181,22,2,20
2022,Enlisted,23237,16,2,14
2022,Enlisted,23417,2,0,2
2022,Enlisted,23434,4,1,3
2022,Enlisted,23451,69,13,56
2022,Enlisted,23502,27,3,24
2022,Enlisted,23609,9,1,8
2022,Enlisted,23666,12,3,9
2022,Enlisted,23701,15,2,13
2022,Enlisted,23805,13,5,8
2022,Enlisted,23824,28,8,20
2022,Enlisted,23847,8,0,8
2022,Enlisted,23851,1,0,1
2022,Enlisted,23901,4,2,2
2022,Enlisted,24073,10,8,2
2022,Enlisted,24151,9,3,6
2022,Enlisted,24175,2,2,0
2022,Enlisted,24212,10,1,9
2022,Enlisted,24251,12,3,9
2022,Enlisted,24301,14,6,8
2022,Enlisted,24401,7,3,4
2022,Enlisted,24450,7,2,5
2022,Enlisted,24502,31,6,25
2022,Enlisted,24523,13,4,9
2022,Enlisted,24540,13,5,8
2022,Enlisted,24592,7,0,7
2022,Enlisted,24609,7,2,5
2022,Enlisted,24701,9,1,8
2022,Enlisted,24957,16,3,13
2022,Enlisted,25168,51,8,43
2022,Enlisted,25262,5,0,5
2022,Enlisted,25309,4,2,2
2022,Enlisted,25311,81,80,1
2022,Enlisted,25401,16,4,12
2022,Enlisted,25405,20,2,18
2022,Enlisted,25530,12,7,5
2022,Enlisted,25550,5,2,3
2022,Enlisted,25625,17,1,16
2022,Enlisted,25846,40,3,37
2022,Enlisted,26003,11,1,10
2022,Enlisted,26041,20,1,19
2022,Enlisted,26101,16,0,16
2022,Enlisted,26187,9,2,7
2022,Enlisted,26201,27,1,26
2022,Enlisted,26250,16,2,14
2022,Enlisted,26301,11,2,9
2022,Enlisted,26505,15,1,14
2022,Enlisted,26508,3,1,2
2022,Enlisted,26537,30,11,19
2022,Enlisted,26554,9,1,8
2022,Enlisted,26624,4,0,4
2022,Enlisted,26651,18,0,18
2022,Enlisted,27028,1,0,1
2022,Enlisted,27030,2,0,2
2022,Enlisted,27103,42,6,36
2022,Enlisted,27203,2,0,2
2022,Enlisted,27205,1,0,1
2022,Enlisted,27217,21,8,13
2022,Enlisted,27260,20,3,17
2022,Enlisted,27292,11,3,8
2022,Enlisted,27320,9,1,8
2022,Enlisted,27330,6,0,6
2022,Enlisted,27344,11,0,11
2022,Enlisted,27360,4,1,3
2022,Enlisted,27401,27,10,17
2022,Enlisted,27504,25,5,20
2022,Enlisted,27509,16,7,9
2022,Enlisted,27530,14,5,9
2022,Enlisted,27549,11,1,10
2022,Enlisted,27560,49,15,34
2022,Enlisted,27573,4,1,3
2022,Enlisted,27577,14,8,6
2022,Enlisted,27596,9,2,7
2022,Enlisted,27607,25,3,22
2022,Enlisted,27704,26,13,13
2022,Enlisted,27830,6,0,6
2022,Enlisted,27856,1,0,1
2022,Enlisted,27870,10,5,5
2022,Enlisted,27889,1,1,0
2022,Enlisted,28001,11,5,6
2022,Enlisted,28012,3,2,1
2022,Enlisted,28027,24,5,19
2022,Enlisted,28043,3,0,3
2022,Enlisted,28054,11,3,8
2022,Enlisted,28086,5,1,4
2022,Enlisted,28092,10,1,9
2022,Enlisted,28110,8,4,4
2022,Enlisted,28115,5,1,4
2022,Enlisted,28147,8,2,6
2022,Enlisted,28170,13,3,10
2022,Enlisted,28208,24,6,18
2022,Enlisted,28306,32,14,18
2022,Enlisted,28310,7,2,5
2022,Enlisted,28328,4,2,2
2022,Enlisted,28334,10,1,9
2022,Enlisted,28337,5,0,5
2022,Enlisted,28345,11,2,9
2022,Enlisted,28352,12,2,10
2022,Enlisted,28358,12,6,6
2022,Enlisted,28371,3,2,1
2022,Enlisted,28376,15,8,7
2022,Enlisted,28377,16,6,10
2022,Enlisted,28379,9,4,5
2022,Enlisted,28382,2,0,2
2022,Enlisted,28384,8,1,7
2022,Enlisted,28387,3,1,2
2022,Enlisted,28401,5,5,0
2022,Enlisted,28405,8,3,5
2022,Enlisted,28459,5,3,2
2022,Enlisted,28472,17,10,7
2022,Enlisted,28504,18,5,13
2022,Enlisted,28518,7,1,6
2022,Enlisted,28540,16,9,7
2022,Enlisted,28557,2,0,2
2022,Enlisted,28560,13,2,11
2022,Enlisted,28590,13,0,13
2022,Enlisted,28601,7,1,6
2022,Enlisted,28607,7,1,6
2022,Enlisted,28621,3,1,2
2022,Enlisted,28640,2,0,2
2022,Enlisted,28645,13,5,8
2022,Enlisted,28655,2,0,2
2022,Enlisted,28658,2,0,2
2022,Enlisted,28659,5,1,4
2022,Enlisted,28677,9,0,9
2022,Enlisted,28681,1,0,1
2022,Enlisted,28734,8,1,7
2022,Enlisted,28779,2,0,2
2022,Enlisted,28806,8,2,6
2022,Enlisted,29006,10,2,8
2022,Enlisted,29020,5,2,3
2022,Enlisted,29044,113,20,93
2022,Enlisted,29102,5,0,5
2022,Enlisted,29108,3,1,2
2022,Enlisted,29115,3,1,2
2022,Enlisted,29138,15,2,13
2022,Enlisted,29153,7,1,6
2022,Enlisted,29161,8,0,8
2022,Enlisted,29170,26,2,24
2022,Enlisted,29201,61,3,58
2022,Enlisted,29303,4,0,4
2022,Enlisted,29325,14,0,14
2022,Enlisted,29341,2,1,1
2022,Enlisted,29360,16,2,14
2022,Enlisted,29379,27,7,20
2022,Enlisted,29385,9,1,8
2022,Enlisted,29409,21,6,15
2022,Enlisted,29418,16,1,15
2022,Enlisted,29440,7,0,7
2022,Enlisted,29461,6,1,5
2022,Enlisted,29464,15,5,10
2022,Enlisted,29488,17,6,11
2022,Enlisted,29506,4,0,4
2022,Enlisted,29510,11,1,10
2022,Enlisted,29512,4,0,4
2022,Enlisted,29526,1,0,1
2022,Enlisted,29532,7,0,7
2022,Enlisted,29550,12,2,10
2022,Enlisted,29554,9,0,9
2022,Enlisted,29556,7,1,6
2022,Enlisted,29571,2,1,1
2022,Enlisted,29574,4,2,2
2022,Enlisted,29577,8,2,6
2022,Enlisted,29605,11,0,11
2022,Enlisted,29620,12,1,11
2022,Enlisted,29625,28,4,24
2022,Enlisted,29631,8,0,8
2022,Enlisted,29640,2,1,1
2022,Enlisted,29644,14,1,13
2022,Enlisted,29646,5,1,4
2022,Enlisted,29651,11,1,10
2022,Enlisted,29653,7,0,7
2022,Enlisted,29678,2,1,1
2022,Enlisted,29715,5,2,3
2022,Enlisted,29720,15,2,13
2022,Enlisted,29732,13,1,12
2022,Enlisted,29810,1,0,1
2022,Enlisted,29812,1,0,1
2022,Enlisted,29824,19,1,18
2022,Enlisted,29829,15,2,13
2022,Enlisted,29845,4,2,2
2022,Enlisted,29906,17,3,14
2022,Enlisted,29944,2,0,2
2022,Enlisted,30014,22,3,19
2022,Enlisted,30032,2,0,2
2022,Enlisted,30040,55,10,45
2022,Enlisted,30043,4,0,4
2022,Enlisted,30046,20,1,19
2022,Enlisted,30060,474,293,181
2022,Enlisted,30069,55,4,51
2022,Enlisted,30114,9,1,8
2022,Enlisted,30125,5,2,3
2022,Enlisted,30134,2,0,2
2022,Enlisted,30144,16,2,14
2022,Enlisted,30161,19,1,18
2022,Enlisted,30224,10,4,6
2022,Enlisted,30233,7,0,7
2022,Enlisted,30240,11,1,10
2022,Enlisted,30263,8,5,3
2022,Enlisted,30294,10,0,10
2022,Enlisted,30297,33,3,30
2022,Enlisted,30336,75,14,61
2022,Enlisted,30401,11,0,11
2022,Enlisted,30427,14,3,11
2022,Enlisted,30439,8,1,7
2022,Enlisted,30458,9,0,9
2022,Enlisted,30461,2,1,1
2022,Enlisted,30501,9,2,7
2022,Enlisted,30577,6,3,3
2022,Enlisted,30597,8,0,8
2022,Enlisted,30635,4,0,4
2022,Enlisted,30643,3,1,2
2022,Enlisted,30655,8,1,7
2022,Enlisted,30673,9,0,9
2022,Enlisted,30680,37,2,35
2022,Enlisted,30701,17,1,16
2022,Enlisted,30720,8,2,6
2022,Enlisted,30824,7,0,7
2022,Enlisted,30904,23,5,18
2022,Enlisted,30905,16,2,14
2022,Enlisted,31015,12,8,4
2022,Enlisted,31029,21,7,14
2022,Enlisted,31040,11,1,10
2022,Enlisted,31061,67,3,64
2022,Enlisted,31211,28,8,20
2022,Enlisted,31313,20,9,11
2022,Enlisted,31314,40,14,26
2022,Enlisted,31329,8,1,7
2022,Enlisted,31406,25,14,11
2022,Enlisted,31409,7,4,3
2022,Enlisted,31520,8,3,5
2022,Enlisted,31533,7,0,7
2022,Enlisted,31601,9,2,7
2022,Enlisted,31704,3,0,3
2022,Enlisted,31792,13,0,13
2022,Enlisted,31794,2,0,2
2022,Enlisted,31901,33,5,28
2022,Enlisted,31905,16,4,12
2022,Enlisted,32055,10,1,9
2022,Enlisted,32064,14,8,6
2022,Enlisted,32084,5,0,5
2022,Enlisted,32086,13,3,10
2022,Enlisted,32091,104,60,44
2022,Enlisted,32164,22,7,15
2022,Enlisted,32177,9,3,6
2022,Enlisted,32221,84,30,54
2022,Enlisted,32311,19,7,12
2022,Enlisted,32351,20,4,16
2022,Enlisted,32405,10,2,8
2022,Enlisted,32425,15,6,9
2022,Enlisted,32428,10,2,8
2022,Enlisted,32446,13,1,12
2022,Enlisted,32514,25,8,17
2022,Enlisted,32539,15,3,12
2022,Enlisted,32609,5,5,0
2022,Enlisted,32721,5,3,2
2022,Enlisted,32724,7,3,4
2022,Enlisted,32726,23,10,13
2022,Enlisted,32771,23,15,8
2022,Enlisted,32806,33,16,17
2022,Enlisted,32862,11,5,6
2022,Enlisted,32922,23,12,11
2022,Enlisted,32935,17,7,10
2022,Enlisted,33027,106,29,77
2022,Enlisted,33039,6,1,5
2022,Enlisted,33127,13,8,5
2022,Enlisted,33315,15,0,15
2022,Enlisted,33401,36,4,32
2022,Enlisted,33405,35,9,26
2022,Enlisted,33406,2,0,2
2022,Enlisted,33523,13,4,9
2022,Enlisted,33563,20,7,13
2022,Enlisted,33606,9,3,6
2022,Enlisted,33711,6,3,3
2022,Enlisted,33782,83,28,55
2022,Enlisted,33811,13,6,7
2022,Enlisted,33825,10,4,6
2022,Enlisted,33830,11,2,9
2022,Enlisted,33844,8,3,5
2022,Enlisted,33859,17,9,8
2022,Enlisted,33873,2,2,0
2022,Enlisted,33880,6,1,5
2022,Enlisted,33916,3,3,0
2022,Enlisted,34208,14,5,9
2022,Enlisted,34221,2,1,1
2022,Enlisted,34237,8,2,6
2022,Enlisted,34266,14,5,9
2022,Enlisted,34429,16,6,10
2022,Enlisted,34474,46,20,26
2022,Enlisted,34604,10,5,5
2022,Enlisted,34748,17,10,7
2022,Enlisted,34947,22,12,10
2022,Enlisted,35010,23,5,18
2022,Enlisted,35016,69,3,66
2022,Enlisted,35040,7,2,5
2022,Enlisted,35042,13,1,12
2022,Enlisted,35045,10,1,9
2022,Enlisted,35055,22,9,13
2022,Enlisted,35072,4,1,3
2022,Enlisted,35121,48,3,45
2022,Enlisted,35124,16,6,10
2022,Enlisted,35146,13,1,12
2022,Enlisted,35160,24,4,20
2022,Enlisted,35178,11,2,9
2022,Enlisted,35209,15,6,9
2022,Enlisted,35217,58,14,44
2022,Enlisted,35259,1,0,1
2022,Enlisted,35405,18,8,10
2022,Enlisted,35476,15,2,13
2022,Enlisted,35501,7,1,6
2022,Enlisted,35555,12,3,9
2022,Enlisted,35565,15,5,10
2022,Enlisted,35601,37,5,32
2022,Enlisted,35613,14,2,12
2022,Enlisted,35630,17,0,17
2022,Enlisted,35803,26,8,18
2022,Enlisted,35805,27,4,23
2022,Enlisted,35904,29,3,26
2022,Enlisted,35967,11,6,5
2022,Enlisted,36016,10,1,9
2022,Enlisted,36027,7,1,6
2022,Enlisted,36043,37,4,33
2022,Enlisted,36067,7,0,7
2022,Enlisted,36078,9,1,8
2022,Enlisted,36081,14,1,13
2022,Enlisted,36083,2,0,2
2022,Enlisted,36109,304,266,38
2022,Enlisted,36117,31,3,28
2022,Enlisted,36203,16,0,16
2022,Enlisted,36205,39,3,36
2022,Enlisted,36250,2,1,1
2022,Enlisted,36265,21,0,21
2022,Enlisted,36301,15,2,13
2022,Enlisted,36323,4,0,4
2022,Enlisted,36330,26,6,20
2022,Enlisted,36340,11,3,8
2022,Enlisted,36420,9,0,9
2022,Enlisted,36426,9,0,9
2022,Enlisted,36442,3,2,1
2022,Enlisted,36502,11,1,10
2022,Enlisted,36522,19,1,18
2022,Enlisted,36532,6,1,5
2022,Enlisted,36535,10,2,8
2022,Enlisted,36605,40,5,35
2022,Enlisted,36608,1,0,1
2022,Enlisted,36701,2,1,1
2022,Enlisted,36832,15,10,5
2022,Enlisted,36854,8,5,3
2022,Enlisted,36867,3,1,2
2022,Enlisted,37015,3,2,1
2022,Enlisted,37033,6,1,5
2022,Enlisted,37042,13,6,7
2022,Enlisted,37055,3,0,3
2022,Enlisted,37056,2,1,1
2022,Enlisted,37066,16,5,11
2022,Enlisted,37083,4,0,4
2022,Enlisted,37090,12,2,10
2022,Enlisted,37091,4,0,4
2022,Enlisted,37097,8,3,5
2022,Enlisted,37110,27,13,14
2022,Enlisted,37129,26,3,23
2022,Enlisted,37167,49,14,35
2022,Enlisted,37172,22,11,11
2022,Enlisted,37185,2,0,2
2022,Enlisted,37204,169,124,45
2022,Enlisted,37217,35,8,27
2022,Enlisted,37306,6,1,5
2022,Enlisted,37321,7,1,6
2022,Enlisted,37323,7,1,6
2022,Enlisted,37327,5,1,4
2022,Enlisted,37334,6,1,5
2022,Enlisted,37356,3,0,3
2022,Enlisted,37388,15,2,13
2022,Enlisted,37398,16,8,8
2022,Enlisted,37404,20,3,17
2022,Enlisted,37615,3,1,2
2022,Enlisted,37620,4,0,4
2022,Enlisted,37643,4,1,3
2022,Enlisted,37645,7,2,5
2022,Enlisted,37717,8,1,7
2022,Enlisted,37743,14,1,13
2022,Enlisted,37757,8,2,6
2022,Enlisted,37760,3,0,3
2022,Enlisted,37771,11,4,7
2022,Enlisted,37777,39,4,35
2022,Enlisted,37801,6,0,6
2022,Enlisted,37821,9,3,6
2022,Enlisted,37825,7,2,5
2022,Enlisted,37841,8,1,7
2022,Enlisted,37854,3,2,1
2022,Enlisted,37857,11,1,10
2022,Enlisted,37860,7,2,5
2022,Enlisted,37863,4,0,4
2022,Enlisted,37874,7,2,5
2022,Enlisted,37919,15,5,10
2022,Enlisted,38001,7,0,7
2022,Enlisted,38008,1,0,1
2022,Enlisted,38012,5,0,5
2022,Enlisted,38019,10,1,9
2022,Enlisted,38024,2,0,2
2022,Enlisted,38053,13,4,9
2022,Enlisted,38118,58,2,56
2022,Enlisted,38201,3,0,3
2022,Enlisted,38210,8,1,7
2022,Enlisted,38242,11,4,7
2022,Enlisted,38261,12,1,11
2022,Enlisted,38301,5,0,5
2022,Enlisted,38305,4,0,4
2022,Enlisted,38320,3,0,3
2022,Enlisted,38340,9,1,8
2022,Enlisted,38343,11,0,11
2022,Enlisted,38344,9,1,8
2022,Enlisted,38351,6,2,4
2022,Enlisted,38358,3,0,3
2022,Enlisted,38372,3,1,2
2022,Enlisted,38375,13,7,6
2022,Enlisted,38382,9,2,7
2022,Enlisted,38401,6,1,5
2022,Enlisted,38462,2,0,2
2022,Enlisted,38464,1,0,1
2022,Enlisted,38478,2,1,1
2022,Enlisted,38485,2,0,2
2022,Enlisted,38506,20,3,17
2022,Enlisted,38556,10,4,6
2022,Enlisted,38563,11,2,9
2022,Enlisted,38570,3,1,2
2022,Enlisted,38572,5,2,3
2022,Enlisted,38583,7,4,3
2022,Enlisted,38606,1,0,1
2022,Enlisted,38614,5,2,3
2022,Enlisted,38632,26,3,23
2022,Enlisted,38635,1,1,0
2022,Enlisted,38655,8,0,8
2022,Enlisted,38668,21,2,19
2022,Enlisted,38671,29,0,29
2022,Enlisted,38703,16,1,15
2022,Enlisted,38751,4,0,4
2022,Enlisted,38801,18,3,15
2022,Enlisted,38821,9,1,8
2022,Enlisted,38829,3,1,2
2022,Enlisted,38834,6,1,5
2022,Enlisted,38851,12,0,12
2022,Enlisted,38863,6,2,4
2022,Enlisted,38901,7,1,6
2022,Enlisted,38915,14,0,14
2022,Enlisted,38916,9,1,8
2022,Enlisted,38930,11,2,9
2022,Enlisted,38967,1,1,0
2022,Enlisted,39042,18,0,18
2022,Enlisted,39046,13,1,12
2022,Enlisted,39047,1,0,1
2022,Enlisted,39051,6,0,6
2022,Enlisted,39056,26,4,22
2022,Enlisted,39059,4,0,4
2022,Enlisted,39074,2,0,2
2022,Enlisted,39090,1,0,1
2022,Enlisted,39111,14,1,13
2022,Enlisted,39117,4,1,3
2022,Enlisted,39120,4,0,4
2022,Enlisted,39183,5,0,5
2022,Enlisted,39194,2,0,2
2022,Enlisted,39202,11,11,0
2022,Enlisted,39204,23,2,21
2022,Enlisted,39209,21,1,20
2022,Enlisted,39216,11,9,2
2022,Enlisted,39232,1,1,0
2022,Enlisted,39307,5,1,4
2022,Enlisted,39339,11,0,11
2022,Enlisted,39345,22,2,20
2022,Enlisted,39350,12,0,12
2022,Enlisted,39401,32,3,29
2022,Enlisted,39407,20,7,13
2022,Enlisted,39422,5,0,5
2022,Enlisted,39429,7,0,7
2022,Enlisted,39440,4,0,4
2022,Enlisted,39452,3,1,2
2022,Enlisted,39466,7,0,7
2022,Enlisted,39470,11,1,10
2022,Enlisted,39505,16,1,15
2022,Enlisted,39507,15,4,11
2022,Enlisted,39532,8,2,6
2022,Enlisted,39556,3,0,3
2022,Enlisted,39567,9,1,8
2022,Enlisted,39577,9,2,7
2022,Enlisted,39601,9,1,8
2022,Enlisted,39648,7,1,6
2022,Enlisted,39654,6,1,5
2022,Enlisted,39704,5,1,4
2022,Enlisted,39730,5,0,5
2022,Enlisted,39759,11,2,9
2022,Enlisted,39773,7,0,7
2022,Enlisted,40004,9,2,7
2022,Enlisted,40065,8,1,7
2022,Enlisted,40108,1,0,1
2022,Enlisted,40205,23,7,16
2022,Enlisted,40218,29,7,22
2022,Enlisted,40311,14,5,9
2022,Enlisted,40330,10,2,8
2022,Enlisted,40351,9,1,8
2022,Enlisted,40422,5,0,5
2022,Enlisted,40472,10,1,9
2022,Enlisted,40475,64,12,52
2022,Enlisted,40510,20,4,16
2022,Enlisted,40601,82,20,62
2022,Enlisted,40741,6,3,3
2022,Enlisted,40769,8,2,6
2022,Enlisted,40840,8,6,2
2022,Enlisted,40906,5,0,5
2022,Enlisted,40965,1,0,1
2022,Enlisted,41005,35,3,32
2022,Enlisted,41008,4,1,3
2022,Enlisted,41031,7,3,4
2022,Enlisted,41094,17,2,15
2022,Enlisted,41101,10,0,10
2022,Enlisted,41164,6,3,3
2022,Enlisted,41339,7,2,5
2022,Enlisted,41653,11,2,9
2022,Enlisted,41701,5,3,2
2022,Enlisted,42025,5,0,5
2022,Enlisted,42071,7,2,5
2022,Enlisted,42086,5,2,3
2022,Enlisted,42101,4,0,4
2022,Enlisted,42141,17,2,15
2022,Enlisted,42167,4,0,4
2022,Enlisted,42240,9,4,5
2022,Enlisted,42276,6,0,6
2022,Enlisted,42301,11,3,8
2022,Enlisted,42330,18,4,14
2022,Enlisted,42345,9,4,5
2022,Enlisted,42431,6,2,4
2022,Enlisted,42501,13,4,9
2022,Enlisted,42633,11,4,7
2022,Enlisted,42701,9,1,8
2022,Enlisted,42718,4,0,4
2022,Enlisted,42754,11,1,10
2022,Enlisted,43015,19,5,14
2022,Enlisted,43040,22,6,16
2022,Enlisted,43055,13,1,12
2022,Enlisted,43102,18,2,16
2022,Enlisted,43213,59,5,54
2022,Enlisted,43215,3,0,3
2022,Enlisted,43217,69,11,58
2022,Enlisted,43235,5,3,2
2022,Enlisted,43402,12,4,8
2022,Enlisted,43465,48,13,35
2022,Enlisted,43614,20,1,19
2022,Enlisted,43756,11,4,7
2022,Enlisted,43812,4,0,4
2022,Enlisted,44023,15,2,13
2022,Enlisted,44055,10,1,9
2022,Enlisted,44128,17,2,15
2022,Enlisted,44142,6,0,6
2022,Enlisted,44224,20,6,14
2022,Enlisted,44256,10,1,9
2022,Enlisted,44313,11,0,11
2022,Enlisted,44444,11,2,9
2022,Enlisted,44515,12,4,8
2022,Enlisted,44622,2,0,2
2022,Enlisted,44691,8,0,8
2022,Enlisted,44720,55,20,35
2022,Enlisted,44837,1,0,1
2022,Enlisted,44857,7,2,5
2022,Enlisted,44870,8,3,5
2022,Enlisted,44883,8,4,4
2022,Enlisted,44903,20,3,17
2022,Enlisted,45015,13,1,12
2022,Enlisted,45035,6,2,4
2022,Enlisted,45044,26,4,22
2022,Enlisted,45215,30,2,28
2022,Enlisted,45331,7,1,6
2022,Enlisted,45356,24,3,21
2022,Enlisted,45385,13,2,11
2022,Enlisted,45430,10,1,9
2022,Enlisted,45502,24,6,18
2022,Enlisted,45601,21,1,20
2022,Enlisted,45662,15,2,13
2022,Enlisted,45804,8,1,7
2022,Enlisted,45885,8,0,8
2022,Enlisted,46012,9,4,5
2022,Enlisted,46036,5,2,3
2022,Enlisted,46041,8,1,7
2022,Enlisted,46052,9,2,7
2022,Enlisted,46122,3,3,0
2022,Enlisted,46124,19,3,16
2022,Enlisted,46131,72,14,58
2022,Enlisted,46135,6,0,6
2022,Enlisted,46140,26,6,20
2022,Enlisted,46151,35,8,27
2022,Enlisted,46176,30,2,28
2022,Enlisted,46208,4,2,2
2022,Enlisted,46216,33,6,27
2022,Enlisted,46241,117,30,87
2022,Enlisted,46323,2,1,1
2022,Enlisted,46350,17,1,16
2022,Enlisted,46360,1,0,1
2022,Enlisted,46383,11,0,11
2022,Enlisted,46402,9,1,8
2022,Enlisted,46406,19,5,14
2022,Enlisted,46517,20,2,18
2022,Enlisted,46563,19,1,18
2022,Enlisted,46582,11,1,10
2022,Enlisted,46613,24,2,22
2022,Enlisted,46703,8,5,3
2022,Enlisted,46750,5,0,5
2022,Enlisted,46825,37,9,28
2022,Enlisted,46901,8,2,6
2022,Enlisted,46947,9,1,8
2022,Enlisted,46953,3,0,3
2022,Enlisted,46970,5,1,4
2022,Enlisted,47150,7,1,6
2022,Enlisted,47167,7,3,4
2022,Enlisted,47170,8,2,6
2022,Enlisted,47203,31,1,30
2022,Enlisted,47223,1,0,1
2022,Enlisted,47250,14,4,10
2022,Enlisted,47265,4,1,3
2022,Enlisted,47274,28,9,19
2022,Enlisted,47303,20,4,16
2022,Enlisted,47331,12,6,6
2022,Enlisted,47348,12,2,10
2022,Enlisted,47374,2,0,2
2022,Enlisted,47394,14,2,12
2022,Enlisted,47401,15,1,14
2022,Enlisted,47421,9,0,9
2022,Enlisted,47441,5,1,4
2022,Enlisted,47501,5,2,3
2022,Enlisted,47546,6,2,4
2022,Enlisted,47591,15,2,13
2022,Enlisted,47715,39,4,35
2022,Enlisted,47804,2,1,1
2022,Enlisted,47834,12,4,8
2022,Enlisted,47872,6,3,3
2022,Enlisted,47904,12,1,11
2022,Enlisted,47905,28,3,25
2022,Enlisted,47933,14,3,11
2022,Enlisted,47960,15,0,15
2022,Enlisted,47977,11,0,11
2022,Enlisted,47978,1,0,1
2022,Enlisted,48060,6,2,4
2022,Enlisted,48180,25,4,21
2022,Enlisted,48197,34,6,28
2022,Enlisted,48208,31,6,25
2022,Enlisted,48234,45,19,26
2022,Enlisted,48341,13,1,12
2022,Enlisted,48446,3,2,1
2022,Enlisted,48601,32,9,23
2022,Enlisted,48642,12,2,10
2022,Enlisted,48706,13,3,10
2022,Enlisted,48801,4,1,3
2022,Enlisted,48817,30,5,25
2022,Enlisted,48837,44,9,35
2022,Enlisted,48838,9,0,9
2022,Enlisted,48843,8,2,6
2022,Enlisted,48906,52,15,37
2022,Enlisted,48912,8,2,6
2022,Enlisted,49009,18,7,11
2022,Enlisted,49012,40,11,29
2022,Enlisted,49047,10,5,5
2022,Enlisted,49201,14,1,13
2022,Enlisted,49224,5,1,4
2022,Enlisted,49306,2,2,0
2022,Enlisted,49307,5,0,5
2022,Enlisted,49437,4,0,4
2022,Enlisted,49509,58,18,40
2022,Enlisted,49601,5,0,5
2022,Enlisted,49696,5,1,4
2022,Enlisted,49707,2,0,2
2022,Enlisted,49739,14,2,12
2022,Enlisted,49783,6,1,5
2022,Enlisted,49801,2,0,2
2022,Enlisted,49837,5,1,4
2022,Enlisted,49849,4,2,2
2022,Enlisted,49855,9,0,9
2022,Enlisted,49913,4,0,4
2022,Enlisted,50025,1,0,1
2022,Enlisted,50036,17,4,13
2022,Enlisted,50126,5,4,1
2022,Enlisted,50131,162,15,147
2022,Enlisted,50138,6,2,4
2022,Enlisted,50158,3,1,2
2022,Enlisted,50220,5,1,4
2022,Enlisted,50401,6,1,5
2022,Enlisted,50501,7,0,7
2022,Enlisted,50588,12,1,11
2022,Enlisted,50616,2,1,1
2022,Enlisted,50662,2,0,2
2022,Enlisted,50703,40,6,34
2022,Enlisted,51031,7,1,6
2022,Enlisted,51111,19,2,17
2022,Enlisted,51201,6,0,6
2022,Enlisted,51301,2,0,2
2022,Enlisted,51334,5,0,5
2022,Enlisted,51401,6,2,4
2022,Enlisted,51442,26,1,25
2022,Enlisted,51503,13,2,11
2022,Enlisted,51566,6,1,5
2022,Enlisted,51601,3,1,2
2022,Enlisted,52001,27,4,23
2022,Enlisted,52002,4,0,4
2022,Enlisted,52246,36,2,34
2022,Enlisted,52353,5,0,5
2022,Enlisted,52404,17,3,14
2022,Enlisted,52501,8,0,8
2022,Enlisted,52556,2,0,2
2022,Enlisted,52577,1,0,1
2022,Enlisted,52632,4,0,4
2022,Enlisted,52638,9,2,7
2022,Enlisted,52641,6,1,5
2022,Enlisted,52732,14,1,13
2022,Enlisted,52761,3,0,3
2022,Enlisted,52806,22,4,18
2022,Enlisted,53027,4,0,4
2022,Enlisted,53066,14,0,14
2022,Enlisted,53073,2,0,2
2022,Enlisted,53089,17,1,16
2022,Enlisted,53094,10,2,8
2022,Enlisted,53095,10,2,8
2022,Enlisted,53121,4,0,4
2022,Enlisted,53144,12,2,10
2022,Enlisted,53154,6,1,5
2022,Enlisted,53186,8,1,7
2022,Enlisted,53190,7,1,6
2022,Enlisted,53212,16,5,11
2022,Enlisted,53403,3,0,3
2022,Enlisted,53511,6,2,4
2022,Enlisted,53538,10,2,8
2022,Enlisted,53581,7,2,5
2022,Enlisted,53704,74,7,67
2022,Enlisted,53821,7,1,6
2022,Enlisted,53901,5,1,4
2022,Enlisted,53948,5,1,4
2022,Enlisted,53959,9,1,8
2022,Enlisted,53963,9,4,5
2022,Enlisted,54017,3,3,0
2022,Enlisted,54022,6,3,3
2022,Enlisted,54143,3,1,2
2022,Enlisted,54241,1,0,1
2022,Enlisted,54303,18,4,14
2022,Enlisted,54401,7,0,7
2022,Enlisted,54405,4,1,3
2022,Enlisted,54409,11,3,8
2022,Enlisted,54449,11,1,10
2022,Enlisted,54451,4,0,4
2022,Enlisted,54455,10,1,9
2022,Enlisted,54456,1,0,1
2022,Enlisted,54481,12,2,10
2022,Enlisted,54487,1,0,1
2022,Enlisted,54495,7,0,7
2022,Enlisted,54501,5,0,5
2022,Enlisted,54612,4,2,2
2022,Enlisted,54615,5,0,5
2022,Enlisted,54618,12,4,8
2022,Enlisted,54646,4,1,3
2022,Enlisted,54650,9,2,7
2022,Enlisted,54660,11,0,11
2022,Enlisted,54665,1,1,0
2022,Enlisted,54703,11,2,9
2022,Enlisted,54729,6,0,6
2022,Enlisted,54751,18,2,16
2022,Enlisted,54801,5,0,5
2022,Enlisted,54806,8,2,6
2022,Enlisted,54843,5,0,5
2022,Enlisted,54868,8,3,5
2022,Enlisted,54880,3,0,3
2022,Enlisted,54901,13,0,13
2022,Enlisted,54902,1,0,1
2022,Enlisted,54914,5,1,4
2022,Enlisted,54929,3,1,2
2022,Enlisted,54932,7,2,5
2022,Enlisted,54935,22,2,20
2022,Enlisted,54971,1,0,1
2022,Enlisted,54981,6,0,6
2022,Enlisted,55008,26,1,25
2022,Enlisted,55016,28,2,26
2022,Enlisted,55021,1,0,1
2022,Enlisted,55033,11,2,9
2022,Enlisted,55063,15,3,12
2022,Enlisted,55066,7,3,4
2022,Enlisted,55068,26,6,20
2022,Enlisted,55073,7,2,5
2022,Enlisted,55077,16,3,13
2022,Enlisted,55082,66,12,54
2022,Enlisted,55101,3,3,0
2022,Enlisted,55106,31,5,26
2022,Enlisted,55107,30,0,30
2022,Enlisted,55112,103,11,92
2022,Enlisted,55118,25,5,20
2022,Enlisted,55303,27,5,22
2022,Enlisted,55350,21,3,18
2022,Enlisted,55355,12,1,11
2022,Enlisted,55362,12,2,10
2022,Enlisted,55413,7,2,5
2022,Enlisted,55431,18,2,16
2022,Enlisted,55443,8,1,7
2022,Enlisted,55719,10,1,9
2022,Enlisted,55720,10,2,8
2022,Enlisted,55744,2,1,1
2022,Enlisted,55746,7,2,5
2022,Enlisted,55811,13,0,13
2022,Enlisted,55901,9,2,7
2022,Enlisted,55912,43,2,41
2022,Enlisted,55987,13,3,10
2022,Enlisted,56001,29,4,25
2022,Enlisted,56007,10,4,6
2022,Enlisted,56031,11,1,10
2022,Enlisted,56073,3,1,2
2022,Enlisted,56081,13,2,11
2022,Enlisted,56082,13,2,11
2022,Enlisted,56143,9,0,9
2022,Enlisted,56156,4,1,3
2022,Enlisted,56164,8,2,6
2022,Enlisted,56201,19,1,18
2022,Enlisted,56208,7,0,7
2022,Enlisted,56258,9,1,8
2022,Enlisted,56265,13,0,13
2022,Enlisted,56267,7,1,6
2022,Enlisted,56273,21,1,20
2022,Enlisted,56277,5,0,5
2022,Enlisted,56278,2,0,2
2022,Enlisted,56301,3,1,2
2022,Enlisted,56303,17,3,14
2022,Enlisted,56308,10,1,9
2022,Enlisted,56345,175,15,160
2022,Enlisted,56378,2,1,1
2022,Enlisted,56401,18,2,16
2022,Enlisted,56482,4,0,4
2022,Enlisted,56501,8,2,6
2022,Enlisted,56537,7,0,7
2022,Enlisted,56560,11,0,11
2022,Enlisted,56601,10,1,9
2022,Enlisted,56701,6,0,6
2022,Enlisted,56716,22,2,20
2022,Enlisted,57006,2,0,2
2022,Enlisted,57028,5,0,5
2022,Enlisted,57042,15,2,13
2022,Enlisted,57069,7,2,5
2022,Enlisted,57078,8,2,6
2022,Enlisted,57104,29,3,26
2022,Enlisted,57201,15,1,14
2022,Enlisted,57252,2,0,2
2022,Enlisted,57301,9,0,9
2022,Enlisted,57325,1,0,1
2022,Enlisted,57350,3,0,3
2022,Enlisted,57366,7,0,7
2022,Enlisted,57380,3,0,3
2022,Enlisted,57401,7,0,7
2022,Enlisted,57501,6,4,2
2022,Enlisted,57601,4,0,4
2022,Enlisted,57701,7,1,6
2022,Enlisted,57702,35,4,31
2022,Enlisted,57703,9,3,6
2022,Enlisted,57717,2,0,2
2022,Enlisted,57783,2,1,1
2022,Enlisted,57785,3,0,3
2022,Enlisted,58054,5,0,5
2022,Enlisted,58072,10,2,8
2022,Enlisted,58075,13,2,11
2022,Enlisted,58102,54,4,50
2022,Enlisted,58201,20,2,18
2022,Enlisted,58301,12,1,11
2022,Enlisted,58401,6,2,4
2022,Enlisted,58433,7,0,7
2022,Enlisted,58495,6,1,5
2022,Enlisted,58501,34,3,31
2022,Enlisted,58504,11,1,10
2022,Enlisted,58506,7,1,6
2022,Enlisted,58601,9,0,9
2022,Enlisted,58703,13,3,10
2022,Enlisted,58801,1,0,1
2022,Enlisted,59047,2,0,2
2022,Enlisted,59102,21,3,18
2022,Enlisted,59301,8,0,8
2022,Enlisted,59405,5,0,5
2022,Enlisted,59457,6,0,6
2022,Enlisted,59501,6,2,4
2022,Enlisted,59538,12,2,10
2022,Enlisted,59602,30,5,25
2022,Enlisted,59636,35,16,19
2022,Enlisted,59701,2,2,0
2022,Enlisted,59711,7,0,7
2022,Enlisted,59714,18,4,14
2022,Enlisted,59725,1,0,1
2022,Enlisted,59760,7,1,6
2022,Enlisted,59808,13,4,9
2022,Enlisted,59901,21,5,16
2022,Enlisted,60037,25,3,22
2022,Enlisted,60098,8,1,7
2022,Enlisted,60120,8,3,5
2022,Enlisted,60178,8,1,7
2022,Enlisted,60435,6,0,6
2022,Enlisted,60472,55,5,50
2022,Enlisted,60505,20,2,18
2022,Enlisted,60545,18,2,16
2022,Enlisted,60546,107,10,97
2022,Enlisted,60615,56,10,46
2022,Enlisted,60616,10,4,6
2022,Enlisted,60651,27,4,23
2022,Enlisted,60901,27,3,24
2022,Enlisted,61021,10,4,6
2022,Enlisted,61032,23,0,23
2022,Enlisted,61071,16,0,16
2022,Enlisted,61115,38,3,35
2022,Enlisted,61201,1,1,0
2022,Enlisted,61264,11,0,11
2022,Enlisted,61341,12,0,12
2022,Enlisted,61401,12,0,12
2022,Enlisted,61434,4,1,3
2022,Enlisted,61443,7,0,7
2022,Enlisted,61455,8,1,7
2022,Enlisted,61607,47,6,41
2022,Enlisted,61701,22,3,19
2022,Enlisted,61761,19,2,17
2022,Enlisted,61764,14,5,9
2022,Enlisted,61801,10,0,10
2022,Enlisted,61820,9,1,8
2022,Enlisted,61834,7,0,7
2022,Enlisted,61938,10,3,7
2022,Enlisted,61944,14,0,14
2022,Enlisted,61951,5,2,3
2022,Enlisted,62056,20,5,15
2022,Enlisted,62205,16,2,14
2022,Enlisted,62269,16,1,15
2022,Enlisted,62286,20,2,18
2022,Enlisted,62301,9,0,9
2022,Enlisted,62401,15,3,12
2022,Enlisted,62439,11,0,11
2022,Enlisted,62521,28,3,25
2022,Enlisted,62618,11,1,10
2022,Enlisted,62659,2,0,2
2022,Enlisted,62702,49,8,41
2022,Enlisted,62864,19,1,18
2022,Enlisted,62896,9,2,7
2022,Enlisted,62959,13,1,12
2022,Enlisted,62966,11,0,11
2022,Enlisted,63020,4,0,4
2022,Enlisted,63028,13,2,11
2022,Enlisted,63044,26,3,23
2022,Enlisted,63077,13,0,13
2022,Enlisted,63125,47,11,36
2022,Enlisted,63383,12,1,11
2022,Enlisted,63401,5,1,4
2022,Enlisted,63552,10,0,10
2022,Enlisted,63640,5,2,3
2022,Enlisted,63645,4,0,4
2022,Enlisted,63701,3,0,3
2022,Enlisted,63703,4,1,3
2022,Enlisted,63755,14,0,14
2022,Enlisted,63775,15,4,11
2022,Enlisted,63801,3,0,3
2022,Enlisted,63841,12,0,12
2022,Enlisted,63857,7,1,6
2022,Enlisted,63901,10,2,8
2022,Enlisted,64052,10,2,8
2022,Enlisted,64067,9,0,9
2022,Enlisted,64085,10,0,10
2022,Enlisted,64093,8,3,5
2022,Enlisted,64129,123,17,106
2022,Enlisted,64402,5,0,5
2022,Enlisted,64468,4,0,4
2022,Enlisted,64506,1,0,1
2022,Enlisted,64601,2,1,1
2022,Enlisted,64683,5,0,5
2022,Enlisted,64701,11,2,9
2022,Enlisted,64735,15,0,15
2022,Enlisted,64759,2,0,2
2022,Enlisted,64772,11,5,6
2022,Enlisted,64804,7,0,7
2022,Enlisted,64831,4,0,4
2022,Enlisted,64836,15,5,10
2022,Enlisted,64850,2,0,2
2022,Enlisted,65101,6,1,5
2022,Enlisted,65109,24,4,20
2022,Enlisted,65202,9,0,9
2022,Enlisted,65251,8,1,7
2022,Enlisted,65265,1,0,1
2022,Enlisted,65270,3,0,3
2022,Enlisted,65301,2,0,2
2022,Enlisted,65305,27,1,26
2022,Enlisted,65340,14,1,13
2022,Enlisted,65401,14,1,13
2022,Enlisted,65473,14,2,12
2022,Enlisted,65605,7,0,7
2022,Enlisted,65708,11,2,9
2022,Enlisted,65723,20,2,18
2022,Enlisted,65775,2,1,1
2022,Enlisted,65802,38,5,33
2022,Enlisted,65803,22,9,13
2022,Enlisted,66027,10,2,8
2022,Enlisted,66044,8,4,4
2022,Enlisted,66061,26,2,24
2022,Enlisted,66067,3,1,2
2022,Enlisted,66071,9,1,8
2022,Enlisted,66102,15,3,12
2022,Enlisted,66217,7,1,6
2022,Enlisted,66219,15,4,11
2022,Enlisted,66401,2,0,2
2022,Enlisted,66434,7,3,4
2022,Enlisted,66436,6,1,5
2022,Enlisted,66441,11,6,5
2022,Enlisted,66502,31,14,17
2022,Enlisted,66508,3,0,3
2022,Enlisted,66611,5,4,1
2022,Enlisted,66619,83,19,64
2022,Enlisted,66749,10,1,9
2022,Enlisted,66762,14,0,14
2022,Enlisted,66801,6,0,6
2022,Enlisted,66901,2,1,1
2022,Enlisted,66967,1,0,1
2022,Enlisted,67010,10,0,10
2022,Enlisted,67114,7,0,7
2022,Enlisted,67124,1,0,1
2022,Enlisted,67217,21,5,16
2022,Enlisted,67219,51,7,44
2022,Enlisted,67337,2,0,2
2022,Enlisted,67401,13,4,9
2022,Enlisted,67410,5,1,4
2022,Enlisted,67501,4,0,4
2022,Enlisted,67530,11,3,8
2022,Enlisted,67601,5,2,3
2022,Enlisted,67701,1,1,0
2022,Enlisted,67801,1,1,0
2022,Enlisted,68066,15,0,15
2022,Enlisted,68073,51,11,40
2022,Enlisted,68106,2,0,2
2022,Enlisted,68142,8,1,7
2022,Enlisted,68310,12,4,8
2022,Enlisted,68508,29,5,24
2022,Enlisted,68524,30,3,27
2022,Enlisted,68601,6,0,6
2022,Enlisted,68701,4,0,4
2022,Enlisted,68787,4,1,3
2022,Enlisted,68801,18,3,15
2022,Enlisted,68822,3,0,3
2022,Enlisted,68847,19,0,19
2022,Enlisted,68901,12,7,5
2022,Enlisted,69001,2,0,2
2022,Enlisted,69101,2,0,2
2022,Enlisted,69162,8,1,7
2022,Enlisted,69337,5,0,5
2022,Enlisted,69341,1,0,1
2022,Enlisted,69361,3,0,3
2022,Enlisted,70072,10,2,8
2022,Enlisted,70084,10,0,10
2022,Enlisted,70117,196,119,77
2022,Enlisted,70301,11,1,10
2022,Enlisted,70364,9,3,6
2022,Enlisted,70390,9,2,7
2022,Enlisted,70401,68,7,61
2022,Enlisted,70403,4,1,3
2022,Enlisted,70427,3,0,3
2022,Enlisted,70433,16,0,16
2022,Enlisted,70438,14,0,14
2022,Enlisted,70443,5,0,5
2022,Enlisted,70460,25,1,24
2022,Enlisted,70508,31,1,30
2022,Enlisted,70510,16,3,13
2022,Enlisted,70517,10,3,7
2022,Enlisted,70526,8,5,3
2022,Enlisted,70544,8,2,6
2022,Enlisted,70563,9,0,9
2022,Enlisted,70570,4,1,3
2022,Enlisted,70582,12,0,12
2022,Enlisted,70586,2,0,2
2022,Enlisted,70601,14,1,13
2022,Enlisted,70633,13,3,10
2022,Enlisted,70634,3,0,3
2022,Enlisted,70714,11,0,11
2022,Enlisted,70721,72,3,69
2022,Enlisted,70737,5,0,5
2022,Enlisted,70760,10,0,10
2022,Enlisted,70764,18,4,14
2022,Enlisted,70802,3,0,3
2022,Enlisted,70820,35,1,34
2022,Enlisted,71019,9,2,7
2022,Enlisted,71055,22,2,20
2022,Enlisted,71101,31,3,28
2022,Enlisted,71111,5,2,3
2022,Enlisted,71203,18,2,16
2022,Enlisted,71220,7,1,6
2022,Enlisted,71232,3,0,3
2022,Enlisted,71241,4,0,4
2022,Enlisted,71251,1,0,1
2022,Enlisted,71263,2,0,2
2022,Enlisted,71270,21,1,20
2022,Enlisted,71292,11,1,10
2022,Enlisted,71295,1,0,1
2022,Enlisted,71303,11,2,9
2022,Enlisted,71322,16,0,16
2022,Enlisted,71342,4,1,3
2022,Enlisted,71351,6,0,6
2022,Enlisted,71360,80,11,69
2022,Enlisted,71373,3,0,3
2022,Enlisted,71415,6,0,6
2022,Enlisted,71417,10,0,10
2022,Enlisted,71457,9,0,9
2022,Enlisted,71459,10,4,6
2022,Enlisted,71602,7,0,7
2022,Enlisted,71671,6,0,6
2022,Enlisted,71701,11,2,9
2022,Enlisted,71730,3,1,2
2022,Enlisted,71801,4,0,4
2022,Enlisted,71832,1,0,1
2022,Enlisted,71854,6,1,5
2022,Enlisted,71857,3,0,3
2022,Enlisted,71923,8,0,8
2022,Enlisted,71953,16,6,10
2022,Enlisted,72006,11,1,10
2022,Enlisted,72012,14,0,14
2022,Enlisted,72015,17,2,15
2022,Enlisted,72023,9,0,9
2022,Enlisted,72032,14,0,14
2022,Enlisted,72064,7,1,6
2022,Enlisted,72086,16,2,14
2022,Enlisted,72104,8,0,8
2022,Enlisted,72110,4,0,4
2022,Enlisted,72114,1,0,1
2022,Enlisted,72119,14,2,12
2022,Enlisted,72143,21,3,18
2022,Enlisted,72150,2,0,2
2022,Enlisted,72199,87,5,82
2022,Enlisted,72301,7,2,5
2022,Enlisted,72335,2,0,2
2022,Enlisted,72401,13,0,13
2022,Enlisted,72432,13,0,13
2022,Enlisted,72450,8,0,8
2022,Enlisted,72476,11,2,9
2022,Enlisted,72501,8,2,6
2022,Enlisted,72543,13,0,13
2022,Enlisted,72601,19,6,13
2022,Enlisted,72650,5,0,5
2022,Enlisted,72653,5,1,4
2022,Enlisted,72701,10,1,9
2022,Enlisted,72712,22,1,21
2022,Enlisted,72713,5,0,5
2022,Enlisted,72744,4,0,4
2022,Enlisted,72756,21,0,21
2022,Enlisted,72761,4,1,3
2022,Enlisted,72802,6,0,6
2022,Enlisted,72830,3,0,3
2022,Enlisted,72834,6,0,6
2022,Enlisted,72855,6,0,6
2022,Enlisted,72905,8,0,8
2022,Enlisted,72923,28,2,26
2022,Enlisted,72927,9,0,9
2022,Enlisted,72949,10,0,10
2022,Enlisted,73034,48,6,42
2022,Enlisted,73036,29,6,23
2022,Enlisted,73051,18,0,18
2022,Enlisted,73064,53,15,38
2022,Enlisted,73069,110,17,93
2022,Enlisted,73111,26,9,17
2022,Enlisted,73141,4,0,4
2022,Enlisted,73401,52,6,46
2022,Enlisted,73501,1,1,0
2022,Enlisted,73503,41,9,32
2022,Enlisted,73521,3,1,2
2022,Enlisted,73705,18,3,15
2022,Enlisted,74003,17,1,16
2022,Enlisted,74012,20,6,14
2022,Enlisted,74014,48,6,42
2022,Enlisted,74017,7,0,7
2022,Enlisted,74075,15,0,15
2022,Enlisted,74107,47,7,40
2022,Enlisted,74112,21,4,17
2022,Enlisted,74116,14,3,11
2022,Enlisted,74301,19,5,14
2022,Enlisted,74403,51,4,47
2022,Enlisted,74423,13,1,12
2022,Enlisted,74447,5,0,5
2022,Enlisted,74501,3,0,3
2022,Enlisted,74601,10,1,9
2022,Enlisted,74701,16,3,13
2022,Enlisted,74801,5,1,4
2022,Enlisted,74820,13,1,12
2022,Enlisted,74821,5,0,5
2022,Enlisted,74834,17,3,14
2022,Enlisted,74848,4,1,3
2022,Enlisted,75020,15,11,4
2022,Enlisted,75051,95,34,61
2022,Enlisted,75077,17,6,11
2022,Enlisted,75098,31,17,14
2022,Enlisted,75110,12,3,9
2022,Enlisted,75159,47,26,21
2022,Enlisted,75165,34,5,29
2022,Enlisted,75220,13,5,8
2022,Enlisted,75237,12,9,3
2022,Enlisted,75402,16,8,8
2022,Enlisted,75570,3,2,1
2022,Enlisted,75662,22,9,13
2022,Enlisted,75709,15,2,13
2022,Enlisted,75803,10,6,4
2022,Enlisted,75901,9,4,5
2022,Enlisted,76067,1,1,0
2022,Enlisted,76086,9,2,7
2022,Enlisted,76108,63,22,41
2022,Enlisted,76115,8,5,3
2022,Enlisted,76207,7,4,3
2022,Enlisted,76234,10,5,5
2022,Enlisted,76302,16,5,11
2022,Enlisted,76401,9,6,3
2022,Enlisted,76502,201,130,71
2022,Enlisted,76528,25,15,10
2022,Enlisted,76542,47,24,23
2022,Enlisted,76544,9,5,4
2022,Enlisted,76574,12,4,8
2022,Enlisted,76707,36,18,18
2022,Enlisted,76801,7,5,2
2022,Enlisted,76905,4,2,2
2022,Enlisted,77034,89,42,47
2022,Enlisted,77067,55,22,33
2022,Enlisted,77082,67,21,46
2022,Enlisted,77340,21,9,12
2022,Enlisted,77437,13,6,7
2022,Enlisted,77471,11,2,9
2022,Enlisted,77503,3,3,0
2022,Enlisted,77515,23,4,19
2022,Enlisted,77568,10,5,5
2022,Enlisted,77802,21,5,16
2022,Enlisted,77833,9,2,7
2022,Enlisted,77904,8,6,2
2022,Enlisted,78041,11,3,8
2022,Enlisted,78130,8,2,6
2022,Enlisted,78218,53,22,31
2022,Enlisted,78219,43,19,24
2022,Enlisted,78257,104,60,44
2022,Enlisted,78363,16,7,9
2022,Enlisted,78416,4,3,1
2022,Enlisted,78520,18,12,6
2022,Enlisted,78527,4,1,3
2022,Enlisted,78596,59,22,37
2022,Enlisted,78602,43,14,29
2022,Enlisted,78617,46,31,15
2022,Enlisted,78624,14,12,2
2022,Enlisted,78665,50,17,33
2022,Enlisted,78666,73,35,38
2022,Enlisted,78703,136,55,81
2022,Enlisted,78731,12,4,8
2022,Enlisted,78746,4,2,2
2022,Enlisted,78861,32,21,11
2022,Enlisted,79107,9,5,4
2022,Enlisted,79403,29,7,22
2022,Enlisted,79607,15,6,9
2022,Enlisted,79705,13,10,3
2022,Enlisted,79924,10,5,5
2022,Enlisted,79936,69,40,29
2022,Enlisted,80011,52,29,23
2022,Enlisted,80012,1,0,1
2022,Enlisted,80112,4,3,1
2022,Enlisted,80137,30,25,5
2022,Enlisted,80216,31,16,15
2022,Enlisted,80501,6,3,3
2022,Enlisted,80504,10,5,5
2022,Enlisted,80521,7,5,2
2022,Enlisted,80550,7,3,4
2022,Enlisted,80621,12,8,4
2022,Enlisted,80907,7,6,1
2022,Enlisted,80913,16,13,3
2022,Enlisted,80916,8,8,0
2022,Enlisted,80920,38,20,18
2022,Enlisted,81004,6,4,2
2022,Enlisted,81101,4,1,3
2022,Enlisted,81401,12,7,5
2022,Enlisted,81501,9,7,2
2022,Enlisted,82005,5,0,5
2022,Enlisted,82009,16,1,15
2022,Enlisted,82070,1,0,1
2022,Enlisted,82214,14,4,10
2022,Enlisted,82240,6,0,6
2022,Enlisted,82435,19,3,16
2022,Enlisted,82520,10,1,9
2022,Enlisted,82604,13,2,11
2022,Enlisted,82633,3,0,3
2022,Enlisted,82716,8,0,8
2022,Enlisted,82801,2,0,2
2022,Enlisted,82901,5,0,5
2022,Enlisted,82930,13,5,8
2022,Enlisted,83110,2,1,1
2022,Enlisted,83202,4,2,2
2022,Enlisted,83221,5,0,5
2022,Enlisted,83263,7,1,6
2022,Enlisted,83301,5,0,5
2022,Enlisted,83318,8,0,8
2022,Enlisted,83330,3,1,2
2022,Enlisted,83338,12,3,9
2022,Enlisted,83402,8,3,5
2022,Enlisted,83440,6,1,5
2022,Enlisted,83442,4,3,1
2022,Enlisted,83445,1,0,1
2022,Enlisted,83501,14,9,5
2022,Enlisted,83530,3,1,2
2022,Enlisted,83605,16,4,12
2022,Enlisted,83647,9,4,5
2022,Enlisted,83687,3,1,2
2022,Enlisted,83705,87,27,60
2022,Enlisted,83716,5,2,3
2022,Enlisted,83843,8,0,8
2022,Enlisted,83854,15,3,12
2022,Enlisted,84003,15,4,11
2022,Enlisted,84020,24,5,19
2022,Enlisted,84043,47,31,16
2022,Enlisted,84058,16,6,10
2022,Enlisted,84065,110,43,67
2022,Enlisted,84074,13,1,12
2022,Enlisted,84083,5,2,3
2022,Enlisted,84084,78,21,57
2022,Enlisted,84116,6,1,5
2022,Enlisted,84302,13,2,11
2022,Enlisted,84321,3,0,3
2022,Enlisted,84404,3,1,2
2022,Enlisted,84405,14,2,12
2022,Enlisted,84501,7,5,2
2022,Enlisted,84642,18,2,16
2022,Enlisted,84647,7,1,6
2022,Enlisted,84660,39,9,30
2022,Enlisted,84663,8,1,7
2022,Enlisted,84701,12,3,9
2022,Enlisted,84713,9,1,8
2022,Enlisted,84721,7,1,6
2022,Enlisted,84790,25,5,20
2022,Enlisted,85008,130,45,85
2022,Enlisted,85020,20,3,17
2022,Enlisted,85128,2,0,2
2022,Enlisted,85132,47,16,31
2022,Enlisted,85145,1,0,1
2022,Enlisted,85201,15,4,11
2022,Enlisted,85222,14,5,9
2022,Enlisted,85281,4,0,4
2022,Enlisted,85286,14,2,12
2022,Enlisted,85326,2,0,2
2022,Enlisted,85365,3,0,3
2022,Enlisted,85396,18,10,8
2022,Enlisted,85546,2,2,0
2022,Enlisted,85607,4,1,3
2022,Enlisted,85653,11,5,6
2022,Enlisted,85706,10,2,8
2022,Enlisted,85713,9,4,5
2022,Enlisted,85756,13,4,9
2022,Enlisted,85901,2,2,0
2022,Enlisted,86001,4,1,3
2022,Enlisted,86015,40,16,24
2022,Enlisted,86301,14,6,8
2022,Enlisted,87002,10,2,8
2022,Enlisted,87123,37,3,34
2022,Enlisted,87144,46,15,31
2022,Enlisted,87401,6,1,5
2022,Enlisted,87507,4,0,4
2022,Enlisted,87508,2,0,2
2022,Enlisted,87557,1,1,0
2022,Enlisted,88001,17,11,6
2022,Enlisted,88007,26,12,14
2022,Enlisted,88101,4,0,4
2022,Enlisted,88203,29,7,22
2022,Enlisted,88240,4,0,4
2022,Enlisted,88310,10,5,5
2022,Enlisted,89002,11,2,9
2022,Enlisted,89034,2,0,2
2022,Enlisted,89115,8,4,4
2022,Enlisted,89139,61,4,57
2022,Enlisted,89165,137,20,117
2022,Enlisted,89406,12,3,9
2022,Enlisted,89502,2,0,2
2022,Enlisted,89506,87,14,73
2022,Enlisted,89701,26,5,21
2022,Enlisted,89801,2,0,2
2022,Enlisted,89822,1,0,1
2022,Enlisted,90025,25,16,9
2022,Enlisted,90201,40,12,28
2022,Enlisted,90249,5,1,4
2022,Enlisted,90266,7,2,5
2022,Enlisted,90302,19,6,13
2022,Enlisted,90501,21,7,14
2022,Enlisted,90720,182,61,121
2022,Enlisted,90731,9,7,2
2022,Enlisted,90822,35,20,15
2022,Enlisted,91205,34,17,17
2022,Enlisted,91406,14,5,9
2022,Enlisted,91505,33,8,25
2022,Enlisted,91702,55,16,39
2022,Enlisted,91764,34,11,23
2022,Enlisted,91766,38,8,30
2022,Enlisted,91950,26,11,15
2022,Enlisted,92020,24,13,11
2022,Enlisted,92025,8,4,4
2022,Enlisted,92111,34,15,19
2022,Enlisted,92243,12,2,10
2022,Enlisted,92307,5,4,1
2022,Enlisted,92311,3,1,2
2022,Enlisted,92324,26,17,9
2022,Enlisted,92410,35,12,23
2022,Enlisted,92518,41,10,31
2022,Enlisted,92707,10,3,7
2022,Enlisted,92833,26,16,10
2022,Enlisted,92866,18,14,4
2022,Enlisted,93003,8,5,3
2022,Enlisted,93007,21,9,12
2022,Enlisted,93257,1,0,1
2022,Enlisted,93291,14,7,7
2022,Enlisted,93307,39,18,21
2022,Enlisted,93405,4,2,2
2022,Enlisted,93451,22,10,12
2022,Enlisted,93536,7,3,4
2022,Enlisted,93550,14,5,9
2022,Enlisted,93638,6,1,5
2022,Enlisted,93727,50,17,33
2022,Enlisted,93955,6,2,4
2022,Enlisted,94043,2,1,1
2022,Enlisted,94132,7,5,2
2022,Enlisted,94401,2,0,2
2022,Enlisted,94510,4,0,4
2022,Enlisted,94519,14,7,7
2022,Enlisted,94533,3,2,1
2022,Enlisted,94565,2,1,1
2022,Enlisted,94568,35,23,12
2022,Enlisted,94590,16,2,14
2022,Enlisted,94596,10,2,8
2022,Enlisted,94804,11,6,5
2022,Enlisted,94903,6,4,2
2022,Enlisted,94952,6,2,4
2022,Enlisted,95023,13,2,11
2022,Enlisted,95110,8,2,6
2022,Enlisted,95206,36,3,33
2022,Enlisted,95231,2,0,2
2022,Enlisted,95240,11,4,7
2022,Enlisted,95341,2,0,2
2022,Enlisted,95351,16,4,12
2022,Enlisted,95361,9,5,4
2022,Enlisted,95380,1,0,1
2022,Enlisted,95401,6,4,2
2022,Enlisted,95503,2,0,2
2022,Enlisted,95655,6,5,1
2022,Enlisted,95678,8,5,3
2022,Enlisted,95815,4,2,2
2022,Enlisted,95823,2,1,1
2022,Enlisted,95827,3,0,3
2022,Enlisted,95828,67,27,40
2022,Enlisted,95832,10,1,9
2022,Enlisted,95926,8,1,7
2022,Enlisted,95965,6,0,6
2022,Enlisted,96001,8,2,6
2022,Enlisted,96080,5,1,4
2022,Enlisted,96707,88,28,60
2022,Enlisted,96716,7,3,4
2022,Enlisted,96720,17,2,15
2022,Enlisted,96750,3,0,3
2022,Enlisted,96753,16,4,12
2022,Enlisted,96782,39,11,28
2022,Enlisted,96789,70,16,54
2022,Enlisted,96816,1,0,1
2022,Enlisted,96820,5,0,5
2022,Enlisted,96857,23,6,17
2022,Enlisted,96911,2,0,2
2022,Enlisted,96913,77,3,74
2022,Enlisted,97015,60,15,45
2022,Enlisted,97030,12,4,8
2022,Enlisted,97031,1,0,1
2022,Enlisted,97051,6,1,5
2022,Enlisted,97058,5,1,4
2022,Enlisted,97071,13,3,10
2022,Enlisted,97116,13,3,10
2022,Enlisted,97128,7,3,4
2022,Enlisted,97140,8,1,7
2022,Enlisted,97146,12,4,8
2022,Enlisted,97211,23,6,17
2022,Enlisted,97217,9,1,8
2022,Enlisted,97218,14,4,10
2022,Enlisted,97301,40,8,32
2022,Enlisted,97302,15,3,12
2022,Enlisted,97321,2,1,1
2022,Enlisted,97322,10,3,7
2022,Enlisted,97330,22,5,17
2022,Enlisted,97338,12,2,10
2022,Enlisted,97365,2,0,2
2022,Enlisted,97420,4,1,3
2022,Enlisted,97470,10,2,8
2022,Enlisted,97477,47,13,34
2022,Enlisted,97501,23,3,20
2022,Enlisted,97520,11,2,9
2022,Enlisted,97526,6,2,4
2022,Enlisted,97603,1,0,1
2022,Enlisted,97702,7,2,5
2022,Enlisted,97754,5,2,3
2022,Enlisted,97756,4,1,3
2022,Enlisted,97801,11,3,8
2022,Enlisted,97814,2,0,2
2022,Enlisted,97838,9,3,6
2022,Enlisted,97850,11,5,6
2022,Enlisted,97862,2,0,2
2022,Enlisted,98032,61,28,33
2022,Enlisted,98052,1,0,1
2022,Enlisted,98108,22,10,12
2022,Enlisted,98119,37,14,23
2022,Enlisted,98221,2,0,2
2022,Enlisted,98271,12,2,10
2022,Enlisted,98290,10,0,10
2022,Enlisted,98312,6,5,1
2022,Enlisted,98321,13,8,5
2022,Enlisted,98366,3,2,1
2022,Enlisted,98372,3,2,1
2022,Enlisted,98430,46,29,17
2022,Enlisted,98433,91,37,54
2022,Enlisted,98499,1,1,0
2022,Enlisted,98501,21,9,12
2022,Enlisted,98512,4,2,2
2022,Enlisted,98531,30,15,15
2022,Enlisted,98563,20,10,10
2022,Enlisted,98632,1,0,1
2022,Enlisted,98682,18,5,13
2022,Enlisted,98823,3,3,0
2022,Enlisted,98837,14,3,11
2022,Enlisted,98901,38,16,22
2022,Enlisted,98903,12,2,10
2022,Enlisted,98930,5,2,3
2022,Enlisted,99011,28,3,25
2022,Enlisted,99217,12,4,8
2022,Enlisted,99219,18,8,10
2022,Enlisted,99301,1,0,1
2022,Enlisted,99362,6,1,5
2022,Enlisted,99505,101,41,60
2022,Enlisted,99654,13,9,4
2022,Enlisted,99701,2,1,1
2022,Enlisted,99821,1,1,0
2022,Officer,     ,3,3,0
2022,Officer,00000,8,8,0
2022,Officer,00624,1,1,0
2022,Officer,00682,1,1,0
2022,Officer,00693,2,2,0
2022,Officer,00725,1,1,0
2022,Officer,00751,4,3,1
2022,Officer,00769,1,1,0
2022,Officer,00778,2,2,0
2022,Officer,00792,1,1,0
2022,Officer,00795,5,5,0
2022,Officer,00802,2,2,0
2022,Officer,00850,1,1,0
2022,Officer,00934,7,4,3
2022,Officer,01013,3,3,0
2022,Officer,01030,1,1,0
2022,Officer,01082,1,1,0
2022,Officer,01085,1,1,0
2022,Officer,01434,1,1,0
2022,Officer,01440,1,1,0
2022,Officer,01588,1,1,0
2022,Officer,01605,2,2,0
2022,Officer,01702,1,1,0
2022,Officer,01731,12,7,5
2022,Officer,01760,1,1,0
2022,Officer,01844,5,5,0
2022,Officer,01867,7,7,0
2022,Officer,02138,2,2,0
2022,Officer,02169,7,7,0
2022,Officer,02420,1,1,0
2022,Officer,02542,7,7,0
2022,Officer,02769,3,3,0
2022,Officer,02780,4,4,0
2022,Officer,02816,1,1,0
2022,Officer,02818,6,5,1
2022,Officer,02842,2,2,0
2022,Officer,02852,6,6,0
2022,Officer,02886,11,10,1
2022,Officer,02896,1,1,0
2022,Officer,02906,4,4,0
2022,Officer,02920,2,2,0
2022,Officer,03101,4,4,0
2022,Officer,03244,2,2,0
2022,Officer,03275,2,2,0
2022,Officer,03301,9,6,3
2022,Officer,03561,1,1,0
2022,Officer,03766,1,1,0
2022,Officer,03801,2,2,0
2022,Officer,04011,2,2,0
2022,Officer,04092,1,0,1
2022,Officer,04240,1,0,1
2022,Officer,04268,1,0,1
2022,Officer,04330,8,8,0
2022,Officer,04401,4,3,1
2022,Officer,04412,2,2,0
2022,Officer,04619,1,1,0
2022,Officer,04901,2,2,0
2022,Officer,05404,1,1,0
2022,Officer,05446,23,22,1
2022,Officer,05465,7,7,0
2022,Officer,05478,6,6,0
2022,Officer,05495,2,2,0
2022,Officer,05633,1,1,0
2022,Officer,05663,3,3,0
2022,Officer,05701,2,0,2
2022,Officer,06082,1,1,0
2022,Officer,06096,8,7,1
2022,Officer,06110,2,2,0
2022,Officer,06320,4,4,0
2022,Officer,06340,2,2,0
2022,Officer,06357,4,3,1
2022,Officer,06360,3,3,0
2022,Officer,06457,3,3,0
2022,Officer,06489,1,1,0
2022,Officer,06497,1,1,0
2022,Officer,06498,1,1,0
2022,Officer,06512,9,9,0
2022,Officer,06702,1,1,0
2022,Officer,06810,1,0,1
2022,Officer,07052,7,7,0
2022,Officer,07090,1,1,0
2022,Officer,07107,3,3,0
2022,Officer,07306,7,5,2
2022,Officer,07457,1,1,0
2022,Officer,07666,6,6,0
2022,Officer,07728,8,8,0
2022,Officer,07806,1,1,0
2022,Officer,07865,3,3,0
2022,Officer,07960,1,1,0
2022,Officer,08002,1,1,0
2022,Officer,08037,2,2,0
2022,Officer,08060,2,2,0
2022,Officer,08210,1,1,0
2022,Officer,08360,1,1,0
2022,Officer,08640,6,4,2
2022,Officer,08648,6,6,0
2022,Officer,08733,4,4,0
2022,Officer,08750,4,3,1
2022,Officer,08759,2,2,0
2022,Officer,08873,2,2,0
2022,Officer,10010,5,4,1
2022,Officer,10037,3,3,0
2022,Officer,10314,1,1,0
2022,Officer,10566,9,9,0
2022,Officer,10567,10,10,0
2022,Officer,10701,4,3,1
2022,Officer,11252,1,1,0
2022,Officer,11357,3,3,0
2022,Officer,11433,2,2,0
2022,Officer,11735,2,2,0
2022,Officer,11779,6,6,0
2022,Officer,12110,8,6,2
2022,Officer,12180,4,3,1
2022,Officer,12189,4,2,2
2022,Officer,12301,3,3,0
2022,Officer,12302,1,1,0
2022,Officer,12553,1,1,0
2022,Officer,12804,2,1,1
2022,Officer,13021,1,1,0
2022,Officer,13211,9,9,0
2022,Officer,13501,3,3,0
2022,Officer,13502,1,1,0
2022,Officer,13905,7,7,0
2022,Officer,14094,1,1,0
2022,Officer,14204,2,2,0
2022,Officer,14213,5,5,0
2022,Officer,14304,2,2,0
2022,Officer,14454,1,1,0
2022,Officer,14456,2,2,0
2022,Officer,14624,10,10,0
2022,Officer,14843,3,3,0
2022,Officer,14850,1,1,0
2022,Officer,15010,3,3,0
2022,Officer,15216,5,4,1
2022,Officer,15301,6,6,0
2022,Officer,15444,1,1,0
2022,Officer,15601,1,1,0
2022,Officer,15666,2,2,0
2022,Officer,15701,2,2,0
2022,Officer,15904,1,1,0
2022,Officer,16101,6,6,0
2022,Officer,16127,3,3,0
2022,Officer,16226,1,1,0
2022,Officer,16403,9,9,0
2022,Officer,16635,2,2,0
2022,Officer,16652,1,1,0
2022,Officer,16803,1,1,0
2022,Officer,16830,1,1,0
2022,Officer,16901,1,1,0
2022,Officer,17003,30,30,0
2022,Officer,17013,4,4,0
2022,Officer,17022,9,8,1
2022,Officer,17033,1,1,0
2022,Officer,17042,7,7,0
2022,Officer,17044,1,0,1
2022,Officer,17103,1,1,0
2022,Officer,17222,2,2,0
2022,Officer,17325,1,1,0
2022,Officer,17331,2,2,0
2022,Officer,18040,3,3,0
2022,Officer,18102,6,6,0
2022,Officer,18201,2,2,0
2022,Officer,18235,1,1,0
2022,Officer,18252,1,1,0
2022,Officer,18407,1,1,0
2022,Officer,18431,1,1,0
2022,Officer,18509,11,10,1
2022,Officer,18704,1,1,0
2022,Officer,19044,4,4,0
2022,Officer,19104,4,4,0
2022,Officer,19153,3,3,0
2022,Officer,19154,7,7,0
2022,Officer,19462,2,2,0
2022,Officer,19475,4,4,0
2022,Officer,19526,2,2,0
2022,Officer,19530,1,1,0
2022,Officer,19605,4,4,0
2022,Officer,19711,1,0,1
2022,Officer,19720,1,1,0
2022,Officer,19939,2,2,0
2022,Officer,19977,3,3,0
2022,Officer,20003,19,15,4
2022,Officer,20112,6,6,0
2022,Officer,20175,1,1,0
2022,Officer,20186,2,2,0
2022,Officer,20646,1,1,0
2022,Officer,20653,1,1,0
2022,Officer,20708,4,4,0
2022,Officer,20882,4,4,0
2022,Officer,21010,13,11,2
2022,Officer,21057,2,2,0
2022,Officer,21061,1,1,0
2022,Officer,21078,1,1,0
2022,Officer,21136,6,5,1
2022,Officer,21157,2,2,0
2022,Officer,21201,2,1,1
2022,Officer,21204,1,1,0
2022,Officer,21216,2,2,0
2022,Officer,21222,11,11,0
2022,Officer,21228,6,6,0
2022,Officer,21657,1,1,0
2022,Officer,21701,3,3,0
2022,Officer,21784,3,3,0
2022,Officer,22032,1,1,0
2022,Officer,22060,13,12,1
2022,Officer,22401,5,5,0
2022,Officer,22427,2,2,0
2022,Officer,22602,4,4,0
2022,Officer,22664,1,1,0
2022,Officer,22902,1,1,0
2022,Officer,23139,2,2,0
2022,Officer,23150,7,7,0
2022,Officer,23181,1,1,0
2022,Officer,23237,1,1,0
2022,Officer,23434,1,1,0
2022,Officer,23451,3,3,0
2022,Officer,23502,4,4,0
2022,Officer,23609,1,1,0
2022,Officer,23666,4,4,0
2022,Officer,23701,3,3,0
2022,Officer,23805,3,3,0
2022,Officer,23824,4,4,0
2022,Officer,23847,1,1,0
2022,Officer,24073,2,2,0
2022,Officer,24151,1,1,0
2022,Officer,24175,1,1,0
2022,Officer,24251,1,1,0
2022,Officer,24401,3,3,0
2022,Officer,24502,2,2,0
2022,Officer,24540,1,1,0
2022,Officer,24701,2,2,0
2022,Officer,24957,1,1,0
2022,Officer,25064,1,1,0
2022,Officer,25168,1,1,0
2022,Officer,25177,1,1,0
2022,Officer,25262,1,1,0
2022,Officer,25309,4,4,0
2022,Officer,25311,2,2,0
2022,Officer,25401,1,1,0
2022,Officer,25405,1,1,0
2022,Officer,25530,1,1,0
2022,Officer,25846,3,3,0
2022,Officer,26003,2,2,0
2022,Officer,26041,2,2,0
2022,Officer,26101,1,1,0
2022,Officer,26201,1,1,0
2022,Officer,26250,1,1,0
2022,Officer,26301,1,1,0
2022,Officer,26537,5,5,0
2022,Officer,26554,2,2,0
2022,Officer,26651,1,1,0
2022,Officer,27103,1,0,1
2022,Officer,27217,1,1,0
2022,Officer,27260,1,1,0
2022,Officer,27344,1,1,0
2022,Officer,27401,2,2,0
2022,Officer,27504,3,2,1
2022,Officer,27530,2,2,0
2022,Officer,27560,4,3,1
2022,Officer,27581,1,1,0
2022,Officer,27596,1,0,1
2022,Officer,27607,2,2,0
2022,Officer,27704,2,2,0
2022,Officer,28001,3,3,0
2022,Officer,28012,5,5,0
2022,Officer,28043,2,2,0
2022,Officer,28054,3,2,1
2022,Officer,28147,1,1,0
2022,Officer,28170,2,2,0
2022,Officer,28208,5,5,0
2022,Officer,28306,5,5,0
2022,Officer,28310,6,6,0
2022,Officer,28328,3,3,0
2022,Officer,28337,1,1,0
2022,Officer,28345,2,2,0
2022,Officer,28352,1,1,0
2022,Officer,28371,1,1,0
2022,Officer,28376,3,3,0
2022,Officer,28377,2,2,0
2022,Officer,28384,1,1,0
2022,Officer,28401,1,0,1
2022,Officer,28405,4,4,0
2022,Officer,28560,2,1,1
2022,Officer,28658,1,1,0
2022,Officer,28659,2,2,0
2022,Officer,28734,1,1,0
2022,Officer,29044,27,24,3
2022,Officer,29108,3,3,0
2022,Officer,29161,2,2,0
2022,Officer,29170,2,2,0
2022,Officer,29201,5,4,1
2022,Officer,29303,2,2,0
2022,Officer,29379,7,6,1
2022,Officer,29409,2,2,0
2022,Officer,29418,2,2,0
2022,Officer,29440,6,5,1
2022,Officer,29464,4,4,0
2022,Officer,29488,1,1,0
2022,Officer,29506,1,1,0
2022,Officer,29532,1,1,0
2022,Officer,29571,1,1,0
2022,Officer,29605,3,3,0
2022,Officer,29625,13,12,1
2022,Officer,29640,1,1,0
2022,Officer,29644,2,2,0
2022,Officer,29646,1,1,0
2022,Officer,29651,1,1,0
2022,Officer,29678,1,1,0
2022,Officer,29732,3,3,0
2022,Officer,29824,6,6,0
2022,Officer,29829,1,1,0
2022,Officer,29906,1,1,0
2022,Officer,29944,3,3,0
2022,Officer,30014,1,1,0
2022,Officer,30040,5,5,0
2022,Officer,30046,2,2,0
2022,Officer,30060,19,17,2
2022,Officer,30069,1,1,0
2022,Officer,30114,1,1,0
2022,Officer,30144,2,2,0
2022,Officer,30161,1,1,0
2022,Officer,30224,1,1,0
2022,Officer,30263,2,2,0
2022,Officer,30297,5,5,0
2022,Officer,30336,6,6,0
2022,Officer,30401,1,1,0
2022,Officer,30680,3,3,0
2022,Officer,30720,1,1,0
2022,Officer,30824,1,1,0
2022,Officer,30830,1,1,0
2022,Officer,30904,1,1,0
2022,Officer,30905,2,2,0
2022,Officer,31029,5,5,0
2022,Officer,31040,1,1,0
2022,Officer,31061,27,27,0
2022,Officer,31211,13,13,0
2022,Officer,31313,1,1,0
2022,Officer,31601,1,1,0
2022,Officer,31704,1,1,0
2022,Officer,31792,3,3,0
2022,Officer,31794,2,2,0
2022,Officer,31901,3,3,0
2022,Officer,31905,3,3,0
2022,Officer,32055,1,0,1
2022,Officer,32084,2,2,0
2022,Officer,32086,5,3,2
2022,Officer,32091,15,12,3
2022,Officer,32164,1,1,0
2022,Officer,32177,1,1,0
2022,Officer,32221,8,7,1
2022,Officer,32311,3,3,0
2022,Officer,32351,2,1,1
2022,Officer,32405,2,2,0
2022,Officer,32425,3,2,1
2022,Officer,32446,1,0,1
2022,Officer,32514,4,3,1
2022,Officer,32539,2,2,0
2022,Officer,32721,2,1,1
2022,Officer,32724,1,1,0
2022,Officer,32726,1,1,0
2022,Officer,32806,4,3,1
2022,Officer,32862,1,0,1
2022,Officer,32922,1,1,0
2022,Officer,32935,2,0,2
2022,Officer,33027,4,3,1
2022,Officer,33127,3,2,1
2022,Officer,33315,1,1,0
2022,Officer,33401,1,1,0
2022,Officer,33405,2,2,0
2022,Officer,33523,3,0,3
2022,Officer,33563,7,7,0
2022,Officer,33606,1,1,0
2022,Officer,33782,17,12,5
2022,Officer,33811,3,2,1
2022,Officer,33825,4,2,2
2022,Officer,33830,3,3,0
2022,Officer,33859,1,0,1
2022,Officer,33873,1,1,0
2022,Officer,33880,1,1,0
2022,Officer,33916,1,1,0
2022,Officer,34208,2,1,1
2022,Officer,34221,3,3,0
2022,Officer,34237,3,3,0
2022,Officer,34429,1,1,0
2022,Officer,34474,1,1,0
2022,Officer,34947,1,0,1
2022,Officer,35010,2,2,0
2022,Officer,35016,3,2,1
2022,Officer,35042,2,2,0
2022,Officer,35055,1,1,0
2022,Officer,35121,2,1,1
2022,Officer,35146,1,1,0
2022,Officer,35160,5,4,1
2022,Officer,35178,2,2,0
2022,Officer,35209,3,2,1
2022,Officer,35217,4,4,0
2022,Officer,35405,3,3,0
2022,Officer,35476,1,1,0
2022,Officer,35555,2,2,0
2022,Officer,35565,1,1,0
2022,Officer,35601,4,3,1
2022,Officer,35904,2,1,1
2022,Officer,36027,1,1,0
2022,Officer,36043,4,4,0
2022,Officer,36078,1,1,0
2022,Officer,36081,3,3,0
2022,Officer,36083,1,1,0
2022,Officer,36109,2,2,0
2022,Officer,36117,2,2,0
2022,Officer,36203,1,1,0
2022,Officer,36205,3,3,0
2022,Officer,36301,3,3,0
2022,Officer,36330,2,2,0
2022,Officer,36340,1,1,0
2022,Officer,36420,2,2,0
2022,Officer,36426,1,0,1
2022,Officer,36442,1,1,0
2022,Officer,36502,1,1,0
2022,Officer,36522,1,1,0
2022,Officer,36535,1,1,0
2022,Officer,36605,4,3,1
2022,Officer,36701,1,1,0
2022,Officer,36832,3,3,0
2022,Officer,36854,2,2,0
2022,Officer,36867,1,0,1
2022,Officer,37015,1,1,0
2022,Officer,37033,1,1,0
2022,Officer,37083,1,1,0
2022,Officer,37090,1,1,0
2022,Officer,37091,2,2,0
2022,Officer,37097,1,1,0
2022,Officer,37110,1,1,0
2022,Officer,37129,2,2,0
2022,Officer,37167,12,9,3
2022,Officer,37185,1,1,0
2022,Officer,37204,10,9,1
2022,Officer,37217,6,6,0
2022,Officer,37306,2,1,1
2022,Officer,37388,2,2,0
2022,Officer,37398,1,1,0
2022,Officer,37404,5,5,0
2022,Officer,37615,1,0,1
2022,Officer,37645,1,1,0
2022,Officer,37743,1,1,0
2022,Officer,37777,6,6,0
2022,Officer,37801,1,1,0
2022,Officer,37857,1,1,0
2022,Officer,37874,4,4,0
2022,Officer,37919,6,6,0
2022,Officer,38008,1,1,0
2022,Officer,38012,1,1,0
2022,Officer,38019,1,1,0
2022,Officer,38053,1,1,0
2022,Officer,38063,3,3,0
2022,Officer,38301,1,1,0
2022,Officer,38305,1,1,0
2022,Officer,38320,1,1,0
2022,Officer,38340,3,3,0
2022,Officer,38343,1,1,0
2022,Officer,38344,1,1,0
2022,Officer,38358,2,1,1
2022,Officer,38375,2,2,0
2022,Officer,38382,2,2,0
2022,Officer,38478,1,1,0
2022,Officer,38506,1,1,0
2022,Officer,38570,1,1,0
2022,Officer,38572,1,1,0
2022,Officer,38583,2,2,0
2022,Officer,38606,2,2,0
2022,Officer,38801,4,4,0
2022,Officer,38829,3,3,0
2022,Officer,38834,1,1,0
2022,Officer,38851,1,1,0
2022,Officer,38863,2,2,0
2022,Officer,38901,2,2,0
2022,Officer,38915,2,2,0
2022,Officer,38967,1,1,0
2022,Officer,39047,1,1,0
2022,Officer,39090,1,1,0
2022,Officer,39111,1,1,0
2022,Officer,39183,1,1,0
2022,Officer,39204,3,1,2
2022,Officer,39209,1,1,0
2022,Officer,39232,2,2,0
2022,Officer,39466,1,1,0
2022,Officer,39505,2,2,0
2022,Officer,39507,1,0,1
2022,Officer,39648,1,1,0
2022,Officer,39654,1,1,0
2022,Officer,39704,1,1,0
2022,Officer,39730,2,2,0
2022,Officer,39759,2,2,0
2022,Officer,39773,1,1,0
2022,Officer,40004,2,2,0
2022,Officer,40065,2,2,0
2022,Officer,40069,1,1,0
2022,Officer,40108,2,2,0
2022,Officer,40205,3,3,0
2022,Officer,40218,2,2,0
2022,Officer,40311,1,1,0
2022,Officer,40330,1,1,0
2022,Officer,40472,1,1,0
2022,Officer,40475,6,5,1
2022,Officer,40510,10,10,0
2022,Officer,40601,12,11,1
2022,Officer,40741,1,1,0
2022,Officer,40769,1,1,0
2022,Officer,40906,1,1,0
2022,Officer,40965,1,1,0
2022,Officer,41005,4,4,0
2022,Officer,41008,1,1,0
2022,Officer,41031,2,2,0
2022,Officer,41101,2,2,0
2022,Officer,41164,1,1,0
2022,Officer,42025,1,1,0
2022,Officer,42086,2,2,0
2022,Officer,42101,2,1,1
2022,Officer,42141,3,3,0
2022,Officer,42240,1,1,0
2022,Officer,42301,4,4,0
2022,Officer,42633,1,1,0
2022,Officer,43015,3,3,0
2022,Officer,43040,3,3,0
2022,Officer,43055,1,1,0
2022,Officer,43213,15,14,1
2022,Officer,43217,6,6,0
2022,Officer,43235,1,1,0
2022,Officer,43465,3,3,0
2022,Officer,43614,1,1,0
2022,Officer,43756,1,1,0
2022,Officer,44023,2,2,0
2022,Officer,44055,3,3,0
2022,Officer,44128,1,1,0
2022,Officer,44224,2,2,0
2022,Officer,44256,2,2,0
2022,Officer,44313,2,2,0
2022,Officer,44444,3,3,0
2022,Officer,44691,1,1,0
2022,Officer,44720,3,3,0
2022,Officer,45015,1,1,0
2022,Officer,45215,6,6,0
2022,Officer,45356,2,2,0
2022,Officer,45430,6,6,0
2022,Officer,45502,7,7,0
2022,Officer,45601,2,2,0
2022,Officer,45662,1,1,0
2022,Officer,45804,1,1,0
2022,Officer,45885,1,1,0
2022,Officer,46012,3,2,1
2022,Officer,46036,2,2,0
2022,Officer,46041,1,1,0
2022,Officer,46052,1,1,0
2022,Officer,46124,3,3,0
2022,Officer,46131,13,13,0
2022,Officer,46140,1,1,0
2022,Officer,46176,1,1,0
2022,Officer,46216,3,3,0
2022,Officer,46228,1,1,0
2022,Officer,46241,20,17,3
2022,Officer,46383,1,1,0
2022,Officer,46402,3,3,0
2022,Officer,46406,2,2,0
2022,Officer,46563,2,2,0
2022,Officer,46825,3,3,0
2022,Officer,47150,4,4,0
2022,Officer,47167,1,1,0
2022,Officer,47203,4,4,0
2022,Officer,47250,1,1,0
2022,Officer,47265,1,1,0
2022,Officer,47274,1,1,0
2022,Officer,47303,1,1,0
2022,Officer,47331,2,2,0
2022,Officer,47348,1,1,0
2022,Officer,47394,1,1,0
2022,Officer,47401,1,1,0
2022,Officer,47421,1,1,0
2022,Officer,47501,1,1,0
2022,Officer,47591,1,1,0
2022,Officer,47715,6,6,0
2022,Officer,47834,1,1,0
2022,Officer,47904,1,1,0
2022,Officer,47905,3,3,0
2022,Officer,47960,2,2,0
2022,Officer,48060,2,2,0
2022,Officer,48180,3,3,0
2022,Officer,48197,2,2,0
2022,Officer,48208,2,2,0
2022,Officer,48234,7,7,0
2022,Officer,48446,1,1,0
2022,Officer,48601,6,6,0
2022,Officer,48642,3,3,0
2022,Officer,48706,2,2,0
2022,Officer,48801,1,1,0
2022,Officer,48817,3,3,0
2022,Officer,48837,4,4,0
2022,Officer,48838,2,2,0
2022,Officer,48843,2,2,0
2022,Officer,48906,8,8,0
2022,Officer,48912,1,1,0
2022,Officer,49009,3,3,0
2022,Officer,49012,5,5,0
2022,Officer,49047,1,1,0
2022,Officer,49224,1,1,0
2022,Officer,49509,12,12,0
2022,Officer,49601,1,1,0
2022,Officer,49696,3,3,0
2022,Officer,49739,1,1,0
2022,Officer,49783,1,1,0
2022,Officer,49801,2,2,0
2022,Officer,49837,1,1,0
2022,Officer,49849,2,2,0
2022,Officer,50025,1,0,1
2022,Officer,50036,3,3,0
2022,Officer,50126,1,1,0
2022,Officer,50131,37,33,4
2022,Officer,50158,1,1,0
2022,Officer,50321,1,1,0
2022,Officer,50501,2,2,0
2022,Officer,50588,3,3,0
2022,Officer,50616,2,2,0
2022,Officer,50703,2,2,0
2022,Officer,50709,3,3,0
2022,Officer,51031,2,2,0
2022,Officer,51111,2,2,0
2022,Officer,51301,2,2,0
2022,Officer,51334,1,1,0
2022,Officer,51442,1,1,0
2022,Officer,51503,1,1,0
2022,Officer,51566,1,1,0
2022,Officer,52001,2,2,0
2022,Officer,52246,4,4,0
2022,Officer,52353,1,1,0
2022,Officer,52404,2,2,0
2022,Officer,52501,1,1,0
2022,Officer,52577,1,1,0
2022,Officer,52806,5,4,1
2022,Officer,53066,1,1,0
2022,Officer,53094,1,1,0
2022,Officer,53095,2,2,0
2022,Officer,53144,1,1,0
2022,Officer,53154,5,4,1
2022,Officer,53186,4,1,3
2022,Officer,53212,10,9,1
2022,Officer,53403,2,2,0
2022,Officer,53511,2,2,0
2022,Officer,53545,1,1,0
2022,Officer,53581,1,1,0
2022,Officer,53704,10,10,0
2022,Officer,53901,1,1,0
2022,Officer,53948,1,1,0
2022,Officer,54017,1,1,0
2022,Officer,54022,1,1,0
2022,Officer,54303,1,1,0
2022,Officer,54401,1,1,0
2022,Officer,54409,1,1,0
2022,Officer,54449,1,1,0
2022,Officer,54451,1,1,0
2022,Officer,54455,1,1,0
2022,Officer,54456,3,3,0
2022,Officer,54481,1,1,0
2022,Officer,54495,1,1,0
2022,Officer,54501,2,2,0
2022,Officer,54612,1,1,0
2022,Officer,54618,3,2,1
2022,Officer,54650,1,1,0
2022,Officer,54703,2,2,0
2022,Officer,54729,2,2,0
2022,Officer,54751,1,1,0
2022,Officer,54880,1,1,0
2022,Officer,54901,2,2,0
2022,Officer,54914,2,2,0
2022,Officer,54932,2,1,1
2022,Officer,54935,2,2,0
2022,Officer,54971,1,1,0
2022,Officer,54981,1,1,0
2022,Officer,55008,3,3,0
2022,Officer,55016,7,6,1
2022,Officer,55021,1,1,0
2022,Officer,55063,1,1,0
2022,Officer,55066,1,1,0
2022,Officer,55068,5,5,0
2022,Officer,55077,1,1,0
2022,Officer,55082,6,6,0
2022,Officer,55101,1,1,0
2022,Officer,55106,1,1,0
2022,Officer,55107,1,1,0
2022,Officer,55111,1,1,0
2022,Officer,55112,14,11,3
2022,Officer,55118,4,4,0
2022,Officer,55303,2,2,0
2022,Officer,55355,2,2,0
2022,Officer,55431,3,3,0
2022,Officer,55443,1,1,0
2022,Officer,55720,1,1,0
2022,Officer,55811,3,3,0
2022,Officer,55912,3,3,0
2022,Officer,55987,3,3,0
2022,Officer,56001,2,2,0
2022,Officer,56007,1,1,0
2022,Officer,56031,1,1,0
2022,Officer,56073,1,1,0
2022,Officer,56082,1,1,0
2022,Officer,56143,1,1,0
2022,Officer,56201,3,3,0
2022,Officer,56208,2,2,0
2022,Officer,56256,1,1,0
2022,Officer,56258,1,1,0
2022,Officer,56265,1,1,0
2022,Officer,56273,1,1,0
2022,Officer,56278,1,1,0
2022,Officer,56301,2,2,0
2022,Officer,56303,2,2,0
2022,Officer,56308,1,1,0
2022,Officer,56345,5,5,0
2022,Officer,56401,5,5,0
2022,Officer,56482,2,2,0
2022,Officer,56560,5,4,1
2022,Officer,56601,2,2,0
2022,Officer,57042,1,1,0
2022,Officer,57078,2,2,0
2022,Officer,57104,3,3,0
2022,Officer,57201,4,4,0
2022,Officer,57252,1,1,0
2022,Officer,57325,1,1,0
2022,Officer,57366,3,3,0
2022,Officer,57401,1,1,0
2022,Officer,57702,8,7,1
2022,Officer,57703,2,2,0
2022,Officer,57785,2,2,0
2022,Officer,58072,2,2,0
2022,Officer,58102,12,12,0
2022,Officer,58201,4,4,0
2022,Officer,58301,2,2,0
2022,Officer,58401,1,1,0
2022,Officer,58433,1,1,0
2022,Officer,58501,5,5,0
2022,Officer,58506,1,1,0
2022,Officer,58703,3,3,0
2022,Officer,59102,3,3,0
2022,Officer,59301,1,1,0
2022,Officer,59405,2,2,0
2022,Officer,59602,4,4,0
2022,Officer,59636,4,4,0
2022,Officer,59701,1,1,0
2022,Officer,59711,1,0,1
2022,Officer,59760,3,1,2
2022,Officer,59808,3,2,1
2022,Officer,59901,5,5,0
2022,Officer,60037,2,1,1
2022,Officer,60178,1,1,0
2022,Officer,60435,1,1,0
2022,Officer,60472,4,3,1
2022,Officer,60505,1,1,0
2022,Officer,60545,1,1,0
2022,Officer,60546,7,5,2
2022,Officer,60615,8,6,2
2022,Officer,60651,3,2,1
2022,Officer,61021,1,1,0
2022,Officer,61115,1,1,0
2022,Officer,61201,1,1,0
2022,Officer,61264,2,2,0
2022,Officer,61341,1,1,0
2022,Officer,61401,3,3,0
2022,Officer,61443,3,2,1
2022,Officer,61607,6,5,1
2022,Officer,61761,3,3,0
2022,Officer,61801,6,5,1
2022,Officer,61820,1,1,0
2022,Officer,61944,1,1,0
2022,Officer,62056,3,2,1
2022,Officer,62286,4,4,0
2022,Officer,62301,1,0,1
2022,Officer,62439,2,1,1
2022,Officer,62521,1,1,0
2022,Officer,62659,2,2,0
2022,Officer,62702,15,13,2
2022,Officer,62864,3,2,1
2022,Officer,62896,2,2,0
2022,Officer,62959,2,2,0
2022,Officer,62966,1,1,0
2022,Officer,63028,1,1,0
2022,Officer,63077,1,1,0
2022,Officer,63125,5,5,0
2022,Officer,63383,1,1,0
2022,Officer,63552,1,1,0
2022,Officer,63701,2,2,0
2022,Officer,63703,1,1,0
2022,Officer,63755,2,2,0
2022,Officer,63775,1,1,0
2022,Officer,63801,1,1,0
2022,Officer,63841,1,1,0
2022,Officer,64052,2,2,0
2022,Officer,64067,1,1,0
2022,Officer,64085,2,2,0
2022,Officer,64129,17,16,1
2022,Officer,64402,1,1,0
2022,Officer,64468,1,1,0
2022,Officer,64506,4,4,0
2022,Officer,64601,3,3,0
2022,Officer,64683,1,1,0
2022,Officer,64759,1,1,0
2022,Officer,64772,1,1,0
2022,Officer,64804,2,1,1
2022,Officer,64836,1,1,0
2022,Officer,64850,1,1,0
2022,Officer,65101,13,12,1
2022,Officer,65109,1,1,0
2022,Officer,65202,2,2,0
2022,Officer,65251,1,1,0
2022,Officer,65265,2,2,0
2022,Officer,65301,2,2,0
2022,Officer,65305,5,5,0
2022,Officer,65340,3,3,0
2022,Officer,65401,1,1,0
2022,Officer,65723,3,3,0
2022,Officer,65775,2,2,0
2022,Officer,65802,3,3,0
2022,Officer,65803,1,1,0
2022,Officer,66027,2,2,0
2022,Officer,66044,1,1,0
2022,Officer,66061,2,2,0
2022,Officer,66067,1,1,0
2022,Officer,66102,4,4,0
2022,Officer,66217,1,1,0
2022,Officer,66219,7,6,1
2022,Officer,66434,3,3,0
2022,Officer,66436,1,1,0
2022,Officer,66441,1,1,0
2022,Officer,66502,5,5,0
2022,Officer,66619,9,8,1
2022,Officer,66749,2,2,0
2022,Officer,66762,1,1,0
2022,Officer,66801,2,2,0
2022,Officer,66901,1,1,0
2022,Officer,67010,1,1,0
2022,Officer,67114,2,2,0
2022,Officer,67124,1,1,0
2022,Officer,67217,2,2,0
2022,Officer,67219,7,7,0
2022,Officer,67410,1,1,0
2022,Officer,67501,2,2,0
2022,Officer,67601,2,2,0
2022,Officer,67801,1,1,0
2022,Officer,67901,1,1,0
2022,Officer,68003,1,1,0
2022,Officer,68073,2,2,0
2022,Officer,68106,1,1,0
2022,Officer,68142,3,3,0
2022,Officer,68508,3,3,0
2022,Officer,68524,6,6,0
2022,Officer,68803,1,1,0
2022,Officer,68847,1,1,0
2022,Officer,68901,1,1,0
2022,Officer,69162,1,1,0
2022,Officer,70072,1,1,0
2022,Officer,70117,10,9,1
2022,Officer,70364,1,1,0
2022,Officer,70401,8,8,0
2022,Officer,70410,1,1,0
2022,Officer,70427,2,2,0
2022,Officer,70433,1,1,0
2022,Officer,70460,2,2,0
2022,Officer,70508,2,2,0
2022,Officer,70510,1,1,0
2022,Officer,70526,1,1,0
2022,Officer,70582,1,1,0
2022,Officer,70586,1,1,0
2022,Officer,70601,1,1,0
2022,Officer,70721,3,3,0
2022,Officer,70760,2,2,0
2022,Officer,70764,3,3,0
2022,Officer,70820,2,2,0
2022,Officer,71055,2,2,0
2022,Officer,71101,1,1,0
2022,Officer,71203,2,2,0
2022,Officer,71270,2,2,0
2022,Officer,71303,1,1,0
2022,Officer,71351,2,2,0
2022,Officer,71360,5,5,0
2022,Officer,71373,1,1,0
2022,Officer,71415,1,1,0
2022,Officer,71417,1,1,0
2022,Officer,71457,2,2,0
2022,Officer,71602,2,2,0
2022,Officer,71671,1,1,0
2022,Officer,71701,1,1,0
2022,Officer,71730,2,2,0
2022,Officer,71832,1,1,0
2022,Officer,71854,2,2,0
2022,Officer,71857,1,1,0
2022,Officer,71923,1,1,0
2022,Officer,71953,1,1,0
2022,Officer,72012,2,2,0
2022,Officer,72023,1,1,0
2022,Officer,72032,3,2,1
2022,Officer,72086,2,2,0
2022,Officer,72143,1,1,0
2022,Officer,72199,17,15,2
2022,Officer,72401,3,3,0
2022,Officer,72501,1,1,0
2022,Officer,72650,1,1,0
2022,Officer,72653,2,2,0
2022,Officer,72712,2,2,0
2022,Officer,72713,2,2,0
2022,Officer,72744,2,2,0
2022,Officer,72802,1,1,0
2022,Officer,72855,2,2,0
2022,Officer,72923,3,3,0
2022,Officer,72949,1,1,0
2022,Officer,73034,3,2,1
2022,Officer,73064,8,8,0
2022,Officer,73069,11,9,2
2022,Officer,73111,12,12,0
2022,Officer,73401,3,2,1
2022,Officer,73501,1,1,0
2022,Officer,73503,6,5,1
2022,Officer,73521,1,1,0
2022,Officer,73705,2,2,0
2022,Officer,74014,4,3,1
2022,Officer,74017,1,1,0
2022,Officer,74075,1,1,0
2022,Officer,74107,1,1,0
2022,Officer,74403,2,2,0
2022,Officer,74447,1,1,0
2022,Officer,74820,2,2,0
2022,Officer,74834,1,0,1
2022,Officer,75051,20,20,0
2022,Officer,75077,3,3,0
2022,Officer,75098,4,4,0
2022,Officer,75110,1,1,0
2022,Officer,75159,1,1,0
2022,Officer,75165,2,2,0
2022,Officer,75237,2,2,0
2022,Officer,75402,2,2,0
2022,Officer,75570,2,2,0
2022,Officer,75662,1,1,0
2022,Officer,75709,1,1,0
2022,Officer,75803,1,1,0
2022,Officer,75901,4,4,0
2022,Officer,76086,2,2,0
2022,Officer,76108,5,5,0
2022,Officer,76207,1,1,0
2022,Officer,76502,8,8,0
2022,Officer,76542,3,3,0
2022,Officer,76574,2,2,0
2022,Officer,76707,7,7,0
2022,Officer,77034,10,10,0
2022,Officer,77067,9,9,0
2022,Officer,77082,4,4,0
2022,Officer,77340,2,2,0
2022,Officer,77437,1,1,0
2022,Officer,77471,1,1,0
2022,Officer,77515,1,1,0
2022,Officer,77568,1,0,1
2022,Officer,77802,2,2,0
2022,Officer,77833,1,1,0
2022,Officer,78041,2,2,0
2022,Officer,78130,2,2,0
2022,Officer,78218,9,9,0
2022,Officer,78219,2,2,0
2022,Officer,78257,12,12,0
2022,Officer,78363,1,1,0
2022,Officer,78416,2,2,0
2022,Officer,78596,3,3,0
2022,Officer,78602,3,3,0
2022,Officer,78617,2,2,0
2022,Officer,78624,2,2,0
2022,Officer,78665,8,8,0
2022,Officer,78666,7,7,0
2022,Officer,78703,21,18,3
2022,Officer,78731,2,2,0
2022,Officer,79107,1,1,0
2022,Officer,79403,1,1,0
2022,Officer,79607,3,3,0
2022,Officer,79705,1,1,0
2022,Officer,79936,7,7,0
2022,Officer,80011,23,23,0
2022,Officer,80012,1,1,0
2022,Officer,80112,8,8,0
2022,Officer,80216,3,3,0
2022,Officer,80501,2,2,0
2022,Officer,80521,4,4,0
2022,Officer,80550,1,1,0
2022,Officer,80907,2,2,0
2022,Officer,80913,3,3,0
2022,Officer,80916,3,3,0
2022,Officer,80920,9,9,0
2022,Officer,81004,1,1,0
2022,Officer,81501,1,1,0
2022,Officer,82005,3,2,1
2022,Officer,82009,6,5,1
2022,Officer,82604,1,1,0
2022,Officer,82801,2,2,0
2022,Officer,82901,1,1,0
2022,Officer,82930,2,2,0
2022,Officer,83202,8,8,0
2022,Officer,83221,1,1,0
2022,Officer,83318,1,1,0
2022,Officer,83442,1,1,0
2022,Officer,83501,2,2,0
2022,Officer,83605,1,1,0
2022,Officer,83617,1,1,0
2022,Officer,83647,4,4,0
2022,Officer,83687,2,2,0
2022,Officer,83705,16,15,1
2022,Officer,83854,4,4,0
2022,Officer,84003,3,3,0
2022,Officer,84020,12,9,3
2022,Officer,84043,2,2,0
2022,Officer,84058,5,5,0
2022,Officer,84065,17,16,1
2022,Officer,84084,7,7,0
2022,Officer,84116,3,3,0
2022,Officer,84321,1,1,0
2022,Officer,84404,1,1,0
2022,Officer,84405,3,3,0
2022,Officer,84642,1,1,0
2022,Officer,84660,2,1,1
2022,Officer,84663,1,1,0
2022,Officer,84713,2,2,0
2022,Officer,84721,1,1,0
2022,Officer,84790,3,3,0
2022,Officer,85008,19,15,4
2022,Officer,85020,1,1,0
2022,Officer,85132,6,5,1
2022,Officer,85201,1,1,0
2022,Officer,85222,2,2,0
2022,Officer,85281,1,1,0
2022,Officer,85286,3,1,2
2022,Officer,85301,1,1,0
2022,Officer,85396,1,1,0
2022,Officer,85546,1,1,0
2022,Officer,85706,1,1,0
2022,Officer,85713,2,1,1
2022,Officer,85756,2,1,1
2022,Officer,86001,2,2,0
2022,Officer,86015,4,2,2
2022,Officer,87002,2,2,0
2022,Officer,87123,5,5,0
2022,Officer,87144,2,2,0
2022,Officer,87401,2,2,0
2022,Officer,87502,1,0,1
2022,Officer,87507,1,1,0
2022,Officer,87508,2,2,0
2022,Officer,88001,3,3,0
2022,Officer,88007,5,5,0
2022,Officer,88240,1,1,0
2022,Officer,88310,2,2,0
2022,Officer,89034,1,1,0
2022,Officer,89115,2,2,0
2022,Officer,89139,9,8,1
2022,Officer,89165,5,5,0
2022,Officer,89502,2,1,1
2022,Officer,89506,8,7,1
2022,Officer,89701,5,5,0
2022,Officer,90025,7,7,0
2022,Officer,90201,3,3,0
2022,Officer,90249,1,1,0
2022,Officer,90266,1,1,0
2022,Officer,90302,3,3,0
2022,Officer,90720,18,17,1
2022,Officer,90822,8,7,1
2022,Officer,91205,3,3,0
2022,Officer,91406,4,4,0
2022,Officer,91505,5,5,0
2022,Officer,91702,7,6,1
2022,Officer,91764,3,3,0
2022,Officer,91766,1,1,0
2022,Officer,91950,1,1,0
2022,Officer,92020,2,2,0
2022,Officer,92025,3,3,0
2022,Officer,92111,9,9,0
2022,Officer,92243,1,1,0
2022,Officer,92324,1,1,0
2022,Officer,92410,2,2,0
2022,Officer,92707,1,1,0
2022,Officer,93007,1,1,0
2022,Officer,93291,1,1,0
2022,Officer,93307,2,2,0
2022,Officer,93405,1,1,0
2022,Officer,93451,1,1,0
2022,Officer,93536,2,2,0
2022,Officer,93550,2,2,0
2022,Officer,93727,4,4,0
2022,Officer,94401,1,1,0
2022,Officer,94510,1,1,0
2022,Officer,94519,4,4,0
2022,Officer,94533,3,3,0
2022,Officer,94568,4,4,0
2022,Officer,94590,3,3,0
2022,Officer,94804,4,4,0
2022,Officer,94903,1,1,0
2022,Officer,94952,1,1,0
2022,Officer,95023,1,1,0
2022,Officer,95206,4,4,0
2022,Officer,95351,1,1,0
2022,Officer,95361,2,2,0
2022,Officer,95401,3,3,0
2022,Officer,95823,1,1,0
2022,Officer,95827,3,3,0
2022,Officer,95828,5,5,0
2022,Officer,95832,2,2,0
2022,Officer,95965,1,1,0
2022,Officer,96707,12,10,2
2022,Officer,96720,2,2,0
2022,Officer,96750,1,1,0
2022,Officer,96782,3,3,0
2022,Officer,96789,2,2,0
2022,Officer,96820,1,1,0
2022,Officer,96857,1,1,0
2022,Officer,96911,1,1,0
2022,Officer,96913,9,9,0
2022,Officer,97015,5,5,0
2022,Officer,97030,1,1,0
2022,Officer,97031,1,1,0
2022,Officer,97071,1,1,0
2022,Officer,97116,2,2,0
2022,Officer,97140,1,1,0
2022,Officer,97211,7,7,0
2022,Officer,97218,2,2,0
2022,Officer,97301,12,10,2
2022,Officer,97302,4,4,0
2022,Officer,97321,1,1,0
2022,Officer,97322,1,1,0
2022,Officer,97330,2,2,0
2022,Officer,97338,1,1,0
2022,Officer,97420,1,1,0
2022,Officer,97470,2,2,0
2022,Officer,97477,2,2,0
2022,Officer,97501,1,1,0
2022,Officer,97702,2,1,1
2022,Officer,97754,1,1,0
2022,Officer,97801,1,1,0
2022,Officer,97814,1,1,0
2022,Officer,97914,1,1,0
2022,Officer,98108,1,1,0
2022,Officer,98119,9,5,4
2022,Officer,98215,1,1,0
2022,Officer,98271,1,1,0
2022,Officer,98290,1,1,0
2022,Officer,98321,3,3,0
2022,Officer,98430,10,10,0
2022,Officer,98433,8,8,0
2022,Officer,98501,1,1,0
2022,Officer,98563,2,2,0
2022,Officer,98837,3,3,0
2022,Officer,98901,2,2,0
2022,Officer,98903,1,1,0
2022,Officer,99011,3,2,1
2022,Officer,99217,4,3,1
2022,Officer,99362,1,1,0
2022,Officer,99502,1,1,0
2022,Officer,99505,25,24,1
2022,Officer,99654,1,1,0
2022,Officer,99731,3,3,0
2022,Warrant Officer,     ,1,1,0
2022,Warrant Officer,00693,1,1,0
2022,Warrant Officer,00778,2,2,0
2022,Warrant Officer,00795,1,1,0
2022,Warrant Officer,00802,1,1,0
2022,Warrant Officer,00850,2,2,0
2022,Warrant Officer,00901,1,1,0
2022,Warrant Officer,00907,1,1,0
2022,Warrant Officer,00934,1,1,0
2022,Warrant Officer,01731,1,1,0
2022,Warrant Officer,01760,1,1,0
2022,Warrant Officer,02542,6,6,0
2022,Warrant Officer,02852,2,2,0
2022,Warrant Officer,03101,2,2,0
2022,Warrant Officer,03244,1,1,0
2022,Warrant Officer,03301,2,2,0
2022,Warrant Officer,03801,1,1,0
2022,Warrant Officer,04092,1,1,0
2022,Warrant Officer,04240,1,1,0
2022,Warrant Officer,04330,2,2,0
2022,Warrant Officer,04401,7,7,0
2022,Warrant Officer,05403,1,1,0
2022,Warrant Officer,05446,1,1,0
2022,Warrant Officer,05495,1,1,0
2022,Warrant Officer,06096,5,5,0
2022,Warrant Officer,06105,3,3,0
2022,Warrant Officer,06340,3,3,0
2022,Warrant Officer,06357,3,3,0
2022,Warrant Officer,07052,2,2,0
2022,Warrant Officer,07095,1,1,0
2022,Warrant Officer,08640,1,1,0
2022,Warrant Officer,08648,2,2,0
2022,Warrant Officer,08733,2,2,0
2022,Warrant Officer,10037,2,2,0
2022,Warrant Officer,10566,1,1,0
2022,Warrant Officer,10567,1,1,0
2022,Warrant Officer,11779,5,5,0
2022,Warrant Officer,12110,9,9,0
2022,Warrant Officer,12301,1,1,0
2022,Warrant Officer,13211,3,3,0
2022,Warrant Officer,13502,1,1,0
2022,Warrant Officer,14048,1,1,0
2022,Warrant Officer,14624,4,4,0
2022,Warrant Officer,15216,1,1,0
2022,Warrant Officer,15301,1,1,0
2022,Warrant Officer,15902,5,5,0
2022,Warrant Officer,17003,7,7,0
2022,Warrant Officer,17033,1,1,0
2022,Warrant Officer,17103,3,3,0
2022,Warrant Officer,18102,1,1,0
2022,Warrant Officer,19720,2,2,0
2022,Warrant Officer,19804,1,1,0
2022,Warrant Officer,19939,1,1,0
2022,Warrant Officer,19977,1,1,0
2022,Warrant Officer,20003,7,7,0
2022,Warrant Officer,20623,1,1,0
2022,Warrant Officer,20708,1,1,0
2022,Warrant Officer,20783,1,1,0
2022,Warrant Officer,21010,2,2,0
2022,Warrant Officer,21078,2,2,0
2022,Warrant Officer,21204,1,1,0
2022,Warrant Officer,22032,1,1,0
2022,Warrant Officer,22060,6,6,0
2022,Warrant Officer,23150,8,8,0
2022,Warrant Officer,23237,2,2,0
2022,Warrant Officer,23451,2,2,0
2022,Warrant Officer,23502,2,2,0
2022,Warrant Officer,23805,1,1,0
2022,Warrant Officer,25168,1,1,0
2022,Warrant Officer,25401,1,1,0
2022,Warrant Officer,25550,1,1,0
2022,Warrant Officer,26003,1,1,0
2022,Warrant Officer,26101,1,1,0
2022,Warrant Officer,26301,1,1,0
2022,Warrant Officer,26330,2,2,0
2022,Warrant Officer,27401,4,4,0
2022,Warrant Officer,27560,3,3,0
2022,Warrant Officer,27607,2,2,0
2022,Warrant Officer,27870,2,2,0
2022,Warrant Officer,28001,1,1,0
2022,Warrant Officer,28147,1,1,0
2022,Warrant Officer,28208,6,6,0
2022,Warrant Officer,28328,1,1,0
2022,Warrant Officer,28607,1,1,0
2022,Warrant Officer,28658,1,1,0
2022,Warrant Officer,29044,11,11,0
2022,Warrant Officer,29303,1,1,0
2022,Warrant Officer,29409,2,2,0
2022,Warrant Officer,29418,1,1,0
2022,Warrant Officer,29556,1,1,0
2022,Warrant Officer,29605,2,2,0
2022,Warrant Officer,29625,1,1,0
2022,Warrant Officer,30060,9,9,0
2022,Warrant Officer,30144,1,1,0
2022,Warrant Officer,30297,1,1,0
2022,Warrant Officer,30680,5,5,0
2022,Warrant Officer,31211,3,3,0
2022,Warrant Officer,31313,1,1,0
2022,Warrant Officer,31314,1,1,0
2022,Warrant Officer,31406,2,2,0
2022,Warrant Officer,31409,1,1,0
2022,Warrant Officer,32086,1,1,0
2022,Warrant Officer,32091,7,7,0
2022,Warrant Officer,32221,3,3,0
2022,Warrant Officer,32428,1,1,0
2022,Warrant Officer,32862,1,1,0
2022,Warrant Officer,33127,3,3,0
2022,Warrant Officer,33315,1,1,0
2022,Warrant Officer,33401,1,1,0
2022,Warrant Officer,33711,1,1,0
2022,Warrant Officer,33782,2,2,0
2022,Warrant Officer,34266,1,1,0
2022,Warrant Officer,34604,5,5,0
2022,Warrant Officer,35045,1,1,0
2022,Warrant Officer,35217,2,2,0
2022,Warrant Officer,35565,2,2,0
2022,Warrant Officer,35601,2,2,0
2022,Warrant Officer,36027,1,1,0
2022,Warrant Officer,36043,4,4,0
2022,Warrant Officer,36067,1,1,0
2022,Warrant Officer,36109,4,4,0
2022,Warrant Officer,36205,2,2,0
2022,Warrant Officer,36250,1,1,0
2022,Warrant Officer,36608,1,1,0
2022,Warrant Officer,36701,1,1,0
2022,Warrant Officer,36832,1,1,0
2022,Warrant Officer,37033,1,1,0
2022,Warrant Officer,37167,1,1,0
2022,Warrant Officer,37204,2,2,0
2022,Warrant Officer,37217,3,3,0
2022,Warrant Officer,37306,1,1,0
2022,Warrant Officer,37388,1,1,0
2022,Warrant Officer,37643,1,1,0
2022,Warrant Officer,37777,4,4,0
2022,Warrant Officer,37919,1,1,0
2022,Warrant Officer,38301,3,3,0
2022,Warrant Officer,38382,1,1,0
2022,Warrant Officer,38801,7,7,0
2022,Warrant Officer,38901,4,4,0
2022,Warrant Officer,38930,1,1,0
2022,Warrant Officer,39183,2,2,0
2022,Warrant Officer,39202,1,1,0
2022,Warrant Officer,39204,4,4,0
2022,Warrant Officer,39209,8,8,0
2022,Warrant Officer,39216,1,1,0
2022,Warrant Officer,39350,1,1,0
2022,Warrant Officer,39401,3,3,0
2022,Warrant Officer,39407,1,1,0
2022,Warrant Officer,39507,1,1,0
2022,Warrant Officer,39654,4,4,0
2022,Warrant Officer,39730,1,1,0
2022,Warrant Officer,39759,3,3,0
2022,Warrant Officer,40205,2,2,0
2022,Warrant Officer,40330,1,1,0
2022,Warrant Officer,40475,1,1,0
2022,Warrant Officer,40510,2,2,0
2022,Warrant Officer,40601,8,8,0
2022,Warrant Officer,41101,1,1,0
2022,Warrant Officer,42101,2,2,0
2022,Warrant Officer,42330,1,1,0
2022,Warrant Officer,43213,5,5,0
2022,Warrant Officer,43217,2,2,0
2022,Warrant Officer,43235,3,3,0
2022,Warrant Officer,43756,1,1,0
2022,Warrant Officer,44142,1,1,0
2022,Warrant Officer,44720,8,8,0
2022,Warrant Officer,45356,1,1,0
2022,Warrant Officer,46124,1,1,0
2022,Warrant Officer,46131,1,1,0
2022,Warrant Officer,46176,1,1,0
2022,Warrant Officer,46241,5,5,0
2022,Warrant Officer,46402,1,1,0
2022,Warrant Officer,46406,2,2,0
2022,Warrant Officer,46613,1,1,0
2022,Warrant Officer,46901,2,2,0
2022,Warrant Officer,47374,1,1,0
2022,Warrant Officer,47715,1,1,0
2022,Warrant Officer,48045,4,4,0
2022,Warrant Officer,48180,1,1,0
2022,Warrant Officer,48208,1,1,0
2022,Warrant Officer,48837,3,3,0
2022,Warrant Officer,48906,2,2,0
2022,Warrant Officer,49012,1,1,0
2022,Warrant Officer,49201,1,1,0
2022,Warrant Officer,49739,2,2,0
2022,Warrant Officer,50036,3,3,0
2022,Warrant Officer,50131,3,3,0
2022,Warrant Officer,50709,2,2,0
2022,Warrant Officer,52556,1,1,0
2022,Warrant Officer,52806,6,6,0
2022,Warrant Officer,53212,1,1,0
2022,Warrant Officer,53704,1,1,0
2022,Warrant Officer,54618,1,1,0
2022,Warrant Officer,55008,1,1,0
2022,Warrant Officer,55066,1,1,0
2022,Warrant Officer,55068,3,3,0
2022,Warrant Officer,55077,2,2,0
2022,Warrant Officer,55101,5,5,0
2022,Warrant Officer,55107,4,4,0
2022,Warrant Officer,55112,6,6,0
2022,Warrant Officer,55303,2,2,0
2022,Warrant Officer,55443,1,1,0
2022,Warrant Officer,55912,1,1,0
2022,Warrant Officer,56201,1,1,0
2022,Warrant Officer,56301,3,3,0
2022,Warrant Officer,56303,2,2,0
2022,Warrant Officer,56345,3,3,0
2022,Warrant Officer,57104,1,1,0
2022,Warrant Officer,57301,1,1,0
2022,Warrant Officer,57350,1,1,0
2022,Warrant Officer,57366,1,1,0
2022,Warrant Officer,57702,3,3,0
2022,Warrant Officer,57703,3,3,0
2022,Warrant Officer,58102,2,2,0
2022,Warrant Officer,58501,2,2,0
2022,Warrant Officer,59602,4,4,0
2022,Warrant Officer,59636,1,1,0
2022,Warrant Officer,59760,1,1,0
2022,Warrant Officer,59901,1,1,0
2022,Warrant Officer,60901,1,1,0
2022,Warrant Officer,61264,2,2,0
2022,Warrant Officer,61607,1,1,0
2022,Warrant Officer,61701,1,1,0
2022,Warrant Officer,61801,2,2,0
2022,Warrant Officer,61820,2,2,0
2022,Warrant Officer,62702,1,1,0
2022,Warrant Officer,63044,1,1,0
2022,Warrant Officer,63125,2,2,0
2022,Warrant Officer,63701,1,1,0
2022,Warrant Officer,64093,1,1,0
2022,Warrant Officer,64129,1,1,0
2022,Warrant Officer,64506,2,2,0
2022,Warrant Officer,65101,5,5,0
2022,Warrant Officer,65109,1,1,0
2022,Warrant Officer,65265,1,1,0
2022,Warrant Officer,65305,3,3,0
2022,Warrant Officer,65340,1,1,0
2022,Warrant Officer,65473,5,5,0
2022,Warrant Officer,65605,1,1,0
2022,Warrant Officer,65803,3,3,0
2022,Warrant Officer,66027,1,1,0
2022,Warrant Officer,66502,1,1,0
2022,Warrant Officer,66619,4,4,0
2022,Warrant Officer,66901,1,1,0
2022,Warrant Officer,67401,1,1,0
2022,Warrant Officer,67501,1,1,0
2022,Warrant Officer,68508,2,2,0
2022,Warrant Officer,68524,7,7,0
2022,Warrant Officer,68901,1,1,0
2022,Warrant Officer,69101,1,1,0
2022,Warrant Officer,70117,1,1,0
2022,Warrant Officer,70401,8,8,0
2022,Warrant Officer,70410,2,2,0
2022,Warrant Officer,70508,2,2,0
2022,Warrant Officer,70544,1,1,0
2022,Warrant Officer,70721,1,1,0
2022,Warrant Officer,70802,1,1,0
2022,Warrant Officer,70820,1,1,0
2022,Warrant Officer,71360,2,2,0
2022,Warrant Officer,71602,1,1,0
2022,Warrant Officer,71671,1,1,0
2022,Warrant Officer,72199,10,10,0
2022,Warrant Officer,72401,1,1,0
2022,Warrant Officer,72543,1,1,0
2022,Warrant Officer,72712,1,1,0
2022,Warrant Officer,72744,1,1,0
2022,Warrant Officer,72756,1,1,0
2022,Warrant Officer,72802,1,1,0
2022,Warrant Officer,73051,1,1,0
2022,Warrant Officer,73064,2,2,0
2022,Warrant Officer,73069,4,4,0
2022,Warrant Officer,73111,3,3,0
2022,Warrant Officer,73501,1,1,0
2022,Warrant Officer,73503,1,1,0
2022,Warrant Officer,73521,1,1,0
2022,Warrant Officer,74107,1,1,0
2022,Warrant Officer,74112,1,1,0
2022,Warrant Officer,74116,2,2,0
2022,Warrant Officer,75709,1,1,0
2022,Warrant Officer,77034,4,4,0
2022,Warrant Officer,77082,3,3,0
2022,Warrant Officer,78218,4,4,0
2022,Warrant Officer,78602,1,1,0
2022,Warrant Officer,78617,6,6,0
2022,Warrant Officer,78665,3,3,0
2022,Warrant Officer,78703,9,9,0
2022,Warrant Officer,78731,1,1,0
2022,Warrant Officer,80011,4,4,0
2022,Warrant Officer,82005,4,4,0
2022,Warrant Officer,82070,1,1,0
2022,Warrant Officer,82801,1,1,0
2022,Warrant Officer,83202,1,1,0
2022,Warrant Officer,83301,1,1,0
2022,Warrant Officer,83647,1,1,0
2022,Warrant Officer,83705,7,7,0
2022,Warrant Officer,84003,3,3,0
2022,Warrant Officer,84020,5,5,0
2022,Warrant Officer,84058,1,1,0
2022,Warrant Officer,84065,8,8,0
2022,Warrant Officer,84084,6,6,0
2022,Warrant Officer,84660,1,1,0
2022,Warrant Officer,84663,1,1,0
2022,Warrant Officer,85008,10,10,0
2022,Warrant Officer,85145,1,1,0
2022,Warrant Officer,85653,1,1,0
2022,Warrant Officer,87123,2,2,0
2022,Warrant Officer,87507,3,3,0
2022,Warrant Officer,88001,2,2,0
2022,Warrant Officer,88007,1,1,0
2022,Warrant Officer,89034,1,1,0
2022,Warrant Officer,89139,1,1,0
2022,Warrant Officer,89165,1,1,0
2022,Warrant Officer,89506,1,1,0
2022,Warrant Officer,90025,1,1,0
2022,Warrant Officer,90501,1,1,0
2022,Warrant Officer,90720,11,11,0
2022,Warrant Officer,90822,2,2,0
2022,Warrant Officer,92111,1,1,0
2022,Warrant Officer,92518,1,1,0
2022,Warrant Officer,92707,1,1,0
2022,Warrant Officer,93727,1,1,0
2022,Warrant Officer,94132,1,1,0
2022,Warrant Officer,94565,1,1,0
2022,Warrant Officer,94903,2,2,0
2022,Warrant Officer,95206,4,4,0
2022,Warrant Officer,95827,1,1,0
2022,Warrant Officer,96707,4,4,0
2022,Warrant Officer,96782,1,1,0
2022,Warrant Officer,96857,5,5,0
2022,Warrant Officer,96913,1,1,0
2022,Warrant Officer,97301,1,1,0
2022,Warrant Officer,97302,5,5,0
2022,Warrant Officer,97801,1,1,0
2022,Warrant Officer,98108,1,1,0
2022,Warrant Officer,98119,1,1,0
2022,Warrant Officer,98321,2,2,0
2022,Warrant Officer,98430,7,7,0
2022,Warrant Officer,98433,12,12,0
2022,Warrant Officer,98930,1,1,0
2022,Warrant Officer,99011,1,1,0
2022,Warrant Officer,99505,5,5,0
2022,Warrant Officer,99731,1,1,0
2023,Enlisted,     ,52,43,9
2023,Enlisted,00000,7,0,7
2023,Enlisted,00604,14,3,11
2023,Enlisted,00612,7,1,6
2023,Enlisted,00623,5,0,5
2023,Enlisted,00624,24,1,23
2023,Enlisted,00641,5,1,4
2023,Enlisted,00682,37,7,30
2023,Enlisted,00693,4,1,3
2023,Enlisted,00705,11,6,5
2023,Enlisted,00714,18,1,17
2023,Enlisted,00725,3,1,2
2023,Enlisted,00733,2,2,0
2023,Enlisted,00735,9,0,9
2023,Enlisted,00736,30,6,24
2023,Enlisted,00751,3,2,1
2023,Enlisted,00769,11,3,8
2023,Enlisted,00778,22,5,17
2023,Enlisted,00785,9,1,8
2023,Enlisted,00792,12,0,12
2023,Enlisted,00795,52,2,50
2023,Enlisted,00802,16,1,15
2023,Enlisted,00820,1,0,1
2023,Enlisted,00850,7,0,7
2023,Enlisted,00901,1,0,1
2023,Enlisted,00907,8,1,7
2023,Enlisted,00934,194,5,189
2023,Enlisted,00951,13,0,13
2023,Enlisted,01013,15,11,4
2023,Enlisted,01022,2,0,2
2023,Enlisted,01030,16,6,10
2023,Enlisted,01062,3,0,3
2023,Enlisted,01085,28,6,22
2023,Enlisted,01109,13,0,13
2023,Enlisted,01434,34,10,24
2023,Enlisted,01440,6,4,2
2023,Enlisted,01453,1,0,1
2023,Enlisted,01588,7,3,4
2023,Enlisted,01605,23,3,20
2023,Enlisted,01702,14,3,11
2023,Enlisted,01731,45,3,42
2023,Enlisted,01760,12,3,9
2023,Enlisted,01844,6,0,6
2023,Enlisted,01867,40,6,34
2023,Enlisted,01923,4,0,4
2023,Enlisted,01950,5,0,5
2023,Enlisted,02043,10,3,7
2023,Enlisted,02122,12,1,11
2023,Enlisted,02138,16,4,12
2023,Enlisted,02169,24,4,20
2023,Enlisted,02173,1,0,1
2023,Enlisted,02176,11,4,7
2023,Enlisted,02184,13,5,8
2023,Enlisted,02301,5,1,4
2023,Enlisted,02324,2,0,2
2023,Enlisted,02346,9,2,7
2023,Enlisted,02420,5,2,3
2023,Enlisted,02532,16,3,13
2023,Enlisted,02542,41,7,34
2023,Enlisted,02724,11,2,9
2023,Enlisted,02769,5,0,5
2023,Enlisted,02780,18,1,17
2023,Enlisted,02809,2,0,2
2023,Enlisted,02816,1,1,0
2023,Enlisted,02818,65,9,56
2023,Enlisted,02842,8,4,4
2023,Enlisted,02852,20,3,17
2023,Enlisted,02886,7,2,5
2023,Enlisted,02896,1,0,1
2023,Enlisted,02904,9,0,9
2023,Enlisted,02906,2,1,1
2023,Enlisted,02920,3,1,2
2023,Enlisted,03055,15,4,11
2023,Enlisted,03060,8,3,5
2023,Enlisted,03101,19,3,16
2023,Enlisted,03235,1,0,1
2023,Enlisted,03244,7,2,5
2023,Enlisted,03264,2,1,1
2023,Enlisted,03275,24,4,20
2023,Enlisted,03301,19,6,13
2023,Enlisted,03561,3,0,3
2023,Enlisted,03766,4,1,3
2023,Enlisted,03801,2,0,2
2023,Enlisted,03867,12,2,10
2023,Enlisted,04011,10,2,8
2023,Enlisted,04073,7,0,7
2023,Enlisted,04092,1,1,0
2023,Enlisted,04240,7,2,5
2023,Enlisted,04268,4,1,3
2023,Enlisted,04330,15,2,13
2023,Enlisted,04401,22,6,16
2023,Enlisted,04412,16,4,12
2023,Enlisted,04736,1,1,0
2023,Enlisted,04769,4,3,1
2023,Enlisted,04901,21,4,17
2023,Enlisted,04976,3,0,3
2023,Enlisted,05001,4,0,4
2023,Enlisted,05033,19,3,16
2023,Enlisted,05158,2,0,2
2023,Enlisted,05201,3,0,3
2023,Enlisted,05403,8,1,7
2023,Enlisted,05404,13,1,12
2023,Enlisted,05446,74,64,10
2023,Enlisted,05465,17,8,9
2023,Enlisted,05478,3,2,1
2023,Enlisted,05491,16,0,16
2023,Enlisted,05495,4,2,2
2023,Enlisted,05633,3,0,3
2023,Enlisted,05661,2,0,2
2023,Enlisted,05663,2,1,1
2023,Enlisted,05701,3,2,1
2023,Enlisted,05851,3,0,3
2023,Enlisted,05855,3,1,2
2023,Enlisted,06051,35,8,27
2023,Enlisted,06066,1,1,0
2023,Enlisted,06082,23,4,19
2023,Enlisted,06096,22,3,19
2023,Enlisted,06105,10,6,4
2023,Enlisted,06110,14,3,11
2023,Enlisted,06320,30,7,23
2023,Enlisted,06333,2,0,2
2023,Enlisted,06340,22,10,12
2023,Enlisted,06357,9,1,8
2023,Enlisted,06360,11,1,10
2023,Enlisted,06457,45,16,29
2023,Enlisted,06489,7,1,6
2023,Enlisted,06497,10,3,7
2023,Enlisted,06498,15,2,13
2023,Enlisted,06512,11,4,7
2023,Enlisted,06702,9,2,7
2023,Enlisted,06810,23,8,15
2023,Enlisted,07052,56,8,48
2023,Enlisted,07090,15,2,13
2023,Enlisted,07095,21,6,15
2023,Enlisted,07107,16,6,10
2023,Enlisted,07306,42,6,36
2023,Enlisted,07457,18,2,16
2023,Enlisted,07666,41,10,31
2023,Enlisted,07728,26,5,21
2023,Enlisted,07806,31,3,28
2023,Enlisted,07840,8,1,7
2023,Enlisted,07865,20,2,18
2023,Enlisted,07871,17,2,15
2023,Enlisted,07960,35,6,29
2023,Enlisted,08002,13,2,11
2023,Enlisted,08012,13,4,9
2023,Enlisted,08037,8,2,6
2023,Enlisted,08060,12,2,10
2023,Enlisted,08063,4,0,4
2023,Enlisted,08096,25,3,22
2023,Enlisted,08098,8,2,6
2023,Enlisted,08210,26,2,24
2023,Enlisted,08360,12,1,11
2023,Enlisted,08401,3,1,2
2023,Enlisted,08640,4,4,0
2023,Enlisted,08648,7,1,6
2023,Enlisted,08733,36,3,33
2023,Enlisted,08750,124,2,122
2023,Enlisted,08755,12,1,11
2023,Enlisted,08759,6,0,6
2023,Enlisted,08822,5,1,4
2023,Enlisted,08873,58,3,55
2023,Enlisted,10010,77,19,58
2023,Enlisted,10037,81,13,68
2023,Enlisted,10314,59,8,51
2023,Enlisted,10468,11,0,11
2023,Enlisted,10566,20,0,20
2023,Enlisted,10567,73,13,60
2023,Enlisted,10701,36,2,34
2023,Enlisted,10962,43,6,37
2023,Enlisted,11209,52,3,49
2023,Enlisted,11252,31,4,27
2023,Enlisted,11357,31,3,28
2023,Enlisted,11433,9,0,9
2023,Enlisted,11735,44,4,40
2023,Enlisted,11746,18,5,13
2023,Enlisted,11753,29,3,26
2023,Enlisted,11779,29,3,26
2023,Enlisted,12078,16,3,13
2023,Enlisted,12110,219,12,207
2023,Enlisted,12180,22,5,17
2023,Enlisted,12189,10,2,8
2023,Enlisted,12301,37,4,33
2023,Enlisted,12401,5,1,4
2023,Enlisted,12451,3,0,3
2023,Enlisted,12553,39,3,36
2023,Enlisted,12804,25,1,24
2023,Enlisted,12962,3,0,3
2023,Enlisted,13021,9,0,9
2023,Enlisted,13211,35,6,29
2023,Enlisted,13501,33,11,22
2023,Enlisted,13502,8,4,4
2023,Enlisted,13643,4,2,2
2023,Enlisted,13856,4,1,3
2023,Enlisted,13905,12,1,11
2023,Enlisted,14048,2,0,2
2023,Enlisted,14094,7,0,7
2023,Enlisted,14204,51,11,40
2023,Enlisted,14213,26,1,25
2023,Enlisted,14304,3,0,3
2023,Enlisted,14454,10,5,5
2023,Enlisted,14456,10,4,6
2023,Enlisted,14624,51,10,41
2023,Enlisted,14701,7,2,5
2023,Enlisted,14760,6,0,6
2023,Enlisted,14843,7,1,6
2023,Enlisted,14845,4,2,2
2023,Enlisted,14850,14,6,8
2023,Enlisted,15010,13,0,13
2023,Enlisted,15216,25,2,23
2023,Enlisted,15301,10,1,9
2023,Enlisted,15370,4,2,2
2023,Enlisted,15425,10,2,8
2023,Enlisted,15444,13,0,13
2023,Enlisted,15537,15,5,10
2023,Enlisted,15541,8,0,8
2023,Enlisted,15601,4,2,2
2023,Enlisted,15666,13,3,10
2023,Enlisted,15701,22,3,19
2023,Enlisted,15767,14,4,10
2023,Enlisted,15779,2,0,2
2023,Enlisted,15902,20,5,15
2023,Enlisted,15904,24,3,21
2023,Enlisted,16001,24,4,20
2023,Enlisted,16101,13,2,11
2023,Enlisted,16127,7,0,7
2023,Enlisted,16148,4,1,3
2023,Enlisted,16226,7,0,7
2023,Enlisted,16403,46,9,37
2023,Enlisted,16635,10,5,5
2023,Enlisted,16652,9,5,4
2023,Enlisted,16738,6,1,5
2023,Enlisted,16803,8,2,6
2023,Enlisted,16830,10,0,10
2023,Enlisted,16901,6,0,6
2023,Enlisted,17003,228,27,201
2023,Enlisted,17013,20,3,17
2023,Enlisted,17022,30,2,28
2023,Enlisted,17033,5,0,5
2023,Enlisted,17042,15,1,14
2023,Enlisted,17044,18,5,13
2023,Enlisted,17098,2,1,1
2023,Enlisted,17103,35,5,30
2023,Enlisted,17201,6,1,5
2023,Enlisted,17222,4,0,4
2023,Enlisted,17325,11,1,10
2023,Enlisted,17331,9,1,8
2023,Enlisted,17408,23,7,16
2023,Enlisted,17701,12,2,10
2023,Enlisted,17745,5,1,4
2023,Enlisted,17821,5,0,5
2023,Enlisted,17837,9,3,6
2023,Enlisted,18040,15,2,13
2023,Enlisted,18102,17,4,13
2023,Enlisted,18201,5,0,5
2023,Enlisted,18235,7,2,5
2023,Enlisted,18252,4,1,3
2023,Enlisted,18407,2,0,2
2023,Enlisted,18431,4,1,3
2023,Enlisted,18509,24,4,20
2023,Enlisted,18634,4,1,3
2023,Enlisted,18651,7,1,6
2023,Enlisted,18704,22,2,20
2023,Enlisted,18834,1,0,1
2023,Enlisted,18960,16,1,15
2023,Enlisted,19044,26,6,20
2023,Enlisted,19103,8,3,5
2023,Enlisted,19104,9,0,9
2023,Enlisted,19153,30,4,26
2023,Enlisted,19154,119,17,102
2023,Enlisted,19320,15,5,10
2023,Enlisted,19460,19,0,19
2023,Enlisted,19462,25,1,24
2023,Enlisted,19475,13,2,11
2023,Enlisted,19526,5,3,2
2023,Enlisted,19530,20,4,16
2023,Enlisted,19605,12,1,11
2023,Enlisted,19706,29,2,27
2023,Enlisted,19711,8,0,8
2023,Enlisted,19720,23,5,18
2023,Enlisted,19804,8,2,6
2023,Enlisted,19808,9,1,8
2023,Enlisted,19939,17,3,14
2023,Enlisted,19947,2,0,2
2023,Enlisted,19973,15,1,14
2023,Enlisted,19977,6,0,6
2023,Enlisted,20003,36,14,22
2023,Enlisted,20112,17,1,16
2023,Enlisted,20175,18,4,14
2023,Enlisted,20186,14,5,9
2023,Enlisted,20373,21,3,18
2023,Enlisted,20623,15,1,14
2023,Enlisted,20653,6,1,5
2023,Enlisted,20708,28,11,17
2023,Enlisted,20882,6,1,5
2023,Enlisted,20904,13,5,8
2023,Enlisted,21010,31,6,25
2023,Enlisted,21057,11,6,5
2023,Enlisted,21061,15,3,12
2023,Enlisted,21078,12,1,11
2023,Enlisted,21136,27,2,25
2023,Enlisted,21157,7,2,5
2023,Enlisted,21201,1,1,0
2023,Enlisted,21204,10,4,6
2023,Enlisted,21216,16,2,14
2023,Enlisted,21222,40,12,28
2023,Enlisted,21228,16,2,14
2023,Enlisted,21236,2,0,2
2023,Enlisted,21401,11,4,7
2023,Enlisted,21601,5,2,3
2023,Enlisted,21701,7,3,4
2023,Enlisted,21740,2,0,2
2023,Enlisted,21784,19,0,19
2023,Enlisted,21801,10,3,7
2023,Enlisted,22032,6,4,2
2023,Enlisted,22060,39,21,18
2023,Enlisted,22401,47,9,38
2023,Enlisted,22427,10,1,9
2023,Enlisted,22601,9,1,8
2023,Enlisted,22602,14,5,9
2023,Enlisted,22664,5,0,5
2023,Enlisted,22801,5,0,5
2023,Enlisted,22902,16,6,10
2023,Enlisted,23139,16,0,16
2023,Enlisted,23150,27,9,18
2023,Enlisted,23181,11,0,11
2023,Enlisted,23237,47,1,46
2023,Enlisted,23417,2,1,1
2023,Enlisted,23434,3,1,2
2023,Enlisted,23451,69,14,55
2023,Enlisted,23502,43,9,34
2023,Enlisted,23609,19,4,15
2023,Enlisted,23666,17,2,15
2023,Enlisted,23701,12,3,9
2023,Enlisted,23805,8,0,8
2023,Enlisted,23824,26,5,21
2023,Enlisted,23847,13,0,13
2023,Enlisted,23901,3,0,3
2023,Enlisted,24073,12,2,10
2023,Enlisted,24151,4,0,4
2023,Enlisted,24175,7,2,5
2023,Enlisted,24212,4,0,4
2023,Enlisted,24251,22,3,19
2023,Enlisted,24301,17,6,11
2023,Enlisted,24401,7,5,2
2023,Enlisted,24450,7,5,2
2023,Enlisted,24502,32,10,22
2023,Enlisted,24523,9,2,7
2023,Enlisted,24540,9,0,9
2023,Enlisted,24592,4,0,4
2023,Enlisted,24609,5,1,4
2023,Enlisted,24701,9,1,8
2023,Enlisted,24957,9,2,7
2023,Enlisted,25168,37,5,32
2023,Enlisted,25262,11,1,10
2023,Enlisted,25309,6,1,5
2023,Enlisted,25311,3,2,1
2023,Enlisted,25401,17,3,14
2023,Enlisted,25405,42,1,41
2023,Enlisted,25530,21,5,16
2023,Enlisted,25550,3,1,2
2023,Enlisted,25625,16,4,12
2023,Enlisted,25846,32,6,26
2023,Enlisted,26003,18,2,16
2023,Enlisted,26041,10,1,9
2023,Enlisted,26101,10,1,9
2023,Enlisted,26187,10,1,9
2023,Enlisted,26201,17,1,16
2023,Enlisted,26250,9,2,7
2023,Enlisted,26301,17,1,16
2023,Enlisted,26505,9,0,9
2023,Enlisted,26508,3,0,3
2023,Enlisted,26537,30,9,21
2023,Enlisted,26554,6,0,6
2023,Enlisted,26624,5,0,5
2023,Enlisted,26651,21,2,19
2023,Enlisted,27028,9,2,7
2023,Enlisted,27030,2,0,2
2023,Enlisted,27103,30,5,25
2023,Enlisted,27203,2,1,1
2023,Enlisted,27217,21,7,14
2023,Enlisted,27260,28,10,18
2023,Enlisted,27292,6,0,6
2023,Enlisted,27320,1,0,1
2023,Enlisted,27330,5,1,4
2023,Enlisted,27344,10,0,10
2023,Enlisted,27360,1,1,0
2023,Enlisted,27401,15,3,12
2023,Enlisted,27504,17,7,10
2023,Enlisted,27509,7,1,6
2023,Enlisted,27530,11,2,9
2023,Enlisted,27549,6,4,2
2023,Enlisted,27560,65,17,48
2023,Enlisted,27573,1,0,1
2023,Enlisted,27577,7,4,3
2023,Enlisted,27596,9,2,7
2023,Enlisted,27607,65,2,63
2023,Enlisted,27704,16,3,13
2023,Enlisted,27830,4,0,4
2023,Enlisted,27856,6,0,6
2023,Enlisted,27870,7,5,2
2023,Enlisted,27889,2,2,0
2023,Enlisted,28001,14,9,5
2023,Enlisted,28012,4,1,3
2023,Enlisted,28027,21,6,15
2023,Enlisted,28043,5,2,3
2023,Enlisted,28054,17,2,15
2023,Enlisted,28086,10,1,9
2023,Enlisted,28092,20,4,16
2023,Enlisted,28110,7,3,4
2023,Enlisted,28115,5,3,2
2023,Enlisted,28147,9,6,3
2023,Enlisted,28170,12,5,7
2023,Enlisted,28208,35,10,25
2023,Enlisted,28306,36,11,25
2023,Enlisted,28310,18,8,10
2023,Enlisted,28328,6,2,4
2023,Enlisted,28334,14,7,7
2023,Enlisted,28337,2,1,1
2023,Enlisted,28345,30,8,22
2023,Enlisted,28352,6,1,5
2023,Enlisted,28358,8,3,5
2023,Enlisted,28371,2,1,1
2023,Enlisted,28376,20,9,11
2023,Enlisted,28377,9,4,5
2023,Enlisted,28379,2,0,2
2023,Enlisted,28387,5,2,3
2023,Enlisted,28401,2,2,0
2023,Enlisted,28405,10,1,9
2023,Enlisted,28459,3,2,1
2023,Enlisted,28472,3,1,2
2023,Enlisted,28504,9,2,7
2023,Enlisted,28518,3,0,3
2023,Enlisted,28540,10,5,5
2023,Enlisted,28560,11,1,10
2023,Enlisted,28590,8,1,7
2023,Enlisted,28601,8,1,7
2023,Enlisted,28607,1,0,1
2023,Enlisted,28621,1,1,0
2023,Enlisted,28640,1,0,1
2023,Enlisted,28645,13,4,9
2023,Enlisted,28655,3,1,2
2023,Enlisted,28659,4,1,3
2023,Enlisted,28677,5,0,5
2023,Enlisted,28681,5,0,5
2023,Enlisted,28726,8,0,8
2023,Enlisted,28734,1,0,1
2023,Enlisted,28779,5,1,4
2023,Enlisted,28806,10,3,7
2023,Enlisted,29006,17,0,17
2023,Enlisted,29020,12,2,10
2023,Enlisted,29044,71,15,56
2023,Enlisted,29102,11,1,10
2023,Enlisted,29108,8,2,6
2023,Enlisted,29115,7,1,6
2023,Enlisted,29138,14,2,12
2023,Enlisted,29153,8,2,6
2023,Enlisted,29161,13,1,12
2023,Enlisted,29170,18,1,17
2023,Enlisted,29172,1,0,1
2023,Enlisted,29201,166,8,158
2023,Enlisted,29303,17,2,15
2023,Enlisted,29325,18,3,15
2023,Enlisted,29341,1,0,1
2023,Enlisted,29360,12,4,8
2023,Enlisted,29379,13,5,8
2023,Enlisted,29385,9,1,8
2023,Enlisted,29409,13,4,9
2023,Enlisted,29418,15,4,11
2023,Enlisted,29440,4,1,3
2023,Enlisted,29461,6,4,2
2023,Enlisted,29464,15,6,9
2023,Enlisted,29488,20,2,18
2023,Enlisted,29506,4,0,4
2023,Enlisted,29510,13,3,10
2023,Enlisted,29512,12,3,9
2023,Enlisted,29527,1,0,1
2023,Enlisted,29532,5,1,4
2023,Enlisted,29536,3,2,1
2023,Enlisted,29550,21,2,19
2023,Enlisted,29554,8,2,6
2023,Enlisted,29556,8,0,8
2023,Enlisted,29571,3,0,3
2023,Enlisted,29574,10,3,7
2023,Enlisted,29577,4,0,4
2023,Enlisted,29605,35,4,31
2023,Enlisted,29620,8,0,8
2023,Enlisted,29625,25,4,21
2023,Enlisted,29631,3,0,3
2023,Enlisted,29640,2,0,2
2023,Enlisted,29644,12,5,7
2023,Enlisted,29646,8,0,8
2023,Enlisted,29651,2,0,2
2023,Enlisted,29653,7,1,6
2023,Enlisted,29678,4,0,4
2023,Enlisted,29706,8,0,8
2023,Enlisted,29715,16,4,12
2023,Enlisted,29720,11,4,7
2023,Enlisted,29732,13,3,10
2023,Enlisted,29810,5,1,4
2023,Enlisted,29812,5,2,3
2023,Enlisted,29824,11,2,9
2023,Enlisted,29829,8,0,8
2023,Enlisted,29845,4,0,4
2023,Enlisted,29906,2,0,2
2023,Enlisted,29944,3,0,3
2023,Enlisted,30014,12,3,9
2023,Enlisted,30032,2,1,1
2023,Enlisted,30040,39,6,33
2023,Enlisted,30043,3,0,3
2023,Enlisted,30046,30,2,28
2023,Enlisted,30060,306,144,162
2023,Enlisted,30069,49,7,42
2023,Enlisted,30114,13,2,11
2023,Enlisted,30125,13,2,11
2023,Enlisted,30134,9,1,8
2023,Enlisted,30144,17,3,14
2023,Enlisted,30161,29,2,27
2023,Enlisted,30224,9,7,2
2023,Enlisted,30233,4,1,3
2023,Enlisted,30240,18,2,16
2023,Enlisted,30263,7,6,1
2023,Enlisted,30294,38,4,34
2023,Enlisted,30297,26,8,18
2023,Enlisted,30336,82,10,72
2023,Enlisted,30401,10,1,9
2023,Enlisted,30427,7,2,5
2023,Enlisted,30439,13,5,8
2023,Enlisted,30458,9,1,8
2023,Enlisted,30461,11,1,10
2023,Enlisted,30501,13,4,9
2023,Enlisted,30577,9,0,9
2023,Enlisted,30597,8,0,8
2023,Enlisted,30635,6,0,6
2023,Enlisted,30643,5,0,5
2023,Enlisted,30655,16,2,14
2023,Enlisted,30673,7,1,6
2023,Enlisted,30680,34,8,26
2023,Enlisted,30701,18,1,17
2023,Enlisted,30720,13,3,10
2023,Enlisted,30824,2,0,2
2023,Enlisted,30830,1,0,1
2023,Enlisted,30904,33,2,31
2023,Enlisted,30905,21,4,17
2023,Enlisted,31015,8,4,4
2023,Enlisted,31029,17,3,14
2023,Enlisted,31040,9,0,9
2023,Enlisted,31061,34,8,26
2023,Enlisted,31211,25,8,17
2023,Enlisted,31313,28,8,20
2023,Enlisted,31314,40,8,32
2023,Enlisted,31329,4,1,3
2023,Enlisted,31406,29,12,17
2023,Enlisted,31409,15,7,8
2023,Enlisted,31520,8,2,6
2023,Enlisted,31533,6,1,5
2023,Enlisted,31601,5,3,2
2023,Enlisted,31704,4,0,4
2023,Enlisted,31792,20,2,18
2023,Enlisted,31794,4,0,4
2023,Enlisted,31901,25,3,22
2023,Enlisted,31905,18,3,15
2023,Enlisted,32055,11,2,9
2023,Enlisted,32064,7,4,3
2023,Enlisted,32084,5,1,4
2023,Enlisted,32086,82,6,76
2023,Enlisted,32091,79,39,40
2023,Enlisted,32164,20,4,16
2023,Enlisted,32177,2,2,0
2023,Enlisted,32221,61,21,40
2023,Enlisted,32311,22,8,14
2023,Enlisted,32351,20,3,17
2023,Enlisted,32405,11,1,10
2023,Enlisted,32425,2,0,2
2023,Enlisted,32428,7,1,6
2023,Enlisted,32446,11,2,9
2023,Enlisted,32514,22,8,14
2023,Enlisted,32539,8,3,5
2023,Enlisted,32609,1,1,0
2023,Enlisted,32724,9,2,7
2023,Enlisted,32726,3,1,2
2023,Enlisted,32771,29,17,12
2023,Enlisted,32806,27,9,18
2023,Enlisted,32862,16,7,9
2023,Enlisted,32922,13,5,8
2023,Enlisted,32935,10,2,8
2023,Enlisted,33027,96,21,75
2023,Enlisted,33039,5,1,4
2023,Enlisted,33127,10,1,9
2023,Enlisted,33315,22,8,14
2023,Enlisted,33401,17,9,8
2023,Enlisted,33405,21,4,17
2023,Enlisted,33406,16,0,16
2023,Enlisted,33523,8,4,4
2023,Enlisted,33563,15,1,14
2023,Enlisted,33606,1,0,1
2023,Enlisted,33609,8,2,6
2023,Enlisted,33627,1,1,0
2023,Enlisted,33711,7,2,5
2023,Enlisted,33782,86,25,61
2023,Enlisted,33811,14,6,8
2023,Enlisted,33825,5,1,4
2023,Enlisted,33830,11,1,10
2023,Enlisted,33844,7,1,6
2023,Enlisted,33859,14,2,12
2023,Enlisted,33873,4,4,0
2023,Enlisted,33880,11,4,7
2023,Enlisted,33916,6,4,2
2023,Enlisted,34208,9,0,9
2023,Enlisted,34221,6,2,4
2023,Enlisted,34237,5,2,3
2023,Enlisted,34266,11,1,10
2023,Enlisted,34429,15,4,11
2023,Enlisted,34474,28,8,20
2023,Enlisted,34604,11,5,6
2023,Enlisted,34748,17,7,10
2023,Enlisted,34947,22,12,10
2023,Enlisted,35010,21,0,21
2023,Enlisted,35016,51,8,43
2023,Enlisted,35040,11,1,10
2023,Enlisted,35042,14,3,11
2023,Enlisted,35045,18,1,17
2023,Enlisted,35055,30,8,22
2023,Enlisted,35121,37,4,33
2023,Enlisted,35124,26,10,16
2023,Enlisted,35146,9,1,8
2023,Enlisted,35160,18,4,14
2023,Enlisted,35178,9,1,8
2023,Enlisted,35209,13,3,10
2023,Enlisted,35217,50,19,31
2023,Enlisted,35405,23,2,21
2023,Enlisted,35476,9,1,8
2023,Enlisted,35501,6,2,4
2023,Enlisted,35555,14,1,13
2023,Enlisted,35565,12,1,11
2023,Enlisted,35601,48,9,39
2023,Enlisted,35613,7,2,5
2023,Enlisted,35630,14,3,11
2023,Enlisted,35803,37,8,29
2023,Enlisted,35805,23,2,21
2023,Enlisted,35904,20,3,17
2023,Enlisted,35967,6,4,2
2023,Enlisted,36016,17,2,15
2023,Enlisted,36027,4,1,3
2023,Enlisted,36043,35,3,32
2023,Enlisted,36067,6,1,5
2023,Enlisted,36078,10,1,9
2023,Enlisted,36081,27,2,25
2023,Enlisted,36083,10,1,9
2023,Enlisted,36109,186,14,172
2023,Enlisted,36117,19,2,17
2023,Enlisted,36203,12,0,12
2023,Enlisted,36205,33,8,25
2023,Enlisted,36265,20,2,18
2023,Enlisted,36301,19,2,17
2023,Enlisted,36323,8,0,8
2023,Enlisted,36330,29,3,26
2023,Enlisted,36340,7,1,6
2023,Enlisted,36420,11,1,10
2023,Enlisted,36426,20,2,18
2023,Enlisted,36442,3,0,3
2023,Enlisted,36502,9,0,9
2023,Enlisted,36522,16,0,16
2023,Enlisted,36532,12,0,12
2023,Enlisted,36535,20,4,16
2023,Enlisted,36605,37,7,30
2023,Enlisted,36608,4,1,3
2023,Enlisted,36701,2,0,2
2023,Enlisted,36832,18,2,16
2023,Enlisted,36854,24,4,20
2023,Enlisted,36867,10,2,8
2023,Enlisted,37015,7,2,5
2023,Enlisted,37033,10,4,6
2023,Enlisted,37042,16,8,8
2023,Enlisted,37055,17,2,15
2023,Enlisted,37056,2,0,2
2023,Enlisted,37066,18,9,9
2023,Enlisted,37083,7,0,7
2023,Enlisted,37090,9,0,9
2023,Enlisted,37091,6,1,5
2023,Enlisted,37097,3,1,2
2023,Enlisted,37110,17,6,11
2023,Enlisted,37129,20,2,18
2023,Enlisted,37160,7,2,5
2023,Enlisted,37167,65,12,53
2023,Enlisted,37172,17,6,11
2023,Enlisted,37185,1,0,1
2023,Enlisted,37204,56,18,38
2023,Enlisted,37217,23,7,16
2023,Enlisted,37306,8,1,7
2023,Enlisted,37321,10,1,9
2023,Enlisted,37323,10,2,8
2023,Enlisted,37327,10,1,9
2023,Enlisted,37334,1,0,1
2023,Enlisted,37356,7,0,7
2023,Enlisted,37388,32,8,24
2023,Enlisted,37398,12,2,10
2023,Enlisted,37404,40,3,37
2023,Enlisted,37615,4,1,3
2023,Enlisted,37620,6,1,5
2023,Enlisted,37643,7,4,3
2023,Enlisted,37645,13,1,12
2023,Enlisted,37743,9,3,6
2023,Enlisted,37757,11,1,10
2023,Enlisted,37760,11,3,8
2023,Enlisted,37771,11,1,10
2023,Enlisted,37777,46,6,40
2023,Enlisted,37801,4,1,3
2023,Enlisted,37821,12,5,7
2023,Enlisted,37825,12,3,9
2023,Enlisted,37841,5,1,4
2023,Enlisted,37854,14,0,14
2023,Enlisted,37857,4,0,4
2023,Enlisted,37860,8,0,8
2023,Enlisted,37863,2,0,2
2023,Enlisted,37874,7,3,4
2023,Enlisted,37919,30,5,25
2023,Enlisted,38001,6,1,5
2023,Enlisted,38008,6,0,6
2023,Enlisted,38012,5,1,4
2023,Enlisted,38019,5,1,4
2023,Enlisted,38053,14,0,14
2023,Enlisted,38054,1,1,0
2023,Enlisted,38118,31,2,29
2023,Enlisted,38201,7,1,6
2023,Enlisted,38242,11,2,9
2023,Enlisted,38261,14,4,10
2023,Enlisted,38301,14,2,12
2023,Enlisted,38305,17,3,14
2023,Enlisted,38320,4,0,4
2023,Enlisted,38340,13,3,10
2023,Enlisted,38343,18,2,16
2023,Enlisted,38344,7,2,5
2023,Enlisted,38351,12,0,12
2023,Enlisted,38358,16,2,14
2023,Enlisted,38372,4,1,3
2023,Enlisted,38375,5,0,5
2023,Enlisted,38382,10,3,7
2023,Enlisted,38401,7,0,7
2023,Enlisted,38464,3,0,3
2023,Enlisted,38478,3,1,2
2023,Enlisted,38485,9,1,8
2023,Enlisted,38506,8,2,6
2023,Enlisted,38556,13,4,9
2023,Enlisted,38563,7,2,5
2023,Enlisted,38570,13,7,6
2023,Enlisted,38572,11,1,10
2023,Enlisted,38583,3,0,3
2023,Enlisted,38606,2,0,2
2023,Enlisted,38632,25,1,24
2023,Enlisted,38655,12,1,11
2023,Enlisted,38668,23,0,23
2023,Enlisted,38671,28,3,25
2023,Enlisted,38703,10,0,10
2023,Enlisted,38801,25,4,21
2023,Enlisted,38821,3,0,3
2023,Enlisted,38829,3,1,2
2023,Enlisted,38834,11,1,10
2023,Enlisted,38843,1,0,1
2023,Enlisted,38851,15,0,15
2023,Enlisted,38863,4,1,3
2023,Enlisted,38901,11,5,6
2023,Enlisted,38915,17,1,16
2023,Enlisted,38916,6,0,6
2023,Enlisted,38930,20,0,20
2023,Enlisted,38967,3,0,3
2023,Enlisted,39042,18,1,17
2023,Enlisted,39046,12,1,11
2023,Enlisted,39047,2,0,2
2023,Enlisted,39051,10,0,10
2023,Enlisted,39056,24,2,22
2023,Enlisted,39059,8,0,8
2023,Enlisted,39074,7,0,7
2023,Enlisted,39111,9,1,8
2023,Enlisted,39117,3,1,2
2023,Enlisted,39120,3,0,3
2023,Enlisted,39183,9,2,7
2023,Enlisted,39202,8,8,0
2023,Enlisted,39204,85,2,83
2023,Enlisted,39209,13,3,10
2023,Enlisted,39216,11,5,6
2023,Enlisted,39307,5,0,5
2023,Enlisted,39339,16,0,16
2023,Enlisted,39345,21,5,16
2023,Enlisted,39350,11,1,10
2023,Enlisted,39401,30,4,26
2023,Enlisted,39407,15,3,12
2023,Enlisted,39422,6,2,4
2023,Enlisted,39429,5,0,5
2023,Enlisted,39440,6,0,6
2023,Enlisted,39452,4,0,4
2023,Enlisted,39466,9,0,9
2023,Enlisted,39470,10,4,6
2023,Enlisted,39505,4,0,4
2023,Enlisted,39507,17,1,16
2023,Enlisted,39532,9,2,7
2023,Enlisted,39556,3,1,2
2023,Enlisted,39567,7,1,6
2023,Enlisted,39577,2,0,2
2023,Enlisted,39601,5,2,3
2023,Enlisted,39648,4,0,4
2023,Enlisted,39654,6,0,6
2023,Enlisted,39730,6,0,6
2023,Enlisted,39759,10,1,9
2023,Enlisted,39773,6,0,6
2023,Enlisted,40004,6,0,6
2023,Enlisted,40065,4,0,4
2023,Enlisted,40069,6,1,5
2023,Enlisted,40108,3,1,2
2023,Enlisted,40122,1,1,0
2023,Enlisted,40205,38,12,26
2023,Enlisted,40218,29,1,28
2023,Enlisted,40311,10,1,9
2023,Enlisted,40330,6,3,3
2023,Enlisted,40351,4,0,4
2023,Enlisted,40472,6,1,5
2023,Enlisted,40475,34,3,31
2023,Enlisted,40510,17,4,13
2023,Enlisted,40601,102,10,92
2023,Enlisted,40741,5,0,5
2023,Enlisted,40769,1,0,1
2023,Enlisted,40840,3,2,1
2023,Enlisted,40903,1,0,1
2023,Enlisted,40906,3,1,2
2023,Enlisted,40965,3,0,3
2023,Enlisted,41005,36,5,31
2023,Enlisted,41008,4,0,4
2023,Enlisted,41031,6,1,5
2023,Enlisted,41094,19,0,19
2023,Enlisted,41101,5,0,5
2023,Enlisted,41164,2,0,2
2023,Enlisted,41339,4,2,2
2023,Enlisted,41653,6,0,6
2023,Enlisted,41701,2,0,2
2023,Enlisted,42025,5,1,4
2023,Enlisted,42071,10,4,6
2023,Enlisted,42086,4,2,2
2023,Enlisted,42101,4,1,3
2023,Enlisted,42141,7,2,5
2023,Enlisted,42167,6,0,6
2023,Enlisted,42240,7,1,6
2023,Enlisted,42301,10,4,6
2023,Enlisted,42330,9,3,6
2023,Enlisted,42345,11,4,7
2023,Enlisted,42431,9,6,3
2023,Enlisted,42501,4,1,3
2023,Enlisted,42633,4,0,4
2023,Enlisted,42701,13,2,11
2023,Enlisted,42718,9,1,8
2023,Enlisted,42754,16,1,15
2023,Enlisted,43015,16,6,10
2023,Enlisted,43040,11,3,8
2023,Enlisted,43055,13,3,10
2023,Enlisted,43102,14,0,14
2023,Enlisted,43213,40,7,33
2023,Enlisted,43215,2,0,2
2023,Enlisted,43217,57,9,48
2023,Enlisted,43235,32,5,27
2023,Enlisted,43402,18,5,13
2023,Enlisted,43465,27,4,23
2023,Enlisted,43614,14,3,11
2023,Enlisted,43756,9,1,8
2023,Enlisted,43812,7,1,6
2023,Enlisted,44023,34,4,30
2023,Enlisted,44055,5,0,5
2023,Enlisted,44128,13,4,9
2023,Enlisted,44142,7,1,6
2023,Enlisted,44224,24,6,18
2023,Enlisted,44256,6,1,5
2023,Enlisted,44313,4,1,3
2023,Enlisted,44444,15,4,11
2023,Enlisted,44515,19,3,16
2023,Enlisted,44601,1,1,0
2023,Enlisted,44622,3,0,3
2023,Enlisted,44691,5,1,4
2023,Enlisted,44720,51,13,38
2023,Enlisted,44857,8,0,8
2023,Enlisted,44870,10,5,5
2023,Enlisted,44883,8,5,3
2023,Enlisted,44903,13,4,9
2023,Enlisted,45015,11,0,11
2023,Enlisted,45035,11,2,9
2023,Enlisted,45044,30,8,22
2023,Enlisted,45215,24,4,20
2023,Enlisted,45331,3,1,2
2023,Enlisted,45356,22,4,18
2023,Enlisted,45430,9,1,8
2023,Enlisted,45502,28,4,24
2023,Enlisted,45601,16,1,15
2023,Enlisted,45662,7,0,7
2023,Enlisted,45804,9,2,7
2023,Enlisted,46012,8,1,7
2023,Enlisted,46036,3,0,3
2023,Enlisted,46041,2,1,1
2023,Enlisted,46052,10,1,9
2023,Enlisted,46124,24,8,16
2023,Enlisted,46131,63,5,58
2023,Enlisted,46135,14,1,13
2023,Enlisted,46140,10,4,6
2023,Enlisted,46151,12,4,8
2023,Enlisted,46176,34,8,26
2023,Enlisted,46208,1,1,0
2023,Enlisted,46216,20,5,15
2023,Enlisted,46223,3,1,2
2023,Enlisted,46228,1,1,0
2023,Enlisted,46241,152,15,137
2023,Enlisted,46323,8,2,6
2023,Enlisted,46350,5,0,5
2023,Enlisted,46360,3,0,3
2023,Enlisted,46383,11,0,11
2023,Enlisted,46402,16,2,14
2023,Enlisted,46406,19,8,11
2023,Enlisted,46517,31,1,30
2023,Enlisted,46563,7,3,4
2023,Enlisted,46582,7,2,5
2023,Enlisted,46613,29,8,21
2023,Enlisted,46703,12,2,10
2023,Enlisted,46714,3,0,3
2023,Enlisted,46750,5,0,5
2023,Enlisted,46825,38,7,31
2023,Enlisted,46901,5,1,4
2023,Enlisted,46947,16,4,12
2023,Enlisted,46970,11,3,8
2023,Enlisted,47150,4,2,2
2023,Enlisted,47167,10,2,8
2023,Enlisted,47170,3,1,2
2023,Enlisted,47203,28,6,22
2023,Enlisted,47223,2,0,2
2023,Enlisted,47250,5,2,3
2023,Enlisted,47265,4,0,4
2023,Enlisted,47274,15,3,12
2023,Enlisted,47303,14,3,11
2023,Enlisted,47331,6,2,4
2023,Enlisted,47348,8,4,4
2023,Enlisted,47374,5,0,5
2023,Enlisted,47394,21,0,21
2023,Enlisted,47401,8,1,7
2023,Enlisted,47421,9,2,7
2023,Enlisted,47501,9,3,6
2023,Enlisted,47546,1,0,1
2023,Enlisted,47591,6,0,6
2023,Enlisted,47715,26,2,24
2023,Enlisted,47804,1,1,0
2023,Enlisted,47834,12,2,10
2023,Enlisted,47872,4,0,4
2023,Enlisted,47904,1,0,1
2023,Enlisted,47905,28,3,25
2023,Enlisted,47933,11,2,9
2023,Enlisted,47960,2,0,2
2023,Enlisted,47977,6,1,5
2023,Enlisted,47978,1,0,1
2023,Enlisted,48060,7,2,5
2023,Enlisted,48180,17,4,13
2023,Enlisted,48197,25,3,22
2023,Enlisted,48208,19,4,15
2023,Enlisted,48234,42,14,28
2023,Enlisted,48341,3,0,3
2023,Enlisted,48446,6,0,6
2023,Enlisted,48601,26,10,16
2023,Enlisted,48642,8,0,8
2023,Enlisted,48706,5,0,5
2023,Enlisted,48801,5,1,4
2023,Enlisted,48817,10,1,9
2023,Enlisted,48837,32,4,28
2023,Enlisted,48838,13,3,10
2023,Enlisted,48843,10,1,9
2023,Enlisted,48906,70,11,59
2023,Enlisted,48912,7,2,5
2023,Enlisted,49009,15,2,13
2023,Enlisted,49012,34,4,30
2023,Enlisted,49047,7,6,1
2023,Enlisted,49201,13,5,8
2023,Enlisted,49224,2,0,2
2023,Enlisted,49306,1,0,1
2023,Enlisted,49307,8,6,2
2023,Enlisted,49437,9,1,8
2023,Enlisted,49509,47,14,33
2023,Enlisted,49601,3,1,2
2023,Enlisted,49696,7,1,6
2023,Enlisted,49739,15,9,6
2023,Enlisted,49783,6,0,6
2023,Enlisted,49801,2,0,2
2023,Enlisted,49837,8,3,5
2023,Enlisted,49849,4,1,3
2023,Enlisted,49855,7,0,7
2023,Enlisted,49913,3,1,2
2023,Enlisted,50025,3,1,2
2023,Enlisted,50036,23,3,20
2023,Enlisted,50126,5,1,4
2023,Enlisted,50131,175,36,139
2023,Enlisted,50138,1,0,1
2023,Enlisted,50158,7,0,7
2023,Enlisted,50220,11,1,10
2023,Enlisted,50401,5,1,4
2023,Enlisted,50501,4,2,2
2023,Enlisted,50588,9,0,9
2023,Enlisted,50616,1,1,0
2023,Enlisted,50703,22,4,18
2023,Enlisted,51031,9,1,8
2023,Enlisted,51111,19,1,18
2023,Enlisted,51201,7,0,7
2023,Enlisted,51301,3,0,3
2023,Enlisted,51334,5,1,4
2023,Enlisted,51401,8,0,8
2023,Enlisted,51442,3,1,2
2023,Enlisted,51503,15,3,12
2023,Enlisted,51566,6,1,5
2023,Enlisted,51601,4,1,3
2023,Enlisted,52001,2,2,0
2023,Enlisted,52246,41,3,38
2023,Enlisted,52353,8,1,7
2023,Enlisted,52404,18,1,17
2023,Enlisted,52501,9,2,7
2023,Enlisted,52556,5,1,4
2023,Enlisted,52577,4,0,4
2023,Enlisted,52632,11,0,11
2023,Enlisted,52638,18,2,16
2023,Enlisted,52641,7,2,5
2023,Enlisted,52732,5,1,4
2023,Enlisted,52761,1,0,1
2023,Enlisted,52806,22,1,21
2023,Enlisted,53027,11,3,8
2023,Enlisted,53066,12,0,12
2023,Enlisted,53089,11,2,9
2023,Enlisted,53094,6,0,6
2023,Enlisted,53095,9,2,7
2023,Enlisted,53121,1,0,1
2023,Enlisted,53144,18,1,17
2023,Enlisted,53154,7,1,6
2023,Enlisted,53186,7,1,6
2023,Enlisted,53190,4,1,3
2023,Enlisted,53212,13,3,10
2023,Enlisted,53403,7,3,4
2023,Enlisted,53511,8,2,6
2023,Enlisted,53538,6,1,5
2023,Enlisted,53545,2,0,2
2023,Enlisted,53704,68,14,54
2023,Enlisted,53821,2,0,2
2023,Enlisted,53901,9,1,8
2023,Enlisted,53913,4,1,3
2023,Enlisted,53948,4,1,3
2023,Enlisted,53959,7,2,5
2023,Enlisted,53963,9,4,5
2023,Enlisted,54017,6,1,5
2023,Enlisted,54022,3,2,1
2023,Enlisted,54143,10,1,9
2023,Enlisted,54241,5,0,5
2023,Enlisted,54303,12,2,10
2023,Enlisted,54401,8,1,7
2023,Enlisted,54405,4,1,3
2023,Enlisted,54409,9,0,9
2023,Enlisted,54449,8,1,7
2023,Enlisted,54455,8,1,7
2023,Enlisted,54456,3,0,3
2023,Enlisted,54481,2,0,2
2023,Enlisted,54495,4,0,4
2023,Enlisted,54501,9,3,6
2023,Enlisted,54612,1,0,1
2023,Enlisted,54615,5,1,4
2023,Enlisted,54618,6,4,2
2023,Enlisted,54646,5,1,4
2023,Enlisted,54650,10,1,9
2023,Enlisted,54656,1,1,0
2023,Enlisted,54660,9,0,9
2023,Enlisted,54665,1,0,1
2023,Enlisted,54703,11,1,10
2023,Enlisted,54729,3,0,3
2023,Enlisted,54751,10,1,9
2023,Enlisted,54801,3,0,3
2023,Enlisted,54806,5,0,5
2023,Enlisted,54843,5,1,4
2023,Enlisted,54868,1,0,1
2023,Enlisted,54880,7,0,7
2023,Enlisted,54902,11,2,9
2023,Enlisted,54929,4,0,4
2023,Enlisted,54932,13,1,12
2023,Enlisted,54935,17,3,14
2023,Enlisted,54971,6,2,4
2023,Enlisted,54981,2,0,2
2023,Enlisted,55008,26,3,23
2023,Enlisted,55016,17,1,16
2023,Enlisted,55021,37,2,35
2023,Enlisted,55033,32,0,32
2023,Enlisted,55060,2,2,0
2023,Enlisted,55063,16,2,14
2023,Enlisted,55066,2,0,2
2023,Enlisted,55068,27,3,24
2023,Enlisted,55077,16,2,14
2023,Enlisted,55082,40,3,37
2023,Enlisted,55101,1,1,0
2023,Enlisted,55106,24,7,17
2023,Enlisted,55107,30,6,24
2023,Enlisted,55112,118,15,103
2023,Enlisted,55118,27,4,23
2023,Enlisted,55303,12,3,9
2023,Enlisted,55350,19,0,19
2023,Enlisted,55355,14,2,12
2023,Enlisted,55362,9,0,9
2023,Enlisted,55413,36,1,35
2023,Enlisted,55431,50,3,47
2023,Enlisted,55443,6,1,5
2023,Enlisted,55719,7,1,6
2023,Enlisted,55720,6,0,6
2023,Enlisted,55744,1,0,1
2023,Enlisted,55746,3,0,3
2023,Enlisted,55811,17,3,14
2023,Enlisted,55901,31,1,30
2023,Enlisted,55912,19,3,16
2023,Enlisted,55987,19,3,16
2023,Enlisted,56001,16,3,13
2023,Enlisted,56007,24,2,22
2023,Enlisted,56031,6,2,4
2023,Enlisted,56073,4,0,4
2023,Enlisted,56081,6,0,6
2023,Enlisted,56082,17,2,15
2023,Enlisted,56143,12,0,12
2023,Enlisted,56156,8,0,8
2023,Enlisted,56164,4,2,2
2023,Enlisted,56201,4,1,3
2023,Enlisted,56208,4,2,2
2023,Enlisted,56256,7,0,7
2023,Enlisted,56258,11,1,10
2023,Enlisted,56265,6,0,6
2023,Enlisted,56267,4,0,4
2023,Enlisted,56273,23,1,22
2023,Enlisted,56277,10,0,10
2023,Enlisted,56278,7,0,7
2023,Enlisted,56301,9,0,9
2023,Enlisted,56303,17,2,15
2023,Enlisted,56308,16,0,16
2023,Enlisted,56345,181,12,169
2023,Enlisted,56378,4,1,3
2023,Enlisted,56401,18,1,17
2023,Enlisted,56482,1,1,0
2023,Enlisted,56501,3,0,3
2023,Enlisted,56537,9,2,7
2023,Enlisted,56560,18,5,13
2023,Enlisted,56601,11,0,11
2023,Enlisted,56701,10,1,9
2023,Enlisted,56716,18,2,16
2023,Enlisted,57006,4,0,4
2023,Enlisted,57028,3,0,3
2023,Enlisted,57042,14,1,13
2023,Enlisted,57069,3,0,3
2023,Enlisted,57078,7,2,5
2023,Enlisted,57104,44,8,36
2023,Enlisted,57201,15,2,13
2023,Enlisted,57252,3,0,3
2023,Enlisted,57301,7,0,7
2023,Enlisted,57325,5,1,4
2023,Enlisted,57350,5,0,5
2023,Enlisted,57366,4,2,2
2023,Enlisted,57380,2,0,2
2023,Enlisted,57401,10,2,8
2023,Enlisted,57501,6,0,6
2023,Enlisted,57601,5,0,5
2023,Enlisted,57701,1,0,1
2023,Enlisted,57702,21,9,12
2023,Enlisted,57703,12,4,8
2023,Enlisted,57717,5,1,4
2023,Enlisted,57783,6,0,6
2023,Enlisted,57785,3,0,3
2023,Enlisted,58054,14,0,14
2023,Enlisted,58072,4,0,4
2023,Enlisted,58075,15,0,15
2023,Enlisted,58102,38,8,30
2023,Enlisted,58201,31,3,28
2023,Enlisted,58301,15,1,14
2023,Enlisted,58401,4,1,3
2023,Enlisted,58433,6,1,5
2023,Enlisted,58495,2,0,2
2023,Enlisted,58501,45,5,40
2023,Enlisted,58504,7,0,7
2023,Enlisted,58506,8,1,7
2023,Enlisted,58601,1,0,1
2023,Enlisted,58703,18,2,16
2023,Enlisted,59102,25,5,20
2023,Enlisted,59218,7,1,6
2023,Enlisted,59301,6,0,6
2023,Enlisted,59405,7,2,5
2023,Enlisted,59538,5,0,5
2023,Enlisted,59602,30,5,25
2023,Enlisted,59636,23,12,11
2023,Enlisted,59701,3,1,2
2023,Enlisted,59711,5,1,4
2023,Enlisted,59714,26,6,20
2023,Enlisted,59725,2,0,2
2023,Enlisted,59808,26,3,23
2023,Enlisted,59901,24,3,21
2023,Enlisted,59923,1,0,1
2023,Enlisted,60037,18,1,17
2023,Enlisted,60098,8,1,7
2023,Enlisted,60120,10,5,5
2023,Enlisted,60178,10,3,7
2023,Enlisted,60435,48,5,43
2023,Enlisted,60472,63,5,58
2023,Enlisted,60505,17,2,15
2023,Enlisted,60545,27,2,25
2023,Enlisted,60546,58,6,52
2023,Enlisted,60615,61,6,55
2023,Enlisted,60651,28,5,23
2023,Enlisted,60901,28,4,24
2023,Enlisted,61021,8,4,4
2023,Enlisted,61032,25,1,24
2023,Enlisted,61071,19,0,19
2023,Enlisted,61115,46,3,43
2023,Enlisted,61201,1,1,0
2023,Enlisted,61264,17,1,16
2023,Enlisted,61341,7,0,7
2023,Enlisted,61401,13,1,12
2023,Enlisted,61434,4,0,4
2023,Enlisted,61443,13,2,11
2023,Enlisted,61455,21,2,19
2023,Enlisted,61607,55,8,47
2023,Enlisted,61701,11,2,9
2023,Enlisted,61761,13,0,13
2023,Enlisted,61764,9,1,8
2023,Enlisted,61801,5,2,3
2023,Enlisted,61820,7,2,5
2023,Enlisted,61834,6,1,5
2023,Enlisted,61938,9,1,8
2023,Enlisted,61944,12,0,12
2023,Enlisted,61951,1,0,1
2023,Enlisted,62056,19,8,11
2023,Enlisted,62205,24,1,23
2023,Enlisted,62269,13,1,12
2023,Enlisted,62286,23,3,20
2023,Enlisted,62301,2,0,2
2023,Enlisted,62401,12,2,10
2023,Enlisted,62439,10,1,9
2023,Enlisted,62521,32,1,31
2023,Enlisted,62659,2,0,2
2023,Enlisted,62702,62,11,51
2023,Enlisted,62864,14,1,13
2023,Enlisted,62896,9,2,7
2023,Enlisted,62959,13,2,11
2023,Enlisted,62966,14,1,13
2023,Enlisted,63020,6,2,4
2023,Enlisted,63028,19,4,15
2023,Enlisted,63044,54,12,42
2023,Enlisted,63077,19,3,16
2023,Enlisted,63125,43,9,34
2023,Enlisted,63383,16,1,15
2023,Enlisted,63401,4,1,3
2023,Enlisted,63552,10,1,9
2023,Enlisted,63640,14,2,12
2023,Enlisted,63645,2,0,2
2023,Enlisted,63701,3,1,2
2023,Enlisted,63703,4,1,3
2023,Enlisted,63755,11,0,11
2023,Enlisted,63775,10,2,8
2023,Enlisted,63801,5,1,4
2023,Enlisted,63841,9,1,8
2023,Enlisted,63857,9,1,8
2023,Enlisted,63901,8,0,8
2023,Enlisted,64052,8,2,6
2023,Enlisted,64067,6,0,6
2023,Enlisted,64085,1,1,0
2023,Enlisted,64093,7,0,7
2023,Enlisted,64129,73,12,61
2023,Enlisted,64402,2,1,1
2023,Enlisted,64468,5,0,5
2023,Enlisted,64506,7,2,5
2023,Enlisted,64601,4,1,3
2023,Enlisted,64683,6,0,6
2023,Enlisted,64701,4,0,4
2023,Enlisted,64735,11,1,10
2023,Enlisted,64759,21,7,14
2023,Enlisted,64772,3,1,2
2023,Enlisted,64804,4,0,4
2023,Enlisted,64831,1,0,1
2023,Enlisted,64836,11,3,8
2023,Enlisted,65082,2,0,2
2023,Enlisted,65101,9,4,5
2023,Enlisted,65109,19,2,17
2023,Enlisted,65202,11,1,10
2023,Enlisted,65233,17,3,14
2023,Enlisted,65251,4,2,2
2023,Enlisted,65265,14,4,10
2023,Enlisted,65270,8,1,7
2023,Enlisted,65301,7,1,6
2023,Enlisted,65305,32,1,31
2023,Enlisted,65340,8,1,7
2023,Enlisted,65401,13,2,11
2023,Enlisted,65473,14,3,11
2023,Enlisted,65605,3,0,3
2023,Enlisted,65708,9,1,8
2023,Enlisted,65723,9,0,9
2023,Enlisted,65775,8,2,6
2023,Enlisted,65802,38,4,34
2023,Enlisted,65803,27,5,22
2023,Enlisted,66027,29,5,24
2023,Enlisted,66044,10,2,8
2023,Enlisted,66061,14,1,13
2023,Enlisted,66067,8,1,7
2023,Enlisted,66071,5,1,4
2023,Enlisted,66102,14,0,14
2023,Enlisted,66217,10,2,8
2023,Enlisted,66219,18,5,13
2023,Enlisted,66401,1,0,1
2023,Enlisted,66434,7,2,5
2023,Enlisted,66436,6,0,6
2023,Enlisted,66441,15,5,10
2023,Enlisted,66442,3,1,2
2023,Enlisted,66502,21,9,12
2023,Enlisted,66611,3,0,3
2023,Enlisted,66619,74,14,60
2023,Enlisted,66749,8,0,8
2023,Enlisted,66762,18,3,15
2023,Enlisted,66801,7,3,4
2023,Enlisted,66901,5,3,2
2023,Enlisted,66967,2,1,1
2023,Enlisted,67010,13,1,12
2023,Enlisted,67114,16,2,14
2023,Enlisted,67124,3,1,2
2023,Enlisted,67217,24,1,23
2023,Enlisted,67219,46,9,37
2023,Enlisted,67337,5,0,5
2023,Enlisted,67401,13,1,12
2023,Enlisted,67410,12,2,10
2023,Enlisted,67432,1,0,1
2023,Enlisted,67501,1,0,1
2023,Enlisted,67530,10,0,10
2023,Enlisted,67601,6,1,5
2023,Enlisted,67654,1,0,1
2023,Enlisted,67701,3,1,2
2023,Enlisted,67801,4,0,4
2023,Enlisted,67901,7,2,5
2023,Enlisted,68066,7,1,6
2023,Enlisted,68073,56,15,41
2023,Enlisted,68106,4,0,4
2023,Enlisted,68142,18,2,16
2023,Enlisted,68310,9,2,7
2023,Enlisted,68467,6,1,5
2023,Enlisted,68508,8,3,5
2023,Enlisted,68524,34,8,26
2023,Enlisted,68601,9,2,7
2023,Enlisted,68701,5,0,5
2023,Enlisted,68787,4,0,4
2023,Enlisted,68801,4,1,3
2023,Enlisted,68803,4,1,3
2023,Enlisted,68822,1,0,1
2023,Enlisted,68847,10,1,9
2023,Enlisted,68901,14,2,12
2023,Enlisted,69001,5,1,4
2023,Enlisted,69101,3,0,3
2023,Enlisted,69162,3,0,3
2023,Enlisted,69337,2,0,2
2023,Enlisted,69341,3,1,2
2023,Enlisted,69361,4,0,4
2023,Enlisted,70072,11,3,8
2023,Enlisted,70084,15,2,13
2023,Enlisted,70117,85,15,70
2023,Enlisted,70301,5,2,3
2023,Enlisted,70364,7,1,6
2023,Enlisted,70390,7,0,7
2023,Enlisted,70401,56,3,53
2023,Enlisted,70403,8,1,7
2023,Enlisted,70427,8,0,8
2023,Enlisted,70433,14,2,12
2023,Enlisted,70438,14,2,12
2023,Enlisted,70443,7,1,6
2023,Enlisted,70460,29,1,28
2023,Enlisted,70508,26,6,20
2023,Enlisted,70510,18,2,16
2023,Enlisted,70517,7,0,7
2023,Enlisted,70526,7,1,6
2023,Enlisted,70544,12,1,11
2023,Enlisted,70563,9,3,6
2023,Enlisted,70570,6,0,6
2023,Enlisted,70582,4,3,1
2023,Enlisted,70586,4,0,4
2023,Enlisted,70601,19,4,15
2023,Enlisted,70633,11,2,9
2023,Enlisted,70634,5,0,5
2023,Enlisted,70714,10,1,9
2023,Enlisted,70721,47,4,43
2023,Enlisted,70737,13,2,11
2023,Enlisted,70760,4,0,4
2023,Enlisted,70764,25,2,23
2023,Enlisted,70802,3,0,3
2023,Enlisted,70820,50,3,47
2023,Enlisted,71019,12,3,9
2023,Enlisted,71055,19,1,18
2023,Enlisted,71101,21,4,17
2023,Enlisted,71111,2,0,2
2023,Enlisted,71203,27,5,22
2023,Enlisted,71220,7,2,5
2023,Enlisted,71232,5,0,5
2023,Enlisted,71241,7,1,6
2023,Enlisted,71251,2,0,2
2023,Enlisted,71263,3,0,3
2023,Enlisted,71270,25,0,25
2023,Enlisted,71292,7,2,5
2023,Enlisted,71295,5,0,5
2023,Enlisted,71303,18,2,16
2023,Enlisted,71322,12,0,12
2023,Enlisted,71342,7,0,7
2023,Enlisted,71351,3,0,3
2023,Enlisted,71360,149,12,137
2023,Enlisted,71373,1,0,1
2023,Enlisted,71415,9,1,8
2023,Enlisted,71417,8,0,8
2023,Enlisted,71457,5,1,4
2023,Enlisted,71459,7,2,5
2023,Enlisted,71602,8,0,8
2023,Enlisted,71671,12,2,10
2023,Enlisted,71701,7,3,4
2023,Enlisted,71730,12,0,12
2023,Enlisted,71801,1,0,1
2023,Enlisted,71832,3,2,1
2023,Enlisted,71854,6,0,6
2023,Enlisted,71857,3,0,3
2023,Enlisted,71923,10,0,10
2023,Enlisted,71953,7,1,6
2023,Enlisted,72006,1,0,1
2023,Enlisted,72012,10,0,10
2023,Enlisted,72015,11,1,10
2023,Enlisted,72023,10,4,6
2023,Enlisted,72032,15,1,14
2023,Enlisted,72064,3,0,3
2023,Enlisted,72086,14,0,14
2023,Enlisted,72104,6,0,6
2023,Enlisted,72110,6,1,5
2023,Enlisted,72119,22,1,21
2023,Enlisted,72143,15,0,15
2023,Enlisted,72150,6,0,6
2023,Enlisted,72160,2,0,2
2023,Enlisted,72199,90,13,77
2023,Enlisted,72301,3,1,2
2023,Enlisted,72335,4,0,4
2023,Enlisted,72401,24,1,23
2023,Enlisted,72432,14,0,14
2023,Enlisted,72450,14,2,12
2023,Enlisted,72476,5,0,5
2023,Enlisted,72501,11,2,9
2023,Enlisted,72543,7,1,6
2023,Enlisted,72601,12,3,9
2023,Enlisted,72650,4,0,4
2023,Enlisted,72653,4,0,4
2023,Enlisted,72701,12,2,10
2023,Enlisted,72712,1,1,0
2023,Enlisted,72713,38,1,37
2023,Enlisted,72744,5,0,5
2023,Enlisted,72756,15,0,15
2023,Enlisted,72761,8,1,7
2023,Enlisted,72802,6,0,6
2023,Enlisted,72830,3,0,3
2023,Enlisted,72834,9,1,8
2023,Enlisted,72855,5,0,5
2023,Enlisted,72905,5,1,4
2023,Enlisted,72923,31,1,30
2023,Enlisted,72927,1,0,1
2023,Enlisted,72949,1,0,1
2023,Enlisted,73034,24,6,18
2023,Enlisted,73036,18,2,16
2023,Enlisted,73051,15,2,13
2023,Enlisted,73064,51,11,40
2023,Enlisted,73069,101,13,88
2023,Enlisted,73111,26,11,15
2023,Enlisted,73141,41,0,41
2023,Enlisted,73401,41,2,39
2023,Enlisted,73501,2,1,1
2023,Enlisted,73503,49,8,41
2023,Enlisted,73521,3,2,1
2023,Enlisted,73705,17,2,15
2023,Enlisted,74003,3,0,3
2023,Enlisted,74012,1,1,0
2023,Enlisted,74014,44,10,34
2023,Enlisted,74017,18,2,16
2023,Enlisted,74075,12,1,11
2023,Enlisted,74107,47,10,37
2023,Enlisted,74112,7,1,6
2023,Enlisted,74116,10,2,8
2023,Enlisted,74301,19,2,17
2023,Enlisted,74403,63,4,59
2023,Enlisted,74423,3,1,2
2023,Enlisted,74447,8,1,7
2023,Enlisted,74501,10,1,9
2023,Enlisted,74601,8,2,6
2023,Enlisted,74701,15,2,13
2023,Enlisted,74801,8,2,6
2023,Enlisted,74820,15,2,13
2023,Enlisted,74834,15,2,13
2023,Enlisted,74848,6,2,4
2023,Enlisted,75020,19,5,14
2023,Enlisted,75051,94,31,63
2023,Enlisted,75077,16,3,13
2023,Enlisted,75098,34,20,14
2023,Enlisted,75110,10,0,10
2023,Enlisted,75159,53,25,28
2023,Enlisted,75165,20,3,17
2023,Enlisted,75220,29,7,22
2023,Enlisted,75237,11,7,4
2023,Enlisted,75402,14,3,11
2023,Enlisted,75570,6,2,4
2023,Enlisted,75662,16,3,13
2023,Enlisted,75709,18,7,11
2023,Enlisted,75803,9,7,2
2023,Enlisted,75901,24,7,17
2023,Enlisted,76067,2,1,1
2023,Enlisted,76086,12,3,9
2023,Enlisted,76105,1,1,0
2023,Enlisted,76108,76,23,53
2023,Enlisted,76115,6,4,2
2023,Enlisted,76207,25,10,15
2023,Enlisted,76234,8,2,6
2023,Enlisted,76302,10,4,6
2023,Enlisted,76401,16,5,11
2023,Enlisted,76502,42,24,18
2023,Enlisted,76528,23,7,16
2023,Enlisted,76542,58,35,23
2023,Enlisted,76544,20,8,12
2023,Enlisted,76554,1,1,0
2023,Enlisted,76574,9,1,8
2023,Enlisted,76707,43,23,20
2023,Enlisted,76801,8,3,5
2023,Enlisted,76905,18,7,11
2023,Enlisted,77034,68,31,37
2023,Enlisted,77067,68,26,42
2023,Enlisted,77082,85,29,56
2023,Enlisted,77340,17,9,8
2023,Enlisted,77437,17,5,12
2023,Enlisted,77471,17,4,13
2023,Enlisted,77503,7,7,0
2023,Enlisted,77515,19,4,15
2023,Enlisted,77568,8,5,3
2023,Enlisted,77802,18,4,14
2023,Enlisted,77833,11,1,10
2023,Enlisted,77904,40,15,25
2023,Enlisted,78041,25,8,17
2023,Enlisted,78130,3,3,0
2023,Enlisted,78218,41,14,27
2023,Enlisted,78219,14,12,2
2023,Enlisted,78257,77,32,45
2023,Enlisted,78363,19,8,11
2023,Enlisted,78501,1,0,1
2023,Enlisted,78520,14,10,4
2023,Enlisted,78527,3,2,1
2023,Enlisted,78596,29,15,14
2023,Enlisted,78602,28,12,16
2023,Enlisted,78617,35,17,18
2023,Enlisted,78624,20,13,7
2023,Enlisted,78665,12,8,4
2023,Enlisted,78666,84,39,45
2023,Enlisted,78703,128,71,57
2023,Enlisted,78731,17,8,9
2023,Enlisted,78861,17,11,6
2023,Enlisted,79107,9,3,6
2023,Enlisted,79403,43,4,39
2023,Enlisted,79602,3,0,3
2023,Enlisted,79607,9,6,3
2023,Enlisted,79705,16,9,7
2023,Enlisted,79918,12,11,1
2023,Enlisted,79924,10,1,9
2023,Enlisted,79936,98,47,51
2023,Enlisted,80011,56,35,21
2023,Enlisted,80012,6,5,1
2023,Enlisted,80112,1,1,0
2023,Enlisted,80137,24,19,5
2023,Enlisted,80216,43,21,22
2023,Enlisted,80501,2,1,1
2023,Enlisted,80504,14,9,5
2023,Enlisted,80521,13,10,3
2023,Enlisted,80550,9,7,2
2023,Enlisted,80621,31,16,15
2023,Enlisted,80907,4,2,2
2023,Enlisted,80913,29,20,9
2023,Enlisted,80916,1,0,1
2023,Enlisted,80920,50,42,8
2023,Enlisted,81004,13,11,2
2023,Enlisted,81101,7,2,5
2023,Enlisted,81401,3,2,1
2023,Enlisted,81501,3,2,1
2023,Enlisted,82005,9,1,8
2023,Enlisted,82009,10,3,7
2023,Enlisted,82070,13,4,9
2023,Enlisted,82201,2,0,2
2023,Enlisted,82214,2,1,1
2023,Enlisted,82240,4,0,4
2023,Enlisted,82435,9,4,5
2023,Enlisted,82520,2,0,2
2023,Enlisted,82604,11,3,8
2023,Enlisted,82633,6,1,5
2023,Enlisted,82716,10,2,8
2023,Enlisted,82801,2,0,2
2023,Enlisted,82901,8,3,5
2023,Enlisted,82930,7,0,7
2023,Enlisted,83110,8,4,4
2023,Enlisted,83202,14,6,8
2023,Enlisted,83221,4,0,4
2023,Enlisted,83263,5,1,4
2023,Enlisted,83301,11,2,9
2023,Enlisted,83318,14,0,14
2023,Enlisted,83330,4,1,3
2023,Enlisted,83338,13,4,9
2023,Enlisted,83402,4,1,3
2023,Enlisted,83440,4,0,4
2023,Enlisted,83442,1,1,0
2023,Enlisted,83501,4,1,3
2023,Enlisted,83530,1,0,1
2023,Enlisted,83544,2,0,2
2023,Enlisted,83605,10,1,9
2023,Enlisted,83617,5,2,3
2023,Enlisted,83647,7,1,6
2023,Enlisted,83687,6,2,4
2023,Enlisted,83705,122,29,93
2023,Enlisted,83716,1,1,0
2023,Enlisted,83843,6,0,6
2023,Enlisted,83854,7,1,6
2023,Enlisted,84003,14,1,13
2023,Enlisted,84020,23,9,14
2023,Enlisted,84043,47,24,23
2023,Enlisted,84058,24,9,15
2023,Enlisted,84065,119,55,64
2023,Enlisted,84074,11,0,11
2023,Enlisted,84083,3,0,3
2023,Enlisted,84084,82,19,63
2023,Enlisted,84116,10,4,6
2023,Enlisted,84302,9,2,7
2023,Enlisted,84321,4,3,1
2023,Enlisted,84404,5,0,5
2023,Enlisted,84405,26,5,21
2023,Enlisted,84501,10,2,8
2023,Enlisted,84511,2,0,2
2023,Enlisted,84642,10,1,9
2023,Enlisted,84647,5,1,4
2023,Enlisted,84660,46,5,41
2023,Enlisted,84663,4,1,3
2023,Enlisted,84701,3,1,2
2023,Enlisted,84713,10,1,9
2023,Enlisted,84721,10,1,9
2023,Enlisted,84790,25,7,18
2023,Enlisted,85008,126,44,82
2023,Enlisted,85020,19,2,17
2023,Enlisted,85128,1,1,0
2023,Enlisted,85132,55,17,38
2023,Enlisted,85145,6,2,4
2023,Enlisted,85201,22,2,20
2023,Enlisted,85222,1,1,0
2023,Enlisted,85281,13,7,6
2023,Enlisted,85286,3,0,3
2023,Enlisted,85301,19,1,18
2023,Enlisted,85326,13,5,8
2023,Enlisted,85365,3,1,2
2023,Enlisted,85396,17,12,5
2023,Enlisted,85546,1,0,1
2023,Enlisted,85607,5,0,5
2023,Enlisted,85653,15,8,7
2023,Enlisted,85706,2,1,1
2023,Enlisted,85713,17,9,8
2023,Enlisted,85756,29,10,19
2023,Enlisted,85901,2,1,1
2023,Enlisted,86001,1,1,0
2023,Enlisted,86015,32,8,24
2023,Enlisted,86301,11,6,5
2023,Enlisted,87002,14,1,13
2023,Enlisted,87123,22,6,16
2023,Enlisted,87144,46,20,26
2023,Enlisted,87301,3,0,3
2023,Enlisted,87401,8,2,6
2023,Enlisted,87507,2,2,0
2023,Enlisted,87508,6,2,4
2023,Enlisted,87532,3,1,2
2023,Enlisted,87701,3,0,3
2023,Enlisted,88001,23,12,11
2023,Enlisted,88007,22,9,13
2023,Enlisted,88101,5,2,3
2023,Enlisted,88203,14,2,12
2023,Enlisted,88240,1,0,1
2023,Enlisted,88310,1,0,1
2023,Enlisted,89002,10,1,9
2023,Enlisted,89034,3,1,2
2023,Enlisted,89115,15,2,13
2023,Enlisted,89139,60,4,56
2023,Enlisted,89165,116,15,101
2023,Enlisted,89406,21,1,20
2023,Enlisted,89506,46,5,41
2023,Enlisted,89701,25,5,20
2023,Enlisted,89801,2,1,1
2023,Enlisted,89822,1,0,1
2023,Enlisted,90025,40,14,26
2023,Enlisted,90201,36,10,26
2023,Enlisted,90249,5,1,4
2023,Enlisted,90266,6,2,4
2023,Enlisted,90302,26,14,12
2023,Enlisted,90501,11,5,6
2023,Enlisted,90720,155,51,104
2023,Enlisted,90731,4,4,0
2023,Enlisted,90822,38,13,25
2023,Enlisted,91205,2,1,1
2023,Enlisted,91406,34,13,21
2023,Enlisted,91505,16,6,10
2023,Enlisted,91702,46,13,33
2023,Enlisted,91764,22,2,20
2023,Enlisted,91766,19,3,16
2023,Enlisted,91950,14,3,11
2023,Enlisted,92020,15,8,7
2023,Enlisted,92025,18,8,10
2023,Enlisted,92111,53,15,38
2023,Enlisted,92243,5,2,3
2023,Enlisted,92307,7,6,1
2023,Enlisted,92311,4,3,1
2023,Enlisted,92324,19,9,10
2023,Enlisted,92410,29,13,16
2023,Enlisted,92518,53,20,33
2023,Enlisted,92707,8,4,4
2023,Enlisted,92833,14,9,5
2023,Enlisted,92866,20,7,13
2023,Enlisted,93003,1,1,0
2023,Enlisted,93007,15,4,11
2023,Enlisted,93291,15,9,6
2023,Enlisted,93307,11,2,9
2023,Enlisted,93405,10,7,3
2023,Enlisted,93451,28,12,16
2023,Enlisted,93536,4,1,3
2023,Enlisted,93550,18,13,5
2023,Enlisted,93727,113,29,84
2023,Enlisted,93955,8,8,0
2023,Enlisted,94132,9,4,5
2023,Enlisted,94401,15,4,11
2023,Enlisted,94510,2,1,1
2023,Enlisted,94519,18,3,15
2023,Enlisted,94533,5,0,5
2023,Enlisted,94565,4,1,3
2023,Enlisted,94568,24,6,18
2023,Enlisted,94590,2,2,0
2023,Enlisted,94596,2,1,1
2023,Enlisted,94804,18,11,7
2023,Enlisted,94903,6,3,3
2023,Enlisted,94952,12,3,9
2023,Enlisted,95023,8,2,6
2023,Enlisted,95110,12,1,11
2023,Enlisted,95206,40,11,29
2023,Enlisted,95209,3,0,3
2023,Enlisted,95231,4,1,3
2023,Enlisted,95351,15,5,10
2023,Enlisted,95361,3,3,0
2023,Enlisted,95401,16,4,12
2023,Enlisted,95503,1,0,1
2023,Enlisted,95655,10,5,5
2023,Enlisted,95678,11,5,6
2023,Enlisted,95823,4,0,4
2023,Enlisted,95827,9,3,6
2023,Enlisted,95828,50,18,32
2023,Enlisted,95832,32,9,23
2023,Enlisted,95926,5,2,3
2023,Enlisted,95965,7,1,6
2023,Enlisted,95991,50,0,50
2023,Enlisted,96001,10,2,8
2023,Enlisted,96067,3,1,2
2023,Enlisted,96080,4,0,4
2023,Enlisted,96707,88,31,57
2023,Enlisted,96716,4,3,1
2023,Enlisted,96720,18,4,14
2023,Enlisted,96746,1,0,1
2023,Enlisted,96748,1,1,0
2023,Enlisted,96750,5,0,5
2023,Enlisted,96753,9,2,7
2023,Enlisted,96782,15,6,9
2023,Enlisted,96789,59,11,48
2023,Enlisted,96795,1,1,0
2023,Enlisted,96816,12,0,12
2023,Enlisted,96820,5,1,4
2023,Enlisted,96857,20,9,11
2023,Enlisted,96913,84,4,80
2023,Enlisted,97015,64,10,54
2023,Enlisted,97030,11,3,8
2023,Enlisted,97031,2,1,1
2023,Enlisted,97051,6,0,6
2023,Enlisted,97058,2,0,2
2023,Enlisted,97071,9,5,4
2023,Enlisted,97116,10,4,6
2023,Enlisted,97128,2,0,2
2023,Enlisted,97140,9,1,8
2023,Enlisted,97146,3,0,3
2023,Enlisted,97211,22,6,16
2023,Enlisted,97217,10,2,8
2023,Enlisted,97218,13,2,11
2023,Enlisted,97301,58,18,40
2023,Enlisted,97302,19,3,16
2023,Enlisted,97322,3,1,2
2023,Enlisted,97330,13,2,11
2023,Enlisted,97338,9,2,7
2023,Enlisted,97365,1,0,1
2023,Enlisted,97420,1,0,1
2023,Enlisted,97470,3,2,1
2023,Enlisted,97477,38,6,32
2023,Enlisted,97501,11,1,10
2023,Enlisted,97520,6,1,5
2023,Enlisted,97526,7,0,7
2023,Enlisted,97603,5,1,4
2023,Enlisted,97702,6,2,4
2023,Enlisted,97754,4,0,4
2023,Enlisted,97756,3,1,2
2023,Enlisted,97801,12,1,11
2023,Enlisted,97814,1,0,1
2023,Enlisted,97838,4,2,2
2023,Enlisted,97850,9,2,7
2023,Enlisted,97862,3,1,2
2023,Enlisted,97914,1,0,1
2023,Enlisted,98032,69,27,42
2023,Enlisted,98052,8,4,4
2023,Enlisted,98108,2,1,1
2023,Enlisted,98119,19,7,12
2023,Enlisted,98215,9,2,7
2023,Enlisted,98221,7,4,3
2023,Enlisted,98271,13,0,13
2023,Enlisted,98290,14,6,8
2023,Enlisted,98312,12,10,2
2023,Enlisted,98321,8,3,5
2023,Enlisted,98366,6,5,1
2023,Enlisted,98430,29,13,16
2023,Enlisted,98433,87,39,48
2023,Enlisted,98512,39,19,20
2023,Enlisted,98531,17,3,14
2023,Enlisted,98563,13,1,12
2023,Enlisted,98632,6,1,5
2023,Enlisted,98682,14,1,13
2023,Enlisted,98801,1,0,1
2023,Enlisted,98823,6,1,5
2023,Enlisted,98837,5,0,5
2023,Enlisted,98901,30,4,26
2023,Enlisted,98903,14,3,11
2023,Enlisted,98930,3,0,3
2023,Enlisted,99011,22,10,12
2023,Enlisted,99217,27,6,21
2023,Enlisted,99219,1,0,1
2023,Enlisted,99224,1,0,1
2023,Enlisted,99301,2,1,1
2023,Enlisted,99354,8,3,5
2023,Enlisted,99362,2,1,1
2023,Enlisted,99505,67,34,33
2023,Enlisted,99515,1,0,1
2023,Enlisted,99599,1,0,1
2023,Enlisted,99654,1,1,0
2023,Enlisted,99701,10,2,8
2023,Officer,     ,13,11,2
2023,Officer,00604,1,1,0
2023,Officer,00624,1,1,0
2023,Officer,00682,2,2,0
2023,Officer,00693,2,2,0
2023,Officer,00714,1,1,0
2023,Officer,00733,2,1,1
2023,Officer,00735,1,1,0
2023,Officer,00736,5,4,1
2023,Officer,00751,1,0,1
2023,Officer,00769,1,1,0
2023,Officer,00778,1,1,0
2023,Officer,00785,1,1,0
2023,Officer,00795,4,4,0
2023,Officer,00802,3,3,0
2023,Officer,00840,2,1,1
2023,Officer,00850,3,3,0
2023,Officer,00934,9,8,1
2023,Officer,01109,1,1,0
2023,Officer,01434,2,2,0
2023,Officer,01440,1,1,0
2023,Officer,01605,3,3,0
2023,Officer,01702,2,2,0
2023,Officer,01731,11,5,6
2023,Officer,01760,1,1,0
2023,Officer,01844,10,10,0
2023,Officer,01867,3,2,1
2023,Officer,01923,1,1,0
2023,Officer,02122,1,1,0
2023,Officer,02138,1,1,0
2023,Officer,02169,2,2,0
2023,Officer,02173,1,1,0
2023,Officer,02176,1,1,0
2023,Officer,02184,1,1,0
2023,Officer,02542,4,4,0
2023,Officer,02769,1,1,0
2023,Officer,02818,6,5,1
2023,Officer,02842,1,1,0
2023,Officer,02852,3,3,0
2023,Officer,02886,3,2,1
2023,Officer,02904,3,3,0
2023,Officer,02906,2,1,1
2023,Officer,03055,1,1,0
2023,Officer,03101,3,3,0
2023,Officer,03235,1,1,0
2023,Officer,03301,6,5,1
2023,Officer,03766,1,1,0
2023,Officer,03867,2,2,0
2023,Officer,04011,1,1,0
2023,Officer,04330,5,3,2
2023,Officer,04401,4,4,0
2023,Officer,04901,2,2,0
2023,Officer,05158,1,1,0
2023,Officer,05403,1,1,0
2023,Officer,05404,2,2,0
2023,Officer,05446,17,12,5
2023,Officer,05465,8,7,1
2023,Officer,05478,3,3,0
2023,Officer,05495,8,8,0
2023,Officer,05663,2,2,0
2023,Officer,05701,3,2,1
2023,Officer,05855,1,1,0
2023,Officer,06096,8,8,0
2023,Officer,06105,2,2,0
2023,Officer,06110,1,1,0
2023,Officer,06320,2,2,0
2023,Officer,06340,1,1,0
2023,Officer,06357,8,4,4
2023,Officer,06360,1,1,0
2023,Officer,06457,5,4,1
2023,Officer,06489,1,1,0
2023,Officer,06497,2,2,0
2023,Officer,06498,1,1,0
2023,Officer,06512,2,2,0
2023,Officer,07052,1,1,0
2023,Officer,07306,2,2,0
2023,Officer,07457,2,2,0
2023,Officer,07666,2,1,1
2023,Officer,07806,1,1,0
2023,Officer,07840,1,1,0
2023,Officer,07865,2,2,0
2023,Officer,08012,1,1,0
2023,Officer,08063,1,1,0
2023,Officer,08096,1,1,0
2023,Officer,08360,1,1,0
2023,Officer,08401,1,1,0
2023,Officer,08640,5,4,1
2023,Officer,08648,1,1,0
2023,Officer,08733,3,3,0
2023,Officer,08750,3,3,0
2023,Officer,08873,2,2,0
2023,Officer,10010,6,6,0
2023,Officer,10021,2,2,0
2023,Officer,10037,5,5,0
2023,Officer,10314,4,4,0
2023,Officer,10566,10,10,0
2023,Officer,10567,2,2,0
2023,Officer,10701,2,2,0
2023,Officer,10962,4,4,0
2023,Officer,11209,2,2,0
2023,Officer,11252,6,6,0
2023,Officer,11357,5,5,0
2023,Officer,11735,3,3,0
2023,Officer,11753,1,1,0
2023,Officer,12078,1,1,0
2023,Officer,12110,2,2,0
2023,Officer,12180,2,2,0
2023,Officer,12189,2,0,2
2023,Officer,12301,5,5,0
2023,Officer,12401,1,1,0
2023,Officer,12553,3,2,1
2023,Officer,12804,3,3,0
2023,Officer,13211,6,6,0
2023,Officer,13501,4,4,0
2023,Officer,13502,2,2,0
2023,Officer,13643,1,1,0
2023,Officer,13905,5,5,0
2023,Officer,14048,1,1,0
2023,Officer,14204,6,6,0
2023,Officer,14213,3,3,0
2023,Officer,14304,2,2,0
2023,Officer,14454,2,2,0
2023,Officer,14456,3,3,0
2023,Officer,14624,5,5,0
2023,Officer,14850,2,2,0
2023,Officer,15216,9,7,2
2023,Officer,15301,1,1,0
2023,Officer,15370,1,1,0
2023,Officer,15425,2,2,0
2023,Officer,15537,1,1,0
2023,Officer,15666,1,1,0
2023,Officer,15902,2,2,0
2023,Officer,15904,4,3,1
2023,Officer,16101,2,2,0
2023,Officer,16226,1,1,0
2023,Officer,16403,3,2,1
2023,Officer,16635,2,2,0
2023,Officer,16738,1,1,0
2023,Officer,16803,1,1,0
2023,Officer,16901,1,1,0
2023,Officer,17003,36,29,7
2023,Officer,17013,7,7,0
2023,Officer,17022,1,1,0
2023,Officer,17103,4,3,1
2023,Officer,17222,1,1,0
2023,Officer,17325,1,1,0
2023,Officer,17331,1,1,0
2023,Officer,17408,2,2,0
2023,Officer,17701,1,1,0
2023,Officer,17821,2,2,0
2023,Officer,17837,1,1,0
2023,Officer,18102,5,4,1
2023,Officer,18201,1,1,0
2023,Officer,18407,1,1,0
2023,Officer,18509,7,6,1
2023,Officer,18634,1,1,0
2023,Officer,18651,1,1,0
2023,Officer,18704,3,3,0
2023,Officer,18834,1,1,0
2023,Officer,19044,3,3,0
2023,Officer,19104,4,4,0
2023,Officer,19153,2,2,0
2023,Officer,19154,4,4,0
2023,Officer,19320,1,1,0
2023,Officer,19462,2,1,1
2023,Officer,19475,1,1,0
2023,Officer,19706,1,1,0
2023,Officer,19720,6,6,0
2023,Officer,19804,2,2,0
2023,Officer,19930,1,1,0
2023,Officer,19947,1,1,0
2023,Officer,19973,1,1,0
2023,Officer,19977,3,3,0
2023,Officer,20003,12,12,0
2023,Officer,20112,2,2,0
2023,Officer,20175,2,2,0
2023,Officer,20623,2,2,0
2023,Officer,20708,3,3,0
2023,Officer,20882,3,2,1
2023,Officer,21010,6,6,0
2023,Officer,21057,1,1,0
2023,Officer,21061,1,1,0
2023,Officer,21136,6,2,4
2023,Officer,21157,1,1,0
2023,Officer,21201,2,2,0
2023,Officer,21204,6,5,1
2023,Officer,21216,2,2,0
2023,Officer,21222,7,6,1
2023,Officer,21228,1,1,0
2023,Officer,21601,1,1,0
2023,Officer,21784,1,1,0
2023,Officer,21801,1,1,0
2023,Officer,22032,1,1,0
2023,Officer,22060,4,4,0
2023,Officer,22401,8,8,0
2023,Officer,22601,2,2,0
2023,Officer,22602,2,2,0
2023,Officer,22664,1,1,0
2023,Officer,22902,1,1,0
2023,Officer,23150,11,11,0
2023,Officer,23181,1,1,0
2023,Officer,23237,3,3,0
2023,Officer,23451,5,5,0
2023,Officer,23502,1,1,0
2023,Officer,23666,1,1,0
2023,Officer,23701,1,1,0
2023,Officer,23805,4,4,0
2023,Officer,23824,6,6,0
2023,Officer,23847,1,1,0
2023,Officer,24151,1,1,0
2023,Officer,24251,2,2,0
2023,Officer,24401,3,3,0
2023,Officer,24450,1,1,0
2023,Officer,24502,4,3,1
2023,Officer,24540,1,1,0
2023,Officer,24701,3,2,1
2023,Officer,25168,4,3,1
2023,Officer,25177,1,1,0
2023,Officer,25309,7,7,0
2023,Officer,25311,3,3,0
2023,Officer,25401,1,1,0
2023,Officer,25530,1,1,0
2023,Officer,26101,1,1,0
2023,Officer,26201,1,1,0
2023,Officer,26250,1,1,0
2023,Officer,26330,1,1,0
2023,Officer,26505,1,1,0
2023,Officer,26537,8,8,0
2023,Officer,26554,1,1,0
2023,Officer,26624,1,1,0
2023,Officer,27203,2,2,0
2023,Officer,27260,1,1,0
2023,Officer,27330,1,1,0
2023,Officer,27344,1,1,0
2023,Officer,27504,1,1,0
2023,Officer,27530,2,2,0
2023,Officer,27560,7,6,1
2023,Officer,27596,1,1,0
2023,Officer,27607,3,3,0
2023,Officer,27704,2,2,0
2023,Officer,27870,2,1,1
2023,Officer,27889,1,1,0
2023,Officer,28001,2,2,0
2023,Officer,28012,1,1,0
2023,Officer,28027,1,1,0
2023,Officer,28043,1,1,0
2023,Officer,28208,1,0,1
2023,Officer,28306,3,3,0
2023,Officer,28310,1,1,0
2023,Officer,28328,4,4,0
2023,Officer,28337,1,1,0
2023,Officer,28376,2,1,1
2023,Officer,28379,1,1,0
2023,Officer,28405,2,2,0
2023,Officer,28518,1,1,0
2023,Officer,28590,1,1,0
2023,Officer,28640,1,1,0
2023,Officer,28681,1,1,0
2023,Officer,28806,1,1,0
2023,Officer,29020,1,1,0
2023,Officer,29044,14,13,1
2023,Officer,29108,2,2,0
2023,Officer,29138,1,1,0
2023,Officer,29161,1,1,0
2023,Officer,29170,2,2,0
2023,Officer,29172,1,1,0
2023,Officer,29201,9,6,3
2023,Officer,29303,3,3,0
2023,Officer,29379,2,2,0
2023,Officer,29409,3,3,0
2023,Officer,29440,3,3,0
2023,Officer,29464,4,4,0
2023,Officer,29506,1,1,0
2023,Officer,29510,1,1,0
2023,Officer,29512,1,1,0
2023,Officer,29532,1,1,0
2023,Officer,29550,2,2,0
2023,Officer,29605,1,1,0
2023,Officer,29620,1,1,0
2023,Officer,29625,2,2,0
2023,Officer,29631,2,2,0
2023,Officer,29640,2,2,0
2023,Officer,29715,1,1,0
2023,Officer,29732,5,5,0
2023,Officer,29810,2,2,0
2023,Officer,29812,1,1,0
2023,Officer,29824,4,4,0
2023,Officer,29906,1,1,0
2023,Officer,29944,1,1,0
2023,Officer,30040,3,3,0
2023,Officer,30060,21,17,4
2023,Officer,30069,3,3,0
2023,Officer,30161,1,1,0
2023,Officer,30224,1,1,0
2023,Officer,30263,3,3,0
2023,Officer,30294,1,1,0
2023,Officer,30297,6,5,1
2023,Officer,30336,3,3,0
2023,Officer,30401,1,1,0
2023,Officer,30458,1,1,0
2023,Officer,30461,2,2,0
2023,Officer,30673,1,1,0
2023,Officer,30680,3,3,0
2023,Officer,30701,3,3,0
2023,Officer,30720,1,1,0
2023,Officer,30904,3,3,0
2023,Officer,30905,2,2,0
2023,Officer,31015,1,1,0
2023,Officer,31029,1,1,0
2023,Officer,31040,2,2,0
2023,Officer,31061,10,10,0
2023,Officer,31211,11,11,0
2023,Officer,31313,2,2,0
2023,Officer,31314,2,2,0
2023,Officer,31406,1,1,0
2023,Officer,31520,1,1,0
2023,Officer,31601,1,1,0
2023,Officer,31704,1,1,0
2023,Officer,31792,1,1,0
2023,Officer,31794,1,1,0
2023,Officer,31901,1,1,0
2023,Officer,32064,2,2,0
2023,Officer,32086,4,2,2
2023,Officer,32091,17,16,1
2023,Officer,32164,4,4,0
2023,Officer,32177,3,3,0
2023,Officer,32221,4,4,0
2023,Officer,32311,2,2,0
2023,Officer,32351,1,1,0
2023,Officer,32405,1,1,0
2023,Officer,32425,1,1,0
2023,Officer,32446,1,1,0
2023,Officer,32514,2,2,0
2023,Officer,32726,1,1,0
2023,Officer,32771,1,1,0
2023,Officer,32806,2,2,0
2023,Officer,33027,5,5,0
2023,Officer,33039,1,1,0
2023,Officer,33315,2,2,0
2023,Officer,33401,3,3,0
2023,Officer,33405,2,2,0
2023,Officer,33563,1,1,0
2023,Officer,33606,1,1,0
2023,Officer,33627,1,1,0
2023,Officer,33782,11,10,1
2023,Officer,33811,1,0,1
2023,Officer,33825,1,1,0
2023,Officer,33844,1,1,0
2023,Officer,33859,2,2,0
2023,Officer,34208,1,1,0
2023,Officer,34429,1,1,0
2023,Officer,34474,1,1,0
2023,Officer,35016,5,5,0
2023,Officer,35040,1,1,0
2023,Officer,35121,1,1,0
2023,Officer,35124,1,1,0
2023,Officer,35146,2,2,0
2023,Officer,35160,1,1,0
2023,Officer,35209,5,4,1
2023,Officer,35217,9,8,1
2023,Officer,35405,1,1,0
2023,Officer,35601,6,5,1
2023,Officer,35613,1,1,0
2023,Officer,35630,2,2,0
2023,Officer,35803,1,1,0
2023,Officer,35904,1,1,0
2023,Officer,35967,2,2,0
2023,Officer,36016,1,1,0
2023,Officer,36043,2,2,0
2023,Officer,36067,1,1,0
2023,Officer,36078,2,2,0
2023,Officer,36081,2,2,0
2023,Officer,36109,8,6,2
2023,Officer,36203,1,1,0
2023,Officer,36205,1,1,0
2023,Officer,36301,1,1,0
2023,Officer,36330,4,3,1
2023,Officer,36340,1,1,0
2023,Officer,36420,2,2,0
2023,Officer,36426,1,1,0
2023,Officer,36522,1,1,0
2023,Officer,36532,1,1,0
2023,Officer,36535,1,1,0
2023,Officer,36605,2,2,0
2023,Officer,36701,1,1,0
2023,Officer,36832,1,1,0
2023,Officer,37015,3,3,0
2023,Officer,37033,1,1,0
2023,Officer,37090,3,3,0
2023,Officer,37160,1,1,0
2023,Officer,37167,12,11,1
2023,Officer,37204,8,6,2
2023,Officer,37217,2,2,0
2023,Officer,37306,1,1,0
2023,Officer,37388,2,2,0
2023,Officer,37404,2,2,0
2023,Officer,37643,1,1,0
2023,Officer,37777,1,1,0
2023,Officer,37821,1,1,0
2023,Officer,37874,1,1,0
2023,Officer,37919,6,5,1
2023,Officer,38024,1,1,0
2023,Officer,38118,3,3,0
2023,Officer,38301,2,2,0
2023,Officer,38305,3,3,0
2023,Officer,38340,1,1,0
2023,Officer,38343,1,1,0
2023,Officer,38375,1,1,0
2023,Officer,38401,3,3,0
2023,Officer,38655,3,2,1
2023,Officer,38671,1,1,0
2023,Officer,38703,1,0,1
2023,Officer,38801,2,2,0
2023,Officer,38821,2,2,0
2023,Officer,38852,1,1,0
2023,Officer,38863,2,2,0
2023,Officer,38915,1,1,0
2023,Officer,39042,1,1,0
2023,Officer,39046,2,2,0
2023,Officer,39056,1,1,0
2023,Officer,39059,1,1,0
2023,Officer,39074,1,1,0
2023,Officer,39111,1,1,0
2023,Officer,39202,2,2,0
2023,Officer,39204,4,4,0
2023,Officer,39209,3,3,0
2023,Officer,39216,3,3,0
2023,Officer,39307,1,1,0
2023,Officer,39345,1,1,0
2023,Officer,39401,1,1,0
2023,Officer,39407,2,2,0
2023,Officer,39422,2,2,0
2023,Officer,39466,1,1,0
2023,Officer,39470,1,1,0
2023,Officer,39505,1,1,0
2023,Officer,39567,2,2,0
2023,Officer,39704,1,1,0
2023,Officer,39759,2,2,0
2023,Officer,40004,1,1,0
2023,Officer,40065,1,1,0
2023,Officer,40069,3,2,1
2023,Officer,40205,7,7,0
2023,Officer,40218,2,2,0
2023,Officer,40311,2,2,0
2023,Officer,40330,2,2,0
2023,Officer,40475,5,4,1
2023,Officer,40510,5,5,0
2023,Officer,40601,11,11,0
2023,Officer,40906,2,2,0
2023,Officer,40965,1,1,0
2023,Officer,41005,2,2,0
2023,Officer,41101,5,5,0
2023,Officer,42025,1,1,0
2023,Officer,42071,1,1,0
2023,Officer,42086,1,1,0
2023,Officer,42101,1,1,0
2023,Officer,42141,4,4,0
2023,Officer,42240,1,1,0
2023,Officer,42301,5,5,0
2023,Officer,43213,7,4,3
2023,Officer,43217,4,4,0
2023,Officer,43235,3,2,1
2023,Officer,43614,1,1,0
2023,Officer,43756,3,3,0
2023,Officer,43812,1,1,0
2023,Officer,44128,1,1,0
2023,Officer,44142,1,1,0
2023,Officer,44224,1,1,0
2023,Officer,44256,1,1,0
2023,Officer,44313,2,2,0
2023,Officer,44444,1,1,0
2023,Officer,44515,1,1,0
2023,Officer,44601,2,2,0
2023,Officer,44622,1,1,0
2023,Officer,44720,7,7,0
2023,Officer,44857,1,1,0
2023,Officer,44870,1,1,0
2023,Officer,44903,1,1,0
2023,Officer,45035,1,1,0
2023,Officer,45215,4,3,1
2023,Officer,45430,2,2,0
2023,Officer,45502,3,3,0
2023,Officer,45601,1,1,0
2023,Officer,45804,1,1,0
2023,Officer,46012,4,3,1
2023,Officer,46052,1,1,0
2023,Officer,46124,2,2,0
2023,Officer,46131,11,10,1
2023,Officer,46151,1,1,0
2023,Officer,46176,2,2,0
2023,Officer,46216,3,3,0
2023,Officer,46228,2,2,0
2023,Officer,46241,10,9,1
2023,Officer,46350,2,2,0
2023,Officer,46383,1,1,0
2023,Officer,46402,1,0,1
2023,Officer,46406,1,1,0
2023,Officer,46563,1,1,0
2023,Officer,46613,1,1,0
2023,Officer,46703,2,2,0
2023,Officer,46750,3,3,0
2023,Officer,46825,2,2,0
2023,Officer,46901,1,1,0
2023,Officer,46970,1,1,0
2023,Officer,47150,1,1,0
2023,Officer,47170,1,1,0
2023,Officer,47203,1,1,0
2023,Officer,47250,1,1,0
2023,Officer,47303,1,1,0
2023,Officer,47331,1,1,0
2023,Officer,47401,1,1,0
2023,Officer,47501,2,2,0
2023,Officer,47591,2,2,0
2023,Officer,47834,2,2,0
2023,Officer,47905,1,1,0
2023,Officer,47960,1,1,0
2023,Officer,48180,4,3,1
2023,Officer,48197,3,3,0
2023,Officer,48208,4,4,0
2023,Officer,48234,12,9,3
2023,Officer,48446,1,1,0
2023,Officer,48601,4,4,0
2023,Officer,48642,1,1,0
2023,Officer,48817,1,1,0
2023,Officer,48837,1,1,0
2023,Officer,48838,2,2,0
2023,Officer,48906,4,3,1
2023,Officer,48912,2,2,0
2023,Officer,49009,1,1,0
2023,Officer,49012,3,3,0
2023,Officer,49201,2,1,1
2023,Officer,49224,1,1,0
2023,Officer,49437,1,1,0
2023,Officer,49509,3,3,0
2023,Officer,49601,1,1,0
2023,Officer,49696,1,1,0
2023,Officer,49739,3,3,0
2023,Officer,49801,1,1,0
2023,Officer,49849,3,2,1
2023,Officer,49913,1,1,0
2023,Officer,50036,6,5,1
2023,Officer,50126,1,1,0
2023,Officer,50131,15,10,5
2023,Officer,50158,1,1,0
2023,Officer,50703,2,2,0
2023,Officer,51503,2,2,0
2023,Officer,52246,4,4,0
2023,Officer,52577,1,1,0
2023,Officer,52632,1,1,0
2023,Officer,52806,4,4,0
2023,Officer,53089,1,1,0
2023,Officer,53095,2,2,0
2023,Officer,53144,1,1,0
2023,Officer,53154,1,1,0
2023,Officer,53212,1,1,0
2023,Officer,53403,1,1,0
2023,Officer,53511,1,1,0
2023,Officer,53538,1,1,0
2023,Officer,53545,1,1,0
2023,Officer,53704,10,9,1
2023,Officer,53963,1,1,0
2023,Officer,54143,1,1,0
2023,Officer,54501,1,1,0
2023,Officer,54618,6,5,1
2023,Officer,54646,1,1,0
2023,Officer,54665,2,2,0
2023,Officer,54729,1,1,0
2023,Officer,54880,2,2,0
2023,Officer,54902,1,1,0
2023,Officer,54914,1,1,0
2023,Officer,54932,4,4,0
2023,Officer,54935,1,1,0
2023,Officer,55008,1,1,0
2023,Officer,55016,1,1,0
2023,Officer,55068,1,1,0
2023,Officer,55077,1,1,0
2023,Officer,55082,4,4,0
2023,Officer,55101,1,1,0
2023,Officer,55106,1,1,0
2023,Officer,55107,4,4,0
2023,Officer,55112,7,6,1
2023,Officer,55118,1,1,0
2023,Officer,55303,4,4,0
2023,Officer,55355,1,1,0
2023,Officer,55431,1,1,0
2023,Officer,55719,1,1,0
2023,Officer,55746,1,1,0
2023,Officer,55811,1,0,1
2023,Officer,55901,2,2,0
2023,Officer,55987,1,1,0
2023,Officer,56001,2,2,0
2023,Officer,56007,1,1,0
2023,Officer,56073,1,1,0
2023,Officer,56256,1,1,0
2023,Officer,56273,1,1,0
2023,Officer,56278,1,1,0
2023,Officer,56301,1,1,0
2023,Officer,56303,3,3,0
2023,Officer,56308,1,1,0
2023,Officer,56345,10,8,2
2023,Officer,56482,1,1,0
2023,Officer,56560,3,2,1
2023,Officer,56601,1,1,0
2023,Officer,57069,2,2,0
2023,Officer,57104,3,3,0
2023,Officer,57201,1,1,0
2023,Officer,57252,1,1,0
2023,Officer,57301,2,2,0
2023,Officer,57350,2,2,0
2023,Officer,57702,6,4,2
2023,Officer,57785,1,1,0
2023,Officer,58072,1,1,0
2023,Officer,58102,2,2,0
2023,Officer,58201,2,2,0
2023,Officer,58501,4,2,2
2023,Officer,58506,1,1,0
2023,Officer,59102,2,2,0
2023,Officer,59538,1,1,0
2023,Officer,59602,4,4,0
2023,Officer,59636,10,8,2
2023,Officer,59711,1,1,0
2023,Officer,59714,3,3,0
2023,Officer,59808,2,2,0
2023,Officer,60098,1,1,0
2023,Officer,60472,1,1,0
2023,Officer,60505,1,1,0
2023,Officer,60546,4,4,0
2023,Officer,60615,3,3,0
2023,Officer,60651,4,3,1
2023,Officer,61021,1,1,0
2023,Officer,61115,2,2,0
2023,Officer,61201,1,1,0
2023,Officer,61264,2,2,0
2023,Officer,61341,1,1,0
2023,Officer,61434,1,1,0
2023,Officer,61443,1,1,0
2023,Officer,61455,1,1,0
2023,Officer,61607,4,4,0
2023,Officer,61701,1,1,0
2023,Officer,61761,2,1,1
2023,Officer,61801,2,2,0
2023,Officer,62205,1,1,0
2023,Officer,62301,1,1,0
2023,Officer,62521,4,4,0
2023,Officer,62702,11,11,0
2023,Officer,62864,2,2,0
2023,Officer,62959,4,4,0
2023,Officer,62966,1,1,0
2023,Officer,63020,1,1,0
2023,Officer,63028,1,1,0
2023,Officer,63044,1,1,0
2023,Officer,63077,1,1,0
2023,Officer,63125,8,5,3
2023,Officer,63640,1,1,0
2023,Officer,63701,1,1,0
2023,Officer,63775,1,1,0
2023,Officer,63857,1,1,0
2023,Officer,63901,1,1,0
2023,Officer,64067,1,0,1
2023,Officer,64129,5,4,1
2023,Officer,64468,1,1,0
2023,Officer,65101,4,3,1
2023,Officer,65265,1,1,0
2023,Officer,65301,1,0,1
2023,Officer,65305,1,1,0
2023,Officer,65473,2,2,0
2023,Officer,65723,1,1,0
2023,Officer,65802,2,1,1
2023,Officer,65803,1,1,0
2023,Officer,66027,1,1,0
2023,Officer,66044,5,5,0
2023,Officer,66067,1,1,0
2023,Officer,66071,1,1,0
2023,Officer,66219,1,0,1
2023,Officer,66434,2,2,0
2023,Officer,66436,1,1,0
2023,Officer,66611,1,0,1
2023,Officer,66619,7,7,0
2023,Officer,66749,1,1,0
2023,Officer,66762,1,1,0
2023,Officer,66801,1,1,0
2023,Officer,67010,2,2,0
2023,Officer,67114,1,1,0
2023,Officer,67124,1,1,0
2023,Officer,67219,3,3,0
2023,Officer,67401,2,2,0
2023,Officer,67501,1,1,0
2023,Officer,67530,1,1,0
2023,Officer,67701,1,1,0
2023,Officer,68073,4,4,0
2023,Officer,68106,2,2,0
2023,Officer,68467,1,1,0
2023,Officer,68503,1,1,0
2023,Officer,68508,3,3,0
2023,Officer,68524,5,4,1
2023,Officer,68601,1,1,0
2023,Officer,68803,1,1,0
2023,Officer,68901,1,1,0
2023,Officer,70072,1,1,0
2023,Officer,70117,3,3,0
2023,Officer,70301,1,1,0
2023,Officer,70401,5,5,0
2023,Officer,70438,2,2,0
2023,Officer,70460,1,1,0
2023,Officer,70563,1,1,0
2023,Officer,70582,3,3,0
2023,Officer,70601,2,2,0
2023,Officer,70721,7,7,0
2023,Officer,70820,1,0,1
2023,Officer,71055,1,1,0
2023,Officer,71101,2,2,0
2023,Officer,71111,1,1,0
2023,Officer,71203,3,3,0
2023,Officer,71303,2,2,0
2023,Officer,71360,3,3,0
2023,Officer,71457,1,1,0
2023,Officer,71671,1,1,0
2023,Officer,71730,1,1,0
2023,Officer,71801,1,1,0
2023,Officer,72012,3,3,0
2023,Officer,72015,1,1,0
2023,Officer,72023,1,1,0
2023,Officer,72086,1,1,0
2023,Officer,72119,1,1,0
2023,Officer,72143,1,1,0
2023,Officer,72199,15,15,0
2023,Officer,72401,5,5,0
2023,Officer,72432,2,2,0
2023,Officer,72701,4,4,0
2023,Officer,72713,3,3,0
2023,Officer,72756,1,1,0
2023,Officer,72830,1,1,0
2023,Officer,72834,1,1,0
2023,Officer,72855,2,2,0
2023,Officer,72923,1,1,0
2023,Officer,73034,2,2,0
2023,Officer,73064,3,2,1
2023,Officer,73069,4,2,2
2023,Officer,73111,13,9,4
2023,Officer,73503,3,3,0
2023,Officer,73521,1,1,0
2023,Officer,73705,1,1,0
2023,Officer,74012,2,2,0
2023,Officer,74014,2,2,0
2023,Officer,74107,2,2,0
2023,Officer,74301,1,1,0
2023,Officer,74403,1,1,0
2023,Officer,74834,2,2,0
2023,Officer,75051,12,12,0
2023,Officer,75077,1,1,0
2023,Officer,75098,4,4,0
2023,Officer,75110,1,1,0
2023,Officer,75159,2,2,0
2023,Officer,75237,3,2,1
2023,Officer,76108,13,13,0
2023,Officer,76115,1,1,0
2023,Officer,76234,3,3,0
2023,Officer,76302,1,1,0
2023,Officer,76401,1,1,0
2023,Officer,76502,7,7,0
2023,Officer,76528,1,1,0
2023,Officer,76542,2,2,0
2023,Officer,76574,2,1,1
2023,Officer,76707,8,7,1
2023,Officer,77034,9,9,0
2023,Officer,77067,6,6,0
2023,Officer,77082,9,9,0
2023,Officer,77340,1,1,0
2023,Officer,77437,1,1,0
2023,Officer,77515,1,1,0
2023,Officer,77568,1,1,0
2023,Officer,77802,5,4,1
2023,Officer,77904,1,1,0
2023,Officer,78041,2,2,0
2023,Officer,78130,1,1,0
2023,Officer,78218,3,3,0
2023,Officer,78219,5,4,1
2023,Officer,78257,9,7,2
2023,Officer,78596,2,2,0
2023,Officer,78602,2,2,0
2023,Officer,78617,3,3,0
2023,Officer,78665,3,3,0
2023,Officer,78666,3,3,0
2023,Officer,78703,9,7,2
2023,Officer,78731,1,1,0
2023,Officer,78746,1,1,0
2023,Officer,79107,1,1,0
2023,Officer,79403,3,3,0
2023,Officer,79918,2,2,0
2023,Officer,79936,7,7,0
2023,Officer,80011,14,12,2
2023,Officer,80012,1,1,0
2023,Officer,80112,5,4,1
2023,Officer,80137,3,3,0
2023,Officer,80216,5,5,0
2023,Officer,80501,3,3,0
2023,Officer,80521,2,2,0
2023,Officer,80907,1,1,0
2023,Officer,80913,7,6,1
2023,Officer,80916,2,2,0
2023,Officer,80920,9,9,0
2023,Officer,81401,1,1,0
2023,Officer,82005,3,2,1
2023,Officer,82009,5,3,2
2023,Officer,82070,2,2,0
2023,Officer,82240,2,2,0
2023,Officer,82604,5,5,0
2023,Officer,83202,4,4,0
2023,Officer,83330,1,1,0
2023,Officer,83338,1,1,0
2023,Officer,83402,1,1,0
2023,Officer,83442,1,1,0
2023,Officer,83617,3,3,0
2023,Officer,83647,2,2,0
2023,Officer,83687,2,2,0
2023,Officer,83705,11,10,1
2023,Officer,83854,1,1,0
2023,Officer,84003,5,5,0
2023,Officer,84020,12,11,1
2023,Officer,84043,2,1,1
2023,Officer,84058,2,2,0
2023,Officer,84065,18,17,1
2023,Officer,84084,7,7,0
2023,Officer,84116,2,2,0
2023,Officer,84302,1,1,0
2023,Officer,84321,1,1,0
2023,Officer,84405,2,2,0
2023,Officer,84501,1,1,0
2023,Officer,84660,2,1,1
2023,Officer,84663,2,2,0
2023,Officer,84713,1,1,0
2023,Officer,84721,4,4,0
2023,Officer,84790,1,1,0
2023,Officer,85008,34,29,5
2023,Officer,85128,1,1,0
2023,Officer,85132,2,2,0
2023,Officer,85201,1,1,0
2023,Officer,85286,2,2,0
2023,Officer,85653,2,2,0
2023,Officer,85713,1,1,0
2023,Officer,86015,1,1,0
2023,Officer,86301,1,1,0
2023,Officer,87002,1,1,0
2023,Officer,87123,2,2,0
2023,Officer,87124,1,1,0
2023,Officer,87144,3,3,0
2023,Officer,87401,2,2,0
2023,Officer,88001,2,2,0
2023,Officer,88007,2,2,0
2023,Officer,88203,1,1,0
2023,Officer,89115,1,1,0
2023,Officer,89139,2,2,0
2023,Officer,89165,4,4,0
2023,Officer,89406,2,2,0
2023,Officer,89502,2,1,1
2023,Officer,89506,2,1,1
2023,Officer,89701,2,2,0
2023,Officer,90025,2,2,0
2023,Officer,90201,8,5,3
2023,Officer,90249,2,2,0
2023,Officer,90266,1,1,0
2023,Officer,90302,2,2,0
2023,Officer,90720,24,18,6
2023,Officer,90822,6,5,1
2023,Officer,91406,2,2,0
2023,Officer,91505,3,3,0
2023,Officer,91702,6,5,1
2023,Officer,91950,1,1,0
2023,Officer,92020,3,3,0
2023,Officer,92025,3,3,0
2023,Officer,92111,4,3,1
2023,Officer,92410,5,5,0
2023,Officer,92518,2,2,0
2023,Officer,92833,2,2,0
2023,Officer,93291,2,2,0
2023,Officer,93405,1,1,0
2023,Officer,93451,1,1,0
2023,Officer,93536,2,2,0
2023,Officer,93727,4,4,0
2023,Officer,94132,2,2,0
2023,Officer,94401,2,2,0
2023,Officer,94510,2,1,1
2023,Officer,94519,1,1,0
2023,Officer,94533,2,2,0
2023,Officer,94545,1,1,0
2023,Officer,94568,1,1,0
2023,Officer,94596,1,1,0
2023,Officer,94903,1,1,0
2023,Officer,95206,2,2,0
2023,Officer,95351,2,1,1
2023,Officer,95401,2,2,0
2023,Officer,95655,1,1,0
2023,Officer,95678,1,1,0
2023,Officer,95825,1,1,0
2023,Officer,95827,5,4,1
2023,Officer,95828,7,7,0
2023,Officer,95832,1,1,0
2023,Officer,95926,1,1,0
2023,Officer,95965,1,1,0
2023,Officer,96080,1,1,0
2023,Officer,96707,14,9,5
2023,Officer,96716,1,1,0
2023,Officer,96720,2,2,0
2023,Officer,96782,2,2,0
2023,Officer,96789,4,4,0
2023,Officer,96913,2,2,0
2023,Officer,97116,2,2,0
2023,Officer,97211,2,1,1
2023,Officer,97301,4,1,3
2023,Officer,97477,1,1,0
2023,Officer,97501,1,0,1
2023,Officer,97520,1,1,0
2023,Officer,97526,1,1,0
2023,Officer,98032,6,6,0
2023,Officer,98119,4,4,0
2023,Officer,98215,2,2,0
2023,Officer,98271,2,2,0
2023,Officer,98312,1,1,0
2023,Officer,98321,2,2,0
2023,Officer,98430,7,7,0
2023,Officer,98433,10,10,0
2023,Officer,98512,5,5,0
2023,Officer,98531,1,1,0
2023,Officer,98563,3,3,0
2023,Officer,98823,1,1,0
2023,Officer,98837,2,1,1
2023,Officer,98903,1,1,0
2023,Officer,98930,1,1,0
2023,Officer,99011,1,1,0
2023,Officer,99217,3,3,0
2023,Officer,99301,1,1,0
2023,Officer,99504,1,1,0
2023,Officer,99505,9,7,2
2023,Officer,99731,2,2,0
2023,Warrant Officer,     ,1,1,0
2023,Warrant Officer,00693,1,1,0
2023,Warrant Officer,00725,1,1,0
2023,Warrant Officer,00778,1,1,0
2023,Warrant Officer,00795,1,1,0
2023,Warrant Officer,00850,1,1,0
2023,Warrant Officer,00907,1,1,0
2023,Warrant Officer,00934,3,3,0
2023,Warrant Officer,01013,3,3,0
2023,Warrant Officer,01085,1,1,0
2023,Warrant Officer,01731,2,2,0
2023,Warrant Officer,02542,1,1,0
2023,Warrant Officer,02818,1,1,0
2023,Warrant Officer,02852,3,3,0
2023,Warrant Officer,03101,1,1,0
2023,Warrant Officer,03301,2,2,0
2023,Warrant Officer,04011,1,1,0
2023,Warrant Officer,04330,2,2,0
2023,Warrant Officer,04401,2,2,0
2023,Warrant Officer,05403,2,2,0
2023,Warrant Officer,05404,1,1,0
2023,Warrant Officer,05446,1,1,0
2023,Warrant Officer,05661,1,1,0
2023,Warrant Officer,06096,2,2,0
2023,Warrant Officer,07960,1,1,0
2023,Warrant Officer,08360,1,1,0
2023,Warrant Officer,08640,1,1,0
2023,Warrant Officer,08648,1,1,0
2023,Warrant Officer,08733,2,2,0
2023,Warrant Officer,08759,1,1,0
2023,Warrant Officer,10567,1,1,0
2023,Warrant Officer,10701,1,1,0
2023,Warrant Officer,12110,3,3,0
2023,Warrant Officer,12301,1,1,0
2023,Warrant Officer,13905,1,1,0
2023,Warrant Officer,14204,1,1,0
2023,Warrant Officer,14213,1,1,0
2023,Warrant Officer,14624,1,1,0
2023,Warrant Officer,15010,1,1,0
2023,Warrant Officer,15301,2,2,0
2023,Warrant Officer,15902,5,5,0
2023,Warrant Officer,15904,1,1,0
2023,Warrant Officer,16101,1,1,0
2023,Warrant Officer,16403,1,1,0
2023,Warrant Officer,17003,4,4,0
2023,Warrant Officer,17098,1,1,0
2023,Warrant Officer,17103,3,3,0
2023,Warrant Officer,17745,1,1,0
2023,Warrant Officer,18407,1,1,0
2023,Warrant Officer,19153,1,1,0
2023,Warrant Officer,19154,1,1,0
2023,Warrant Officer,19720,3,3,0
2023,Warrant Officer,19804,1,1,0
2023,Warrant Officer,19939,3,3,0
2023,Warrant Officer,19977,1,1,0
2023,Warrant Officer,20003,4,4,0
2023,Warrant Officer,20708,1,1,0
2023,Warrant Officer,20783,2,2,0
2023,Warrant Officer,21010,4,4,0
2023,Warrant Officer,21057,1,1,0
2023,Warrant Officer,22060,2,2,0
2023,Warrant Officer,23150,2,2,0
2023,Warrant Officer,24701,1,1,0
2023,Warrant Officer,25064,1,1,0
2023,Warrant Officer,26330,3,3,0
2023,Warrant Officer,27217,1,1,0
2023,Warrant Officer,27560,7,7,0
2023,Warrant Officer,27607,4,4,0
2023,Warrant Officer,27704,1,1,0
2023,Warrant Officer,28012,1,1,0
2023,Warrant Officer,28208,4,4,0
2023,Warrant Officer,28328,2,2,0
2023,Warrant Officer,28334,1,1,0
2023,Warrant Officer,28659,1,1,0
2023,Warrant Officer,29044,3,3,0
2023,Warrant Officer,29153,1,1,0
2023,Warrant Officer,29201,2,2,0
2023,Warrant Officer,29605,3,3,0
2023,Warrant Officer,30032,1,1,0
2023,Warrant Officer,30060,7,7,0
2023,Warrant Officer,30069,1,1,0
2023,Warrant Officer,30233,1,1,0
2023,Warrant Officer,30297,2,2,0
2023,Warrant Officer,30336,1,1,0
2023,Warrant Officer,30461,1,1,0
2023,Warrant Officer,31211,1,1,0
2023,Warrant Officer,31314,1,1,0
2023,Warrant Officer,31409,4,4,0
2023,Warrant Officer,31905,2,2,0
2023,Warrant Officer,32084,1,1,0
2023,Warrant Officer,32091,3,3,0
2023,Warrant Officer,32221,6,6,0
2023,Warrant Officer,32862,2,2,0
2023,Warrant Officer,33315,1,1,0
2023,Warrant Officer,33782,1,1,0
2023,Warrant Officer,33811,1,1,0
2023,Warrant Officer,33830,2,2,0
2023,Warrant Officer,34604,1,1,0
2023,Warrant Officer,35016,1,1,0
2023,Warrant Officer,35217,3,3,0
2023,Warrant Officer,35405,1,1,0
2023,Warrant Officer,35565,1,1,0
2023,Warrant Officer,35967,1,1,0
2023,Warrant Officer,36043,4,4,0
2023,Warrant Officer,36109,1,1,0
2023,Warrant Officer,36203,1,1,0
2023,Warrant Officer,36205,3,3,0
2023,Warrant Officer,36250,1,1,0
2023,Warrant Officer,36301,1,1,0
2023,Warrant Officer,36605,3,3,0
2023,Warrant Officer,36608,2,2,0
2023,Warrant Officer,36867,1,1,0
2023,Warrant Officer,37083,1,1,0
2023,Warrant Officer,37167,1,1,0
2023,Warrant Officer,37204,5,5,0
2023,Warrant Officer,37217,1,1,0
2023,Warrant Officer,37615,1,1,0
2023,Warrant Officer,37777,4,4,0
2023,Warrant Officer,38301,1,1,0
2023,Warrant Officer,38671,1,1,0
2023,Warrant Officer,38801,2,2,0
2023,Warrant Officer,39111,1,1,0
2023,Warrant Officer,39202,3,3,0
2023,Warrant Officer,39204,2,2,0
2023,Warrant Officer,39209,2,2,0
2023,Warrant Officer,39216,2,2,0
2023,Warrant Officer,39345,1,1,0
2023,Warrant Officer,39407,2,2,0
2023,Warrant Officer,39440,1,1,0
2023,Warrant Officer,39505,2,2,0
2023,Warrant Officer,39507,2,2,0
2023,Warrant Officer,39773,2,2,0
2023,Warrant Officer,40205,1,1,0
2023,Warrant Officer,40475,2,2,0
2023,Warrant Officer,40510,2,2,0
2023,Warrant Officer,40601,9,9,0
2023,Warrant Officer,41005,1,1,0
2023,Warrant Officer,41031,1,1,0
2023,Warrant Officer,42330,1,1,0
2023,Warrant Officer,43217,3,3,0
2023,Warrant Officer,43465,1,1,0
2023,Warrant Officer,44720,3,3,0
2023,Warrant Officer,45215,1,1,0
2023,Warrant Officer,45601,1,1,0
2023,Warrant Officer,46131,4,4,0
2023,Warrant Officer,46176,4,4,0
2023,Warrant Officer,46216,2,2,0
2023,Warrant Officer,46241,6,6,0
2023,Warrant Officer,46406,1,1,0
2023,Warrant Officer,46901,2,2,0
2023,Warrant Officer,47203,1,1,0
2023,Warrant Officer,47834,1,1,0
2023,Warrant Officer,47933,1,1,0
2023,Warrant Officer,48180,1,1,0
2023,Warrant Officer,48642,1,1,0
2023,Warrant Officer,48837,2,2,0
2023,Warrant Officer,48906,6,6,0
2023,Warrant Officer,49009,1,1,0
2023,Warrant Officer,50036,3,3,0
2023,Warrant Officer,50131,7,7,0
2023,Warrant Officer,50220,1,1,0
2023,Warrant Officer,50709,1,1,0
2023,Warrant Officer,52404,1,1,0
2023,Warrant Officer,52577,1,1,0
2023,Warrant Officer,52806,1,1,0
2023,Warrant Officer,53095,3,3,0
2023,Warrant Officer,53704,3,3,0
2023,Warrant Officer,53948,2,2,0
2023,Warrant Officer,54401,1,1,0
2023,Warrant Officer,54618,3,3,0
2023,Warrant Officer,54660,1,1,0
2023,Warrant Officer,54665,1,1,0
2023,Warrant Officer,55008,1,1,0
2023,Warrant Officer,55068,2,2,0
2023,Warrant Officer,55101,1,1,0
2023,Warrant Officer,55107,3,3,0
2023,Warrant Officer,55112,2,2,0
2023,Warrant Officer,55431,1,1,0
2023,Warrant Officer,56301,3,3,0
2023,Warrant Officer,56303,2,2,0
2023,Warrant Officer,57104,1,1,0
2023,Warrant Officer,57702,3,3,0
2023,Warrant Officer,57703,2,2,0
2023,Warrant Officer,57741,1,1,0
2023,Warrant Officer,57785,1,1,0
2023,Warrant Officer,58072,1,1,0
2023,Warrant Officer,58102,1,1,0
2023,Warrant Officer,58201,3,3,0
2023,Warrant Officer,58501,2,2,0
2023,Warrant Officer,59102,2,2,0
2023,Warrant Officer,59602,2,2,0
2023,Warrant Officer,59636,1,1,0
2023,Warrant Officer,59701,1,1,0
2023,Warrant Officer,59901,1,1,0
2023,Warrant Officer,60615,1,1,0
2023,Warrant Officer,60901,1,1,0
2023,Warrant Officer,61455,1,1,0
2023,Warrant Officer,61607,3,3,0
2023,Warrant Officer,61761,1,1,0
2023,Warrant Officer,61801,1,1,0
2023,Warrant Officer,61820,1,1,0
2023,Warrant Officer,61938,1,1,0
2023,Warrant Officer,62521,3,3,0
2023,Warrant Officer,63044,2,2,0
2023,Warrant Officer,63645,1,1,0
2023,Warrant Officer,64129,2,2,0
2023,Warrant Officer,64804,1,1,0
2023,Warrant Officer,65101,2,2,0
2023,Warrant Officer,65202,1,1,0
2023,Warrant Officer,65305,1,1,0
2023,Warrant Officer,65723,1,1,0
2023,Warrant Officer,65803,2,2,0
2023,Warrant Officer,66027,3,3,0
2023,Warrant Officer,66502,1,1,0
2023,Warrant Officer,66619,2,2,0
2023,Warrant Officer,66749,1,1,0
2023,Warrant Officer,67219,1,1,0
2023,Warrant Officer,67601,1,1,0
2023,Warrant Officer,67654,1,1,0
2023,Warrant Officer,68508,2,2,0
2023,Warrant Officer,68524,1,1,0
2023,Warrant Officer,68803,1,1,0
2023,Warrant Officer,70401,2,2,0
2023,Warrant Officer,70410,2,2,0
2023,Warrant Officer,70508,2,2,0
2023,Warrant Officer,70721,2,2,0
2023,Warrant Officer,71220,1,1,0
2023,Warrant Officer,71270,1,1,0
2023,Warrant Officer,71303,1,1,0
2023,Warrant Officer,71360,5,5,0
2023,Warrant Officer,72015,1,1,0
2023,Warrant Officer,72199,9,9,0
2023,Warrant Officer,72650,1,1,0
2023,Warrant Officer,72701,1,1,0
2023,Warrant Officer,73069,2,2,0
2023,Warrant Officer,73111,7,7,0
2023,Warrant Officer,74116,6,6,0
2023,Warrant Officer,75051,2,2,0
2023,Warrant Officer,75165,1,1,0
2023,Warrant Officer,76108,1,1,0
2023,Warrant Officer,76115,1,1,0
2023,Warrant Officer,77034,5,5,0
2023,Warrant Officer,77067,1,1,0
2023,Warrant Officer,77802,1,1,0
2023,Warrant Officer,78218,1,1,0
2023,Warrant Officer,78257,1,1,0
2023,Warrant Officer,78602,1,1,0
2023,Warrant Officer,78617,2,2,0
2023,Warrant Officer,78666,1,1,0
2023,Warrant Officer,78703,2,2,0
2023,Warrant Officer,80011,7,6,1
2023,Warrant Officer,80112,3,3,0
2023,Warrant Officer,80137,1,1,0
2023,Warrant Officer,80550,1,1,0
2023,Warrant Officer,80913,3,3,0
2023,Warrant Officer,82009,3,3,0
2023,Warrant Officer,83705,6,6,0
2023,Warrant Officer,83854,1,1,0
2023,Warrant Officer,84020,1,1,0
2023,Warrant Officer,84065,3,3,0
2023,Warrant Officer,84084,9,9,0
2023,Warrant Officer,84116,1,1,0
2023,Warrant Officer,84790,1,1,0
2023,Warrant Officer,85008,9,9,0
2023,Warrant Officer,85653,3,3,0
2023,Warrant Officer,86015,1,1,0
2023,Warrant Officer,87144,2,2,0
2023,Warrant Officer,87507,2,2,0
2023,Warrant Officer,89115,3,3,0
2023,Warrant Officer,89506,2,2,0
2023,Warrant Officer,89701,1,1,0
2023,Warrant Officer,90201,2,2,0
2023,Warrant Officer,90720,7,7,0
2023,Warrant Officer,91505,1,1,0
2023,Warrant Officer,92111,1,1,0
2023,Warrant Officer,93405,1,1,0
2023,Warrant Officer,93727,5,5,0
2023,Warrant Officer,94043,1,1,0
2023,Warrant Officer,95206,1,1,0
2023,Warrant Officer,95231,1,1,0
2023,Warrant Officer,95401,1,1,0
2023,Warrant Officer,95655,1,1,0
2023,Warrant Officer,95678,1,1,0
2023,Warrant Officer,95827,3,3,0
2023,Warrant Officer,95828,1,1,0
2023,Warrant Officer,95832,1,1,0
2023,Warrant Officer,95926,1,1,0
2023,Warrant Officer,96707,7,7,0
2023,Warrant Officer,96720,2,2,0
2023,Warrant Officer,96750,1,1,0
2023,Warrant Officer,96753,1,1,0
2023,Warrant Officer,96782,1,1,0
2023,Warrant Officer,96857,2,2,0
2023,Warrant Officer,97301,1,1,0
2023,Warrant Officer,97302,1,1,0
2023,Warrant Officer,97801,1,1,0
2023,Warrant Officer,98119,1,1,0
2023,Warrant Officer,98430,3,3,0
2023,Warrant Officer,98433,4,4,0
2023,Warrant Officer,99505,3,3,0
2023,Warrant Officer,99731,1,1,0